daniel : Daniel : (rzecz.) Daniel
dawid : Dawid : (rzecz.) Dave | : (rzecz.) David
diana : Diana : (rzecz.) Diana
dominik : Dominik : (rzecz.) Dominic
dorota : Dorota : (rzecz.) Dorothy
dach : dach : (rzecz.) roof | : (rzecz.) rooftop
dacharz : dacharz : (rzecz.) roofer
dachowiec : dachowiec : (rzecz.) roofer
dachowka : dachówka : (rzecz.) roof-tile | : (rzecz.) slate | : (rzecz.) tile
dacza : dacza : (rzecz.) bower | : (rzecz.) cabin | : (rzecz.) cottage | : (rzecz.) dacha
dafnia : dafnia : (rzecz.) daphnia
dagerotyp : dagerotyp : (rzecz.) daguerreotype
daktyl : daktyl : (rzecz.) dactyl | : (rzecz.) date
daktyliczny : daktyliczny : (przym.) dactylic
daktylowiec : daktylowiec : (rzecz.) date | : (rzecz.) date-palm
dal : dal : (rzecz.) distance | : (rzecz.) remoteness
dalba : dalba : (rzecz.) dolphin
dalej : dalej : (rzecz.) onwards
daleki : daleki : (przym.) distant | : (przym.) far | : (przym.) faraway | : (przym.) far-away | : (przym.) far-off | : (przym.) long-haul | : (przym.) remote
daleko : daleko : (przysł.) afar | : (przysł.) away | : (przysł.) distantly | : (przysł.) famously | : (przysł.) far | : (przysł.) further
dalekobiezny : dalekobieżny : (przym.) interurban | : (przym.) long-distance
dalekomierz : dalekomierz : (rzecz.) rangefinder | : (rzecz.) telemeter
dalekomorski : dalekomorski : (przym.) deep-sea
dalekonosny : dalekonośny : (przym.) long-range
dalekopis : dalekopis : (rzecz.) teletype | : (rzecz.) teletypewriter
dalekosiezny : dalekosiężny : (przym.) far-reaching
dalekowzrocznosc : dalekowzroczność : (rzecz.) farsightedness | : (rzecz.) far-sightedness | : (rzecz.) sagacity
dalekowzroczny : dalekowzroczny : (przym.) farseeing | : (przym.) far-seeing | : (przym.) farsighted | : (przym.) forward | : (przym.) longsighted | : (przym.) long-sighted
dalekosc : dalekość : (rzecz.) distance
dalia : dalia : (rzecz.) dahlia
dalmatyka : dalmatyka : (rzecz.) dalmatic
dalmierz : dalmierz : (rzecz.) rangefinder | : (rzecz.) range-finder | : (rzecz.) telemeter
dalszy : dalszy : (przym.) ulterior
daltonizm : daltonizm : (rzecz.) colour-blindness
dama : dama : (rzecz.) dame | : (rzecz.) gentlewoman | : (rzecz.) lady | : (rzecz.) queen
damaszka : damaszka : (rzecz.) damson
damka : damka : (rzecz.) king
damski : damski : (przym.) ladies'
dandys : dandys : (rzecz.) buck | : (rzecz.) dandy | : (rzecz.) jack-a-dandy
dandyzm : dandyzm : (rzecz.) dandyism
dane : dane : (rzecz.) data | : (rzecz.) datasheet | : (rzecz.) statistics
danie : danie : (rzecz.) course | : (rzecz.) dish | : (rzecz.) plat
daniel : daniel : (rzecz.) fallow-deer
danina : danina : (rzecz.) levy | : (rzecz.) subsidy | : (rzecz.) tribute
dany : dany : (przym.) given | : (przym.) underlying
dar : dar : (rzecz.) bestowal | : (rzecz.) bestowing | : (rzecz.) bestowment | : (rzecz.) boon | : (rzecz.) bounty | : (rzecz.) donation | : (rzecz.) faculty | : (rzecz.) gift | : (rzecz.) grant | : (rzecz.) gratuity | : (rzecz.) present
darczynca : darczyńca : (rzecz.) donor
daremnie : daremnie : (przysł.) futilely
daremnosc : daremność : (rzecz.) frustration | : (rzecz.) futility | : (rzecz.) laziness | : (rzecz.) pointlessness | : (rzecz.) vainness | : (rzecz.) vanity
daremny : daremny : (przym.) abortive | : (przym.) bootless | : (przym.) futile | : (przym.) idle | : (przym.) ineffective | : (przym.) inefficacious | : (przym.) purposeless | : (przym.) self-defeating | : (przym.) unavailing | : (przym.) unfruitful | : (przym.) vain
darmo : darmo : (przysł.) free | : (przysł.) gratis
darmowy : darmowy : (przym.) complimentary | : (przym.) free | : (przym.) gratis
darmozjad : darmozjad : (rzecz.) freeloader | : (rzecz.) parasite | : (rzecz.) sponger
darnina : darnina : (rzecz.) sod | : (rzecz.) turf
darniowanie : darniowanie : (rzecz.) turf
darniowac : darniować : (czas.) sod
darowanie : darowanie : (rzecz.) remission | : (rzecz.) sparer | : (rzecz.) sparest
darowac : darować : (czas.) absolve | : (czas.) condone | : (czas.) donate | : (czas.) forgive | : (czas.) give | : (czas.) pardon | : (czas.) present | : (czas.) remit | : (czas.) spar
darowizna : darowizna : (rzecz.) donation | : (rzecz.) gift | : (rzecz.) grant
darowywac : darowywać : (czas.) donate
darwinista : darwinista : (rzecz.) Darwinian
darwinizm : darwinizm : (rzecz.) Darwinism
darzyc : darzyć : (czas.) give
darn : darń : (rzecz.) sod | : (rzecz.) sward | : (rzecz.) turf
daszek : daszek : (rzecz.) caret
daszkowy : daszkowy : (przym.) peaked
data : data : (rzecz.) date
datek : datek : (rzecz.) charity | : (rzecz.) contribution | : (rzecz.) donation | : (rzecz.) handout | : (rzecz.) offering | : (rzecz.) subscription
datowanie : datowanie : (rzecz.) dater
datowany : datowany : (przym.) dated
datowac : datować : (czas.) date
datownik : datownik : (rzecz.) dater | : (rzecz.) date-stamp | : (rzecz.) timestamp
dawac : dawać : (czas.) administer | : (czas.) afford | : (czas.) allow | : (czas.) equip | : (czas.) give | : (czas.) graft | : (czas.) let
dawca : dawca : (rzecz.) donator | : (rzecz.) donor | : (rzecz.) giver
dawka : dawka : (rzecz.) dose | : (rzecz.) drench | : (rzecz.) potion
dawkomierz : dawkomierz : (rzecz.) dosimeter
dawkowanie : dawkowanie : (rzecz.) dosage | : (rzecz.) dose
dawkowac : dawkować : (czas.) dispense | : (czas.) dose
dawkownik : dawkownik : (rzecz.) batcher
dawno : dawno : (przysł.) long
dawnosc : dawność : (rzecz.) antiquity
dawny : dawny : (przym.) ancient | : (przym.) antique | : (przym.) early | : (przym.) former | : (przym.) old | : (przym.) old-time | : (przym.) onetime | : (przym.) one-time | : (przym.) past | : (przym.) pristine
dac : dać : (czas.) afford | : (czas.) contribute | : (czas.) give | : (czas.) incur | : (czas.) tip
dbale : dbale : (przysł.) carefully | : (przysł.) mindfully
dbac : dbać : (czas.) care
dbalosc : dbałość : (rzecz.) care | : (rzecz.) diligence
dbaly : dbały : (przym.) heedful | : (przym.) painstaking
dealer : dealer : (rzecz.) reseller
debata : debata : (rzecz.) argument | : (rzecz.) debate | : (rzecz.) discussion
debatowanie : debatowanie : (rzecz.) discussion
debatowac : debatować : (czas.) debate
debel : debel : (rzecz.) double
debet : debet : (rzecz.) debit | : (rzecz.) overdraft
debil : debil : (rzecz.) fool | : (rzecz.) idiot | : (rzecz.) moron | : (rzecz.) yuk
debilizm : debilizm : (rzecz.) debility
debilny : debilny : (przym.) moronic
debiut : debiut : (rzecz.) debut
debiutant : debiutant : (rzecz.) colt | : (rzecz.) debutant | : (rzecz.) debutante
deblowy : deblowy : (przym.) double
decentralizacja : decentralizacja : (rzecz.) decentralization
decentralizowac : decentralizować : (czas.) decentralize
dech : dech : (rzecz.) breath | : (rzecz.) wind
decha : decha : (rzecz.) board | : (rzecz.) plank
decybel : decybel : (rzecz.) decibel
decydent : decydent : (rzecz.) decision-maker
decydowanie : decydowanie : (rzecz.) decision-making | : (rzecz.) determinative
decydowac : decydować : (czas.) choose | : (czas.) decide | : (czas.) determine
decydujaco : decydująco : (przysł.) decisively | : (przysł.) vitally
decydujacy : decydujący : (przym.) crucial | : (przym.) decisive
decylitr : decylitr : (rzecz.) decilitre
decymetr : decymetr : (rzecz.) decimetre
decyzja : decyzja : (rzecz.) decision | : (rzecz.) resolution | : (rzecz.) ruling
dedukcja : dedukcja : (rzecz.) deduction | : (rzecz.) inference
dedukcyjnie : dedukcyjnie : (przysł.) deductively
dedukcyjny : dedukcyjny : (przym.) deductive
dedukowac : dedukować : (czas.) deduce | : (czas.) infer
dedykacja : dedykacja : (rzecz.) dedication | : (rzecz.) inscription
dedykacyjny : dedykacyjny : (przym.) dedicatory
dedykowany : dedykowany : (przym.) dedicated
dedykowac : dedykować : (czas.) dedicate | : (czas.) inscribe
defekacja : defekacja : (rzecz.) crap | : (rzecz.) defecation
defekowac : defekować : (czas.) defecate
defekt : defekt : (rzecz.) break-down | : (rzecz.) defect | : (rzecz.) defectiveness | : (rzecz.) error | : (rzecz.) fault | : (rzecz.) flaw | : (rzecz.) vice
defektowy : defektowy : (przym.) defective
defenestracja : defenestracja : (rzecz.) defenestration
defensywa : defensywa : (rzecz.) defence | : (rzecz.) defensive
defensywnie : defensywnie : (przysł.) defensively
defensywny : defensywny : (przym.) defensive
defetysta : defetysta : (rzecz.) defeatist
defetystyczny : defetystyczny : (przym.) defeatist
defetyzm : defetyzm : (rzecz.) defeatism
defibrylator : defibrylator : (rzecz.) defibrillator
deficyt : deficyt : (rzecz.) deficiency | : (rzecz.) deficit | : (rzecz.) slippage
deficytowy : deficytowy : (przym.) unprofitable
defilada : defilada : (rzecz.) march-past | : (rzecz.) parade | : (rzecz.) past | : (rzecz.) procession
defilowanie : defilowanie : (rzecz.) parading
defilowac : defilować : (czas.) defile
definicja : definicja : (rzecz.) definition
definicyjny : definicyjny : (przym.) definitional
definiowalny : definiowalny : (przym.) definable
definiowanie : definiowanie : (rzecz.) definition
definiowac : definiować : (czas.) define
definitywnie : definitywnie : (przysł.) definitely | : (przysł.) finally
definitywny : definitywny : (przym.) definitive | : (przym.) final
deflacja : deflacja : (rzecz.) deflation
deflacyjny : deflacyjny : (przym.) deflationary
deflagracja : deflagracja : (rzecz.) deflagration
deflektor : deflektor : (rzecz.) baffle | : (rzecz.) deflector
defloracja : defloracja : (rzecz.) defloration
defoliacja : defoliacja : (rzecz.) defoliation
deforestacja : deforestacja : (rzecz.) deforestation
deformacja : deformacja : (rzecz.) alteration | : (rzecz.) deformation | : (rzecz.) deformity
deformowac : deformować : (czas.) deform | : (czas.) strain
defraudacja : defraudacja : (rzecz.) carding | : (rzecz.) defalcation | : (rzecz.) embezzlement | : (rzecz.) misappropriation | : (rzecz.) peculation
defraudant : defraudant : (rzecz.) defaulter | : (rzecz.) defrauder | : (rzecz.) embezzler
defraudowac : defraudować : (czas.) defalcate | : (czas.) embezzle | : (czas.) misappropriate | : (czas.) peculate
degeneracja : degeneracja : (rzecz.) degeneracy | : (rzecz.) degeneration
degenerat : degenerat : (rzecz.) degenerate
degenerowac : degenerować : (czas.) degenerate
degradacja : degradacja : (rzecz.) aggravation | : (rzecz.) degradation | : (rzecz.) demotion | : (rzecz.) deterioration | : (rzecz.) relegation
degradowac : degradować : (czas.) declass | : (czas.) degrade | : (czas.) demote | : (czas.) lower
degrengolada : degrengolada : (rzecz.) downfall
degustacja : degustacja : (rzecz.) tasting
degustator : degustator : (rzecz.) taster
degustowac : degustować : (czas.) displease | : (czas.) taste
dehumanizacja : dehumanizacja : (rzecz.) dehumanization
dehydratacja : dehydratacja : (rzecz.) dehydration
deifikacja : deifikacja : (rzecz.) deification
deifikowac : deifikować : (czas.) deify
deistyczny : deistyczny : (przym.) deistic | : (przym.) deistical
deizm : deizm : (rzecz.) deism
dejonizacja : dejonizacja : (rzecz.) deionization
dejwud : dejwud : (rzecz.) deadwood
dekada : dekada : (rzecz.) decade
dekadencja : dekadencja : (rzecz.) decadence | : (rzecz.) decadency
dekadencki : dekadencki : (przym.) decadent
dekadent : dekadent : (rzecz.) decadent
dekadentyzm : dekadentyzm : (rzecz.) decadency
dekagram : dekagram : (rzecz.) decagram
dekalkomania : dekalkomania : (rzecz.) decalcomania
dekanat : dekanat : (rzecz.) deanery
dekanter : dekanter : (rzecz.) decanter
dekantowac : dekantować : (czas.) decant
dekapitacja : dekapitacja : (rzecz.) decapitation
dekarbonizacja : dekarbonizacja : (rzecz.) decarbonisation | : (rzecz.) decarbonising
dekarstwo : dekarstwo : (rzecz.) roofing | : (rzecz.) tiling
dekarz : dekarz : (rzecz.) roofer
dekatyzowac : dekatyzować : (czas.) shrink
dekiel : dekiel : (rzecz.) cover | : (rzecz.) hubcap | : (rzecz.) lid
deklamacja : deklamacja : (rzecz.) declamation | : (rzecz.) recitation
deklamacyjny : deklamacyjny : (przym.) recitative
deklamator : deklamator : (rzecz.) declaimer
deklamatorski : deklamatorski : (przym.) declamatory
deklamowanie : deklamowanie : (rzecz.) declamation
deklamowac : deklamować : (czas.) declaim | : (czas.) recite
deklaracja : deklaracja : (rzecz.) declaration | : (rzecz.) testimony
deklaracyjny : deklaracyjny : (przym.) declarative
deklaratywny : deklaratywny : (przym.) declarative | : (przym.) declaratory
deklarowac : deklarować : (czas.) declare | : (czas.) testify
deklasowac : deklasować : (czas.) declass
deklinacja : deklinacja : (rzecz.) declension | : (rzecz.) declination
deklinator : deklinator : (rzecz.) declinometer
deklinowac : deklinować : (czas.) decline
deko : deko : (rzecz.) decagram
dekoder : dekoder : (rzecz.) decoder
dekodowac : dekodować : (czas.) decode | : (czas.) decrypt
dekolonizacja : dekolonizacja : (rzecz.) decolonization
dekolt : dekolt : (rzecz.) cleavage | : (rzecz.) neckline
dekompilacja : dekompilacja : (rzecz.) decompiling | : (rzecz.) reverse
dekomponowac : dekomponować : (czas.) decompose | : (czas.) recompose
dekompozycja : dekompozycja : (rzecz.) decomposition
dekompresja : dekompresja : (rzecz.) decompression
dekonspirowac : dekonspirować : (czas.) unsheathe
dekontaminacja : dekontaminacja : (rzecz.) decontamination
dekontaminowac : dekontaminować : (czas.) decontaminate
dekoracja : dekoracja : (rzecz.) adornment | : (rzecz.) decor | : (rzecz.) decoration | : (rzecz.) dressing | : (rzecz.) ornament | : (rzecz.) scenery
dekoracje : dekoracje : (rzecz.) scenery
dekoracyjnie : dekoracyjnie : (przysł.) ornamentally
dekoracyjnosc : dekoracyjność : (rzecz.) decorative
dekoracyjny : dekoracyjny : (przym.) decorative | : (przym.) fancy | : (przym.) ornamental
dekorator : dekorator : (rzecz.) decorator | : (rzecz.) scene-painter
dekorowanie : dekorowanie : (rzecz.) decoration
dekorowac : dekorować : (czas.) adorn | : (czas.) decorate
dekortykator : dekortykator : (rzecz.) decorticator
dekowanie : dekowanie : (rzecz.) edict | : (rzecz.) tillage
dekrement : dekrement : (rzecz.) decrement | : (rzecz.) decremented | : (rzecz.) decrements
dekrementacja : dekrementacja : (rzecz.) decrement | : (rzecz.) decrementing
dekret : dekret : (rzecz.) decree | : (rzecz.) edict | : (rzecz.) fiat | : (rzecz.) order
dekretowanie : dekretowanie : (rzecz.) decree
dekretowac : dekretować : (czas.) decree
dekretowy : dekretowy : (przym.) decretory
dekstroza : dekstroza : (rzecz.) dextrose
dekstryna : dekstryna : (rzecz.) dextrin
delegacja : delegacja : (rzecz.) delegacy | : (rzecz.) delegation | : (rzecz.) deputation
delegalizowac : delegalizować : (czas.) proscribe
delegat : delegat : (rzecz.) delegate | : (rzecz.) deputy | : (rzecz.) substitute
delegatura : delegatura : (rzecz.) delegacy | : (rzecz.) office
delegowanie : delegowanie : (rzecz.) delegation | : (rzecz.) posting
delegowac : delegować : (czas.) delegate
delektowac : delektować : (czas.) enjoy
delfin : delfin : (rzecz.) dauphin | : (rzecz.) dolphin | : (rzecz.) porpoise
deliberacja : deliberacja : (rzecz.) deliberation | : (rzecz.) meditation
deliberowac : deliberować : (czas.) deliberate
delicja : delicja : (rzecz.) delicacies | : (rzecz.) delicacy | : (rzecz.) relish
delikates : delikates : (rzecz.) delicacy | : (rzecz.) delicatessen | : (rzecz.) plum
delikatnie : delikatnie : (przysł.) daintily | : (przysł.) delicately | : (przysł.) fondly | : (przysł.) gently | : (przysł.) gingerly | : (przysł.) slightly | : (przysł.) tenderly
delikatnosc : delikatność : (rzecz.) daintiness | : (rzecz.) delicacy | : (rzecz.) finesse | : (rzecz.) fondness | : (rzecz.) gentleness | : (rzecz.) mildness | : (rzecz.) nicety | : (rzecz.) sensitivity | : (rzecz.) slightness | : (rzecz.) softness | : (rzecz.) tact | : (rzecz.) tender | : (rzecz.) tenderness
delikatny : delikatny : (przym.) dainty | : (przym.) delicate | : (przym.) exquisite | : (przym.) fine | : (przym.) fine-spun | : (przym.) fond | : (przym.) fragile | : (przym.) gentle | : (przym.) gentlest | : (przym.) mild | : (przym.) nice | : (przym.) queasy | : (przym.) sappy | : (przym.) scabrous | : (przym.) sensitive | : (przym.) silken | : (przym.) soft | : (przym.) squeamish | : (przym.) sweet | : (przym.) tender | : (przym.) tenuous | : (przym.) thin-skinned | : (przym.) ticklish
delikt : delikt : (rzecz.) tort
delikwent : delikwent : (rzecz.) delinquent | : (rzecz.) felon | : (rzecz.) lawbreaker
delimitacja : delimitacja : (rzecz.) delimitation
deliryczny : deliryczny : (przym.) delirious
delta : delta : (rzecz.) delta
deltoid : deltoid : (rzecz.) deltoid
deltowy : deltowy : (przym.) deltaic
demagnetyzacja : demagnetyzacja : (rzecz.) demagnetization
demagog : demagog : (rzecz.) demagogue
demagogia : demagogia : (rzecz.) demagoguery | : (rzecz.) demagogy
demagogiczny : demagogiczny : (przym.) demagogic
demarkacja : demarkacja : (rzecz.) demarcation
demaskowac : demaskować : (czas.) debunk | : (czas.) disclose | : (czas.) expose | : (czas.) unmask
dematerializacja : dematerializacja : (rzecz.) dematerialization
demencja : demencja : (rzecz.) dementia
dementowanie : dementowanie : (rzecz.) belying
dementowac : dementować : (czas.) belie | : (czas.) deny | : (czas.) disagree
demilitaryzacja : demilitaryzacja : (rzecz.) demilitarization
demineralizacja : demineralizacja : (rzecz.) demineralization
demitologizacja : demitologizacja : (rzecz.) exposure
demitologizowac : demitologizować : (czas.) demythologize
demiurg : demiurg : (rzecz.) demiurge
demo : demo : (rzecz.) demo
demobilizacja : demobilizacja : (rzecz.) demobilization
demobilizacyjny : demobilizacyjny : (przym.) demobilising
demobilizowac : demobilizować : (czas.) decommission | : (czas.) demob | : (czas.) demobilize
demodulacja : demodulacja : (rzecz.) demodulation
demodulator : demodulator : (rzecz.) demodulator
demodulowac : demodulować : (czas.) demodulate
demografia : demografia : (rzecz.) demographics | : (rzecz.) demography
demograficznie : demograficznie : (przysł.) demographically
demograficzny : demograficzny : (przym.) demographic
demokracja : demokracja : (rzecz.) democracy
demokrata : demokrata : (rzecz.) democrat
demokratycznie : demokratycznie : (przysł.) democratically
demokratyczny : demokratyczny : (przym.) democratic
demokratyzacja : demokratyzacja : (rzecz.) democratization
demokratyzowac : demokratyzować : (czas.) democratize
demolowac : demolować : (czas.) demolish | : (czas.) smash | : (czas.) vandalize
demon : demon : (rzecz.) daemon | : (rzecz.) demon
demonetyzacja : demonetyzacja : (rzecz.) demonetization
demonicznie : demonicznie : (przysł.) demonically
demoniczny : demoniczny : (przym.) demoniac | : (przym.) demoniacal | : (przym.) demonic
demonizowac : demonizować : (czas.) demonize | : (czas.) demonized
demonologia : demonologia : (rzecz.) demonology | : (rzecz.) devilry
demonstracja : demonstracja : (rzecz.) demo | : (rzecz.) demonstration | : (rzecz.) presentation
demonstracyjny : demonstracyjny : (przym.) demonstrative | : (przym.) ostentatious
demonstrant : demonstrant : (rzecz.) demonstrator | : (rzecz.) protester | : (rzecz.) rioter
demonstrowac : demonstrować : (czas.) demonstrate | : (czas.) show
demontaz : demontaż : (rzecz.) disassembly
demontowac : demontować : (czas.) demount | : (czas.) disassemble | : (czas.) dismantle | : (czas.) dismount
demoralizacja : demoralizacja : (rzecz.) demoralization | : (rzecz.) depravity
demoralizowac : demoralizować : (czas.) demoralize | : (czas.) deprave | : (czas.) pervert
demotyczny : demotyczny : (przym.) demotic
demulgator : demulgator : (rzecz.) de-emulsifier
demulgowanie : demulgowanie : (rzecz.) de-emulsification
demulgowac : demulgować : (czas.) demulsify
demultiplekser : demultiplekser : (rzecz.) selector
denacjonalizacja : denacjonalizacja : (rzecz.) denationalization
denat : denat : (rzecz.) suicide
denaturalizacja : denaturalizacja : (rzecz.) denaturalization
denaturalizowac : denaturalizować : (czas.) denaturalize
denaturowanie : denaturowanie : (rzecz.) denaturing
denaturowac : denaturować : (czas.) denature
dendrolog : dendrolog : (rzecz.) dendrologist
dendrologia : dendrologia : (rzecz.) dendrology
dendryt : dendryt : (rzecz.) dendrite
denerwowanie : denerwowanie : (rzecz.) excitement | : (rzecz.) fluster
denerwowac : denerwować : (czas.) aggravate | : (czas.) annoy | : (czas.) displease | : (czas.) fidget | : (czas.) fluster | : (czas.) fret | : (czas.) irritate
denerwujacy : denerwujący : (przym.) infuriating
denier : denier : (rzecz.) denier
denko : denko : (rzecz.) web
denny : denny : (przym.) benthic | : (przym.) longitudinal
denominacja : denominacja : (rzecz.) denomination | : (rzecz.) redenomination
denotacja : denotacja : (rzecz.) denotation
densymetr : densymetr : (rzecz.) densitometer
densytometr : densytometr : (rzecz.) densitometer
densytometria : densytometria : (rzecz.) densitometry
dentyna : dentyna : (rzecz.) dentine
dentysta : dentysta : (rzecz.) dentist
dentystyczny : dentystyczny : (przym.) dental | : (przym.) dentist's
dentystyka : dentystyka : (rzecz.) dentistry
denudacja : denudacja : (rzecz.) denudation
denuncjacja : denuncjacja : (rzecz.) denunciation
denuncjant : denuncjant : (rzecz.) informer | : (rzecz.) telltale
denuncjator : denuncjator : (rzecz.) denunciator | : (rzecz.) informer
denuncjowac : denuncjować : (czas.) denounce
deontologia : deontologia : (rzecz.) deontology
departament : departament : (rzecz.) department
depersonalizacja : depersonalizacja : (rzecz.) depersonalisation | : (rzecz.) depersonalization
depesza : depesza : (rzecz.) cable | : (rzecz.) cablegram | : (rzecz.) dispatch | : (rzecz.) telegram | : (rzecz.) wire
depeszowac : depeszować : (czas.) cable | : (czas.) telegraph
depilacja : depilacja : (rzecz.) depilation
depilacyjny : depilacyjny : (przym.) depilating | : (przym.) depilatory
depilator : depilator : (rzecz.) depilatory | : (rzecz.) epilator
depilowac : depilować : (czas.) depilate
depolaryzacja : depolaryzacja : (rzecz.) depolarisation | : (rzecz.) depolarization
depolaryzator : depolaryzator : (rzecz.) depolarizer
depolaryzowac : depolaryzować : (czas.) depolarize
deponent : deponent : (rzecz.) depositor
deponowac : deponować : (czas.) deposit | : (czas.) lodge
deportacja : deportacja : (rzecz.) deportation | : (rzecz.) removal | : (rzecz.) transportation
deportowanie : deportowanie : (rzecz.) deportation
deportowac : deportować : (czas.) deport
depozyt : depozyt : (rzecz.) deposit | : (rzecz.) depository | : (rzecz.) escrow
depozytariusz : depozytariusz : (rzecz.) depositary
depozytor : depozytor : (rzecz.) depositor
depozytowy : depozytowy : (przym.) custodial
deprawacja : deprawacja : (rzecz.) depravation | : (rzecz.) depravity
deprawowac : deprawować : (czas.) demoralize | : (czas.) deprave | : (czas.) pervert
deprecjacja : deprecjacja : (rzecz.) debasement | : (rzecz.) depreciation
deprecjonowac : deprecjonować : (czas.) debase | : (czas.) depreciate
depresja : depresja : (rzecz.) abatement | : (rzecz.) depression
depresyjny : depresyjny : (przym.) depressive
deprymowac : deprymować : (czas.) deject
deptak : deptak : (rzecz.) pedestrian | : (rzecz.) promenade | : (rzecz.) walk
deptanie : deptanie : (rzecz.) dept
deptac : deptać : (czas.) tramp | : (czas.) trample | : (czas.) tread
deputacja : deputacja : (rzecz.) deputation
deputat : deputat : (rzecz.) allowance
deputowany : deputowany : (przym.) deputy
deregulacja : deregulacja : (rzecz.) deregulation
dereniowy : dereniowy : (przym.) dogberry
dereszowaty : dereszowaty : (przym.) roan
deren : dereń : (rzecz.) dogberry | : (rzecz.) dogwood
derka : derka : (rzecz.) blanket | : (rzecz.) manta | : (rzecz.) rug | : (rzecz.) saddlecloth
derkacz : derkacz : (rzecz.) landrail
derma : derma : (rzecz.) leatherette
dermatolog : dermatolog : (rzecz.) dermatologist
dermatologia : dermatologia : (rzecz.) dermatology
dermatologiczny : dermatologiczny : (przym.) dermatological
derogacja : derogacja : (rzecz.) derogation
derywacja : derywacja : (rzecz.) derivation
derywat : derywat : (rzecz.) derivative
derywowac : derywować : (czas.) derive
desant : desant : (rzecz.) descent | : (rzecz.) embarkation | : (rzecz.) landing
desantowiec : desantowiec : (rzecz.) ranger
desegregacja : desegregacja : (rzecz.) desegregation
desensybilizacja : desensybilizacja : (rzecz.) desensitization
deser : deser : (rzecz.) afters | : (rzecz.) dessert | : (rzecz.) pudding
desen : deseń : (rzecz.) design | : (rzecz.) pattern
deska : deska : (rzecz.) board | : (rzecz.) breadboard | : (rzecz.) pegboard | : (rzecz.) plank | : (rzecz.) trencher
deskorolka : deskorolka : (rzecz.) skate | : (rzecz.) skateboard
deskowanie : deskowanie : (rzecz.) boarding | : (rzecz.) formwork | : (rzecz.) planking | : (rzecz.) sheeting
deskrypcja : deskrypcja : (rzecz.) description
deskryptor : deskryptor : (rzecz.) descriptor
desperacja : desperacja : (rzecz.) despair | : (rzecz.) desperation | : (rzecz.) hopelessness
desperacki : desperacki : (przym.) desperate
desperat : desperat : (rzecz.) desperado
desperowac : desperować : (czas.) despair
despota : despota : (rzecz.) despot | : (rzecz.) tyrant
despotycznie : despotycznie : (przysł.) domineeringly | : (przysł.) tyrannically
despotyczny : despotyczny : (przym.) authoritarian | : (przym.) despotic | : (przym.) highhanded | : (przym.) high-handed | : (przym.) oppressive | : (przym.) overbearing
despotyzm : despotyzm : (rzecz.) despotism | : (rzecz.) tyranny
dessous : dessous : (rzecz.) petticoat
destabilizacja : destabilizacja : (rzecz.) destabilisation | : (rzecz.) destabilization
destabilizowanie : destabilizowanie : (rzecz.) destabilizing
destabilizowac : destabilizować : (czas.) destabilize
destrukcja : destrukcja : (rzecz.) destruction | : (rzecz.) ruin
destrukcyjnosc : destrukcyjność : (rzecz.) destructiveness
destrukcyjny : destrukcyjny : (przym.) destructive | : (przym.) devastating | : (przym.) disruptive
destruktor : destruktor : (rzecz.) destructor | : (rzecz.) garbage
destruktywny : destruktywny : (przym.) destructive
destylacja : destylacja : (rzecz.) distillation
destylacyjny : destylacyjny : (przym.) distillatory
destylarnia : destylarnia : (rzecz.) distillery | : (rzecz.) still
destylat : destylat : (rzecz.) distillate
destylator : destylator : (rzecz.) distiller | : (rzecz.) still
destylowac : destylować : (czas.) distil
desygnacja : desygnacja : (rzecz.) designation | : (rzecz.) nomination
desygnator : desygnator : (rzecz.) designator
desygnowac : desygnować : (czas.) designate | : (czas.) nominate
desykant : desykant : (rzecz.) desiccant
deszcz : deszcz : (rzecz.) downpour | : (rzecz.) rain | : (rzecz.) rainfall
deszczomierz : deszczomierz : (rzecz.) rain-gauge
deszczoodporny : deszczoodporny : (przym.) rainproof
deszczowanie : deszczowanie : (rzecz.) sprinkling
deszczowiec : deszczowiec : (rzecz.) galosh | : (rzecz.) raincoat
deszczowy : deszczowy : (przym.) pluvial | : (przym.) rainy | : (przym.) showery | : (przym.) wet | : (przym.) wetted | : (przym.) wettest
deszczulka : deszczułka : (rzecz.) lath | : (rzecz.) slat | : (rzecz.) splint | : (rzecz.) trencher
deszczyk : deszczyk : (rzecz.) drizzle
deszczowka : deszczówka : (rzecz.) rainwater | : (rzecz.) rain-water
deszyfracja : deszyfracja : (rzecz.) decryption
deszyfrator : deszyfrator : (rzecz.) descrambler
deszyfrowanie : deszyfrowanie : (rzecz.) decipherment | : (rzecz.) decrypting | : (rzecz.) decryption
deszyfrowac : deszyfrować : (czas.) decrypt
detal : detal : (rzecz.) article | : (rzecz.) detail | : (rzecz.) retail
detaliczny : detaliczny : (przym.) retail
detalista : detalista : (rzecz.) retailer
detekcja : detekcja : (rzecz.) detection
detektor : detektor : (rzecz.) coherer | : (rzecz.) detector
detektyw : detektyw : (rzecz.) detective | : (rzecz.) investigator | : (rzecz.) sleuth
detektywistyczny : detektywistyczny : (przym.) detective
detergent : detergent : (rzecz.) detergent
deterioracja : deterioracja : (rzecz.) deterioration
determinacja : determinacja : (rzecz.) determination | : (rzecz.) drive | : (rzecz.) resoluteness
determinanta : determinanta : (rzecz.) determinant
deterministyczny : deterministyczny : (przym.) deterministic
determinizm : determinizm : (rzecz.) determinism
determinowac : determinować : (czas.) determine | : (czas.) govern | : (czas.) predetermine
detoksykacja : detoksykacja : (rzecz.) detoxification
detonacja : detonacja : (rzecz.) detonation | : (rzecz.) explosion | : (rzecz.) peal | : (rzecz.) report
detonowac : detonować : (czas.) detonate
detronizacja : detronizacja : (rzecz.) deposition | : (rzecz.) dethronement
detronizowanie : detronizowanie : (rzecz.) dethronement
detronizowac : detronizować : (czas.) dethrone
detrytus : detrytus : (rzecz.) detritus
deuter : deuter : (rzecz.) deuterium
deuteron : deuteron : (rzecz.) deuteron
dewaluacja : dewaluacja : (rzecz.) depreciation | : (rzecz.) devaluation
dewaluowac : dewaluować : (czas.) devaluate | : (czas.) devalue
dewastacja : dewastacja : (rzecz.) desolation | : (rzecz.) devastation | : (rzecz.) ravage | : (rzecz.) vandalism
dewastator : dewastator : (rzecz.) devastator
dewastowac : dewastować : (czas.) devastate | : (czas.) ravage | : (czas.) vandalize
dewiacja : dewiacja : (rzecz.) aberration | : (rzecz.) deviance | : (rzecz.) deviation
dewiacyjny : dewiacyjny : (przym.) deviant | : (przym.) deviatory
dewiator : dewiator : (rzecz.) deviator
dewiza : dewiza : (rzecz.) device | : (rzecz.) motto | : (rzecz.) slogan | : (rzecz.) watchword
dewizka : dewizka : (rzecz.) fob | : (rzecz.) watch-chain
dewizowy : dewizowy : (przym.) foreign-currency
dewocja : dewocja : (rzecz.) bigotry | : (rzecz.) devotion
dezaktywacja : dezaktywacja : (rzecz.) deactivation
dezaktywowac : dezaktywować : (czas.) deactivate | : (czas.) decontaminate
dezaprobata : dezaprobata : (rzecz.) deprecation | : (rzecz.) disapprobation | : (rzecz.) disapproval
dezaprobowac : dezaprobować : (czas.) disapprove | : (czas.) discountenance
dezasemblowanie : dezasemblowanie : (rzecz.) disassembling
dezasemblowac : dezasemblować : (czas.) disassemble
dezawuowac : dezawuować : (czas.) disavow | : (czas.) disown
dezercja : dezercja : (rzecz.) defection | : (rzecz.) desertion
dezerter : dezerter : (rzecz.) defector | : (rzecz.) deserter
dezerterowac : dezerterować : (czas.) desert
dezinformacja : dezinformacja : (rzecz.) disinformation | : (rzecz.) misinformation
dezintegracja : dezintegracja : (rzecz.) disintegration
dezintegrator : dezintegrator : (rzecz.) disintegrator
dezodorant : dezodorant : (rzecz.) deodorant | : (rzecz.) deodorizer
dezodoryzacja : dezodoryzacja : (rzecz.) deodorisation | : (rzecz.) deodorization
dezodoryzowac : dezodoryzować : (czas.) deodorize
dezorganizacja : dezorganizacja : (rzecz.) confusion | : (rzecz.) derangement | : (rzecz.) disorganization
dezorganizowac : dezorganizować : (czas.) derange | : (czas.) disarrange | : (czas.) discompose | : (czas.) disorganize | : (czas.) unsettle
dezorientacja : dezorientacja : (rzecz.) bewilderment | : (rzecz.) confusion | : (rzecz.) disorientation
dezorientowac : dezorientować : (czas.) confuse | : (czas.) disorientate
dezyderat : dezyderat : (rzecz.) desideratum
dezyderaty : dezyderaty : (rzecz.) desiderata
dezynfekcja : dezynfekcja : (rzecz.) disinfectant | : (rzecz.) disinfection | : (rzecz.) sterilisation
dezynfekowac : dezynfekować : (czas.) disinfect
dezynfekujacy : dezynfekujący : (przym.) disinfectant
dezyntegrator : dezyntegrator : (rzecz.) disintegrator
diabelnie : diabelnie : (przysł.) cursedly | : (przysł.) deucedly
diabelny : diabelny : (przym.) confounded | : (przym.) deuced
diabelski : diabelski : (przym.) deuced | : (przym.) devilfish | : (przym.) devilish | : (przym.) diabolic | : (przym.) diabolical | : (przym.) fiendish | : (przym.) hellish | : (przym.) infernal
diabelsko : diabelsko : (przysł.) devilish | : (przysł.) devilishly | : (przysł.) fiendishly
diabelstwo : diabelstwo : (rzecz.) devilment | : (rzecz.) devilry
diabetyk : diabetyk : (rzecz.) diabetes | : (rzecz.) diabetic
diabel : diabeł : (rzecz.) deuce | : (rzecz.) devil | : (rzecz.) dickens | : (rzecz.) fiend | : (rzecz.) serpent
diabelek : diabełek : (rzecz.) imp
diablica : diablica : (rzecz.) shrew
diaboliczny : diaboliczny : (przym.) diabetic | : (przym.) diabolic | : (przym.) diabolical | : (przym.) satanic
diadem : diadem : (rzecz.) chaplet | : (rzecz.) crown | : (rzecz.) diadem | : (rzecz.) tiara
diafon : diafon : (rzecz.) diaphone
diafragma : diafragma : (rzecz.) diaphragm
diagnosta : diagnosta : (rzecz.) diagnostician
diagnostyczny : diagnostyczny : (przym.) diagnostic
diagnostyka : diagnostyka : (rzecz.) diagnosis | : (rzecz.) diagnostic | : (rzecz.) diagnostics
diagnoza : diagnoza : (rzecz.) diagnosis
diagnozowalny : diagnozowalny : (przym.) diagnosable
diagnozowanie : diagnozowanie : (rzecz.) diagnosis | : (rzecz.) troubleshooting
diagnozowac : diagnozować : (czas.) diagnose
diagonal : diagonal : (rzecz.) twill
diagonalnie : diagonalnie : (przysł.) diagonally
diagonalny : diagonalny : (przym.) diagonal
diagram : diagram : (rzecz.) diagram
diakon : diakon : (rzecz.) deacon
diakonisa : diakonisa : (rzecz.) deaconess
diakrytyczny : diakrytyczny : (przym.) diacritic | : (przym.) diacritical
dialekt : dialekt : (rzecz.) dialect
dialektalny : dialektalny : (przym.) dialectal
dialektologia : dialektologia : (rzecz.) dialectology
dialektowy : dialektowy : (przym.) dialectical
dialektyczny : dialektyczny : (przym.) dialectical
dialektyk : dialektyk : (rzecz.) dialectician
dialektyka : dialektyka : (rzecz.) dialectician | : (rzecz.) dialectics
dializa : dializa : (rzecz.) dialysis
dialog : dialog : (rzecz.) dialog | : (rzecz.) dialogue | : (rzecz.) duologue
dialogit : dialogit : (rzecz.) dialogite
dialogowy : dialogowy : (przym.) conversational
diamagnetyczny : diamagnetyczny : (przym.) diamagnetic
diamagnetyzm : diamagnetyzm : (rzecz.) diamagnetism
diament : diament : (rzecz.) adamant | : (rzecz.) diamond | : (rzecz.) sparkler
diamentowy : diamentowy : (przym.) adamantine
diametralnie : diametralnie : (przysł.) diametrically
diametralny : diametralny : (przym.) diametric | : (przym.) diametrical
diapazon : diapazon : (rzecz.) diapason
diapozytyw : diapozytyw : (rzecz.) filmstrip | : (rzecz.) slide
diariusz : diariusz : (rzecz.) diary
diaskop : diaskop : (rzecz.) slide
diastaza : diastaza : (rzecz.) diastase
diastrofizm : diastrofizm : (rzecz.) diastrophism
diatermia : diatermia : (rzecz.) diathermy
diatoniczny : diatoniczny : (przym.) diatonic
diatryba : diatryba : (rzecz.) diatribe
diecezja : diecezja : (rzecz.) bishopric | : (rzecz.) diocese
diecezjalny : diecezjalny : (przym.) diocesan
dielektryczny : dielektryczny : (przym.) dielectric
dielektryk : dielektryk : (rzecz.) dielectric
dieta : dieta : (rzecz.) allowance | : (rzecz.) diet
dietetyczny : dietetyczny : (przym.) dietary | : (przym.) dietetic
dietetyk : dietetyk : (rzecz.) dietician | : (rzecz.) nutrition | : (rzecz.) nutritionist
dietetyka : dietetyka : (rzecz.) dietetics
digitalizacja : digitalizacja : (rzecz.) digitalisation | : (rzecz.) digitization | : (rzecz.) digitizing
diler : diler : (rzecz.) dealer | : (rzecz.) peddler
dinozaur : dinozaur : (rzecz.) dinosaur
dinozaury : dinozaury : (rzecz.) dinosaurs
dioda : dioda : (rzecz.) diode
dioda-pentoda : dioda-pentoda : (rzecz.) diode-pentode
dioryt : dioryt : (rzecz.) diorite
diplekser : diplekser : (rzecz.) diplexer
dipol : dipol : (rzecz.) dipole
dipolowy : dipolowy : (przym.) dipolar
diwa : diwa : (rzecz.) diva
dla : dla : (przyim.) for
dlaczego : dlaczego : (przysł.) wherefore
dlatego : dlatego : (przysł.) consequently | : (przysł.) so | : (przysł.) therefore | : (przysł.) thereupon | : (przysł.) wherefore
dmuch : dmuch : (rzecz.) wind
dmuchacz : dmuchacz : (rzecz.) blower | : (rzecz.) glassblower | : (rzecz.) glass-blower
dmuchanie : dmuchanie : (rzecz.) blowing
dmuchawa : dmuchawa : (rzecz.) blower | : (rzecz.) blowpipe | : (rzecz.) fan
dmuchawiec : dmuchawiec : (rzecz.) dandelion | : (rzecz.) low-ball
dmuchawka : dmuchawka : (rzecz.) bellows
dmuchac : dmuchać : (czas.) blow | : (czas.) puff
dmuchniecie : dmuchnięcie : (rzecz.) puff | : (rzecz.) whiff
dniec : dnieć : (czas.) light
dniowkowy : dniówkowy : (przym.) daily
dno : dno : (rzecz.) bed | : (rzecz.) bilge | : (rzecz.) bottom | : (rzecz.) bottoming | : (rzecz.) floor | : (rzecz.) ground
do : do : (przyim.) by | : (przyim.) for | : (przyim.) in | : (przyim.) into | : (przyim.) on | : (przyim.) onto | : (przyim.) to | : (przyim.) until | : (przyim.) unto
doba : doba : (rzecz.) day | : (rzecz.) hours
dobicie : dobicie : (rzecz.) finisher
dobiegac : dobiegać : (czas.) approach
dobierac : dobierać : (czas.) assort | : (czas.) select | : (czas.) selected | : (czas.) sort
dobijac : dobijać : (czas.) knock
dobitnie : dobitnie : (przysł.) distinctly | : (przysł.) impressively | : (przysł.) markedly | : (przysł.) strongly
dobitnosc : dobitność : (rzecz.) clearness | : (rzecz.) emphasis
dobitny : dobitny : (przym.) distinct | : (przym.) emphatic | : (przym.) expressive | : (przym.) forcible | : (przym.) strong
dobniak : dobniak : (rzecz.) beetle
doborowosc : doborowość : (rzecz.) excellence
doborowy : doborowy : (przym.) excellent | : (przym.) picked | : (przym.) select
dobosz : dobosz : (rzecz.) drum | : (rzecz.) drummer
dobowy : dobowy : (przym.) daily | : (przym.) diurnal
dobranoc : dobranoc : (rzecz.) goodnight | : (rzecz.) good-night
dobrnac : dobrnąć : (czas.) reach
dobro : dobro : (rzecz.) gong | : (rzecz.) weal | : (rzecz.) welfare
dobrobyt : dobrobyt : (rzecz.) affluence | : (rzecz.) prosperity | : (rzecz.) wealth | : (rzecz.) welfare | : (rzecz.) wellbeing | : (rzecz.) well-being
dobroczynnosc : dobroczynność : (rzecz.) beneficence | : (rzecz.) benevolence | : (rzecz.) charity | : (rzecz.) philanthropy
dobroczynny : dobroczynny : (przym.) beneficent | : (przym.) beneficial | : (przym.) benevolent | : (przym.) benign | : (przym.) charitable | : (przym.) kindly | : (przym.) salutary
dobroczynca : dobroczyńca : (rzecz.) benefactor
dobrodusznosc : dobroduszność : (rzecz.) bonhomie | : (rzecz.) kind-heartedness
dobroduszny : dobroduszny : (przym.) good-humoured | : (przym.) good-natured
dobrodziej : dobrodziej : (rzecz.) benefactor | : (rzecz.) benefactors
dobrodziejstwo : dobrodziejstwo : (rzecz.) benefaction | : (rzecz.) benefit | : (rzecz.) blessing
dobrotliwie : dobrotliwie : (przysł.) blandly
dobrotliwosc : dobrotliwość : (rzecz.) blandness
dobrotliwy : dobrotliwy : (przym.) benevolent | : (przym.) benignant | : (przym.) bland | : (przym.) genial | : (przym.) good-natured | : (przym.) kind-hearted | : (przym.) kindly
dobrowolnie : dobrowolnie : (przysł.) voluntarily
dobrowolnosc : dobrowolność : (rzecz.) voluntary
dobrowolny : dobrowolny : (przym.) discretional | : (przym.) discretionary | : (przym.) gratuitous | : (przym.) volitional
dobroc : dobroć : (rzecz.) better | : (rzecz.) friendliness | : (rzecz.) goodness | : (rzecz.) kindliness | : (rzecz.) kindness | : (rzecz.) virtue
dobry : dobry : (przym.) amiable | : (przym.) benign | : (przym.) good | : (przym.) hunky-dory | : (przym.) kind | : (przym.) kind-hearted | : (przym.) kindly | : (przym.) right | : (przym.) warm-hearted | : (przym.) welled
dobrze : dobrze : (przysł.) alright | : (przysł.) aright | : (przysł.) fine | : (przysł.) right
dobudowac : dobudować : (czas.) build
dobudowka : dobudówka : (rzecz.) annexe | : (rzecz.) extension | : (rzecz.) outbuilding | : (rzecz.) outhouse
dobytek : dobytek : (rzecz.) belonging | : (rzecz.) belongings | : (rzecz.) chattel | : (rzecz.) effect | : (rzecz.) having | : (rzecz.) possession | : (rzecz.) property
dobywac : dobywać : (czas.) produce
dobyc : dobyć : (czas.) draw
dobor : dobór : (rzecz.) assortment | : (rzecz.) choice | : (rzecz.) match | : (rzecz.) selection
doceniac : doceniać : (czas.) appreciate | : (czas.) underestimate
docenic : docenić : (czas.) appreciate
docent : docent : (rzecz.) teacher
docentura : docentura : (rzecz.) readership
dochodowosc : dochodowość : (rzecz.) profitableness
dochodowy : dochodowy : (przym.) lucrative | : (przym.) moneymaking | : (przym.) payable | : (przym.) profitable | : (przym.) profit-making | : (przym.) remunerative | : (przym.) rewarding
dochodzenie : dochodzenie : (rzecz.) inquiry | : (rzecz.) investigation | : (rzecz.) prosecution
dochodzeniowy : dochodzeniowy : (przym.) investigative
dochodzic : dochodzić : (czas.) added | : (czas.) assert | : (czas.) come | : (czas.) reach | : (czas.) strike | : (czas.) supervene
dochowac : dochować : (czas.) preserve | : (czas.) remain
dochod : dochód : (rzecz.) benefice | : (rzecz.) income | : (rzecz.) proceeds | : (rzecz.) profit | : (rzecz.) return | : (rzecz.) revenue | : (rzecz.) taking
dociekanie : dociekanie : (rzecz.) exam | : (rzecz.) examination | : (rzecz.) investigation | : (rzecz.) study
dociekac : dociekać : (czas.) inquire | : (czas.) investigate
dociekliwie : dociekliwie : (przysł.) inquisitively
dociekliwosc : dociekliwość : (rzecz.) inquisitiveness
dociekliwy : dociekliwy : (przym.) curious | : (przym.) inquiring | : (przym.) inquisitive | : (przym.) searching
docierak : docierak : (rzecz.) lap
docieranie : docieranie : (rzecz.) break-in
docierac : docierać : (czas.) attain | : (czas.) reach
docinac : docinać : (czas.) taunt | : (czas.) tease
docinek : docinek : (rzecz.) gibe | : (rzecz.) jeer | : (rzecz.) kicker | : (rzecz.) sally | : (rzecz.) shot
docisk : docisk : (rzecz.) clamp | : (rzecz.) holdfast
dociskac : dociskać : (czas.) clamp | : (czas.) depress | : (czas.) subtend | : (czas.) tighten
dociac : dociąć : (czas.) cut
docisniecie : dociśnięcie : (rzecz.) pressing
doczekac : doczekać : (czas.) abide | : (czas.) wait
doczepka : doczepka : (rzecz.) trailer
doczesnosc : doczesność : (rzecz.) temporality
doczesny : doczesny : (przym.) earthly | : (przym.) mundane | : (przym.) temporal | : (przym.) terrestrial | : (przym.) worldly
doczesnie : docześnie : (przysł.) temporally
doczyszczac : doczyszczać : (czas.) clean
dodaj : dodaj : (rzecz.) add-or-subtract
dodajnik : dodajnik : (rzecz.) addend
dodanie : dodanie : (rzecz.) addition
dodatek : dodatek : (rzecz.) accessory | : (rzecz.) accompaniment | : (rzecz.) addendum | : (rzecz.) add-in | : (rzecz.) adding | : (rzecz.) addition | : (rzecz.) additive | : (rzecz.) add-on | : (rzecz.) adjunct | : (rzecz.) allowance | : (rzecz.) annex | : (rzecz.) appendage | : (rzecz.) appendix | : (rzecz.) bonus | : (rzecz.) complement | : (rzecz.) condiment | : (rzecz.) dope | : (rzecz.) enclosure | : (rzecz.) exordium | : (rzecz.) extra | : (rzecz.) plug-in | : (rzecz.) premium | : (rzecz.) pullout | : (rzecz.) pull-out | : (rzecz.) spice | : (rzecz.) supplement | : (rzecz.) surplus
dodatki : dodatki : (rzecz.) accessories
dodatkowo : dodatkowo : (przysł.) additionally | : (przysł.) extra
dodatkowy : dodatkowy : (przym.) additional | : (przym.) another | : (przym.) collateral | : (przym.) duplicate | : (przym.) excess | : (przym.) extra | : (przym.) further | : (przym.) odd | : (przym.) optional | : (przym.) plus | : (przym.) secondary | : (przym.) subsidiary | : (przym.) supplemental | : (przym.) supplementary | : (przym.) surplus
dodatni : dodatni : (przym.) additional | : (przym.) plus | : (przym.) positive
dodatnio : dodatnio : (przysł.) positively
dodawanie : dodawanie : (rzecz.) adding | : (rzecz.) addition | : (rzecz.) admixture | : (rzecz.) summation
dodawac : dodawać : (czas.) add | : (czas.) append | : (czas.) eke | : (czas.) hearten | : (czas.) lend | : (czas.) sum
dodawac-odejmowac : dodawać-odejmować : (czas.) add-subtract
dodac : dodać : (czas.) add | : (czas.) affix | : (czas.) append | : (czas.) impart | : (czas.) put
dodruk : dodruk : (rzecz.) impression | : (rzecz.) imprint
dofermentowanie : dofermentowanie : (rzecz.) after-fermentation
dofinansowanie : dofinansowanie : (rzecz.) bailout | : (rzecz.) grant | : (rzecz.) refinancing
dogadzanie : dogadzanie : (rzecz.) indulgence
dogadzac : dogadzać : (czas.) indulge | : (czas.) pander | : (czas.) please | : (czas.) satisfy
doganiac : doganiać : (czas.) catch | : (czas.) forereach | : (czas.) fore-reach | : (czas.) overtake
doglad : dogląd : (rzecz.) care | : (rzecz.) superintendence | : (rzecz.) supervision
dogladanie : doglądanie : (rzecz.) care | : (rzecz.) superintendence
dogladac : doglądać : (czas.) inspect | : (czas.) mind | : (czas.) nurse | : (czas.) oversee | : (czas.) superintend | : (czas.) supervise | : (czas.) tend
dogmat : dogmat : (rzecz.) dogma | : (rzecz.) tenet
dogmatycznie : dogmatycznie : (przysł.) dogmatically
dogmatyczny : dogmatyczny : (przym.) dogmatic | : (przym.) opinionated
dogmatyk : dogmatyk : (rzecz.) bigot | : (rzecz.) dogmatist
dogmatyzm : dogmatyzm : (rzecz.) dogmatism
dogmatyzowac : dogmatyzować : (czas.) dogmatize
dogniatanie : dogniatanie : (rzecz.) burnish
dogodnie : dogodnie : (przysł.) conveniently
dogodnosc : dogodność : (rzecz.) convenience
dogodny : dogodny : (przym.) attractive | : (przym.) convenient | : (przym.) good | : (przym.) handy | : (przym.) opportune
dogonic : dogonić : (czas.) catch | : (czas.) reach
dogrywka : dogrywka : (rzecz.) overtime | : (rzecz.) playoff | : (rzecz.) play-off | : (rzecz.) runoff | : (rzecz.) run-off
dogryzac : dogryzać : (czas.) sting
dogrzac : dogrzać : (czas.) heat | : (czas.) scorch
doglebnie : dogłębnie : (przysł.) profoundly
doglebnosc : dogłębność : (rzecz.) depth
doglebny : dogłębny : (przym.) thorough
doic : doić : (czas.) milk
dojarka : dojarka : (rzecz.) dairymaid | : (rzecz.) milkmaid
dojarz : dojarz : (rzecz.) dairyman
dojazd : dojazd : (rzecz.) access | : (rzecz.) approach
dojazdowy : dojazdowy : (przym.) accessible
dojechac : dojechać : (czas.) approach | : (czas.) get | : (czas.) reach
dojenie : dojenie : (rzecz.) milking
dojezdzanie : dojeżdżanie : (rzecz.) commuter
dojezdzac : dojeżdżać : (czas.) commute | : (czas.) reach
dojmowac : dojmować : (czas.) gripe
dojrzale : dojrzale : (przysł.) maturely
dojrzalosc : dojrzałość : (rzecz.) maturity | : (rzecz.) puberty | : (rzecz.) ripeness | : (rzecz.) womanhood
dojrzaly : dojrzały : (przym.) mature | : (przym.) ripe
dojrzewanie : dojrzewanie : (rzecz.) adolescence | : (rzecz.) maturation | : (rzecz.) puberty
dojrzewac : dojrzewać : (czas.) incubate | : (czas.) maturate | : (czas.) mature | : (czas.) mellow | : (czas.) precociously | : (czas.) ripen | : (czas.) stir
dojrzec : dojrzeć : (czas.) glimpse | : (czas.) mature | : (czas.) ripen
dojscie : dojście : (rzecz.) access | : (rzecz.) accession | : (rzecz.) approach | : (rzecz.) handle
dojsc : dojść : (czas.) attain | : (czas.) get | : (czas.) got | : (czas.) reach
dok : dok : (rzecz.) doc | : (rzecz.) dock
dokarmiac : dokarmiać : (czas.) fatten
dokazywanie : dokazywanie : (rzecz.) romp
dokazywac : dokazywać : (czas.) daff | : (czas.) frolic | : (czas.) hector | : (czas.) romp
dokanczac : dokańczać : (czas.) finish
doker : doker : (rzecz.) longshoreman | : (rzecz.) stevedore
dokonanie : dokonanie : (rzecz.) accomplishment | : (rzecz.) achievement | : (rzecz.) consummation | : (rzecz.) effort | : (rzecz.) feat | : (rzecz.) performance | : (rzecz.) revise
dokonac : dokonać : (czas.) achieve | : (czas.) consummate | : (czas.) effectuate | : (czas.) stunt
dokonywanie : dokonywanie : (rzecz.) making
dokonywac : dokonywać : (czas.) accomplish | : (czas.) achieve | : (czas.) caulk | : (czas.) commit | : (czas.) consummate | : (czas.) make | : (czas.) perform
dokooptowac : dokooptować : (czas.) co-opt | : (czas.) opt
dokowac : dokować : (czas.) dock
dokola : dokoła : (przysł.) around
dokonczenie : dokończenie : (rzecz.) conclusion | : (rzecz.) finish
dokonczyc : dokończyć : (czas.) clinch | : (czas.) complete | : (czas.) resume
dokrewny : dokrewny : (przym.) endocrine
dokrecac : dokręcać : (czas.) screw | : (czas.) tighten
dokrecic : dokręcić : (czas.) tighten
dokretka : dokrętka : (rzecz.) nut
doktor : doktor : (rzecz.) doctor
doktorat : doktorat : (rzecz.) doctor | : (rzecz.) doctorate
doktorski : doktorski : (przym.) doctoral | : (przym.) doctor's
doktryna : doktryna : (rzecz.) doctrine | : (rzecz.) tenet
doktrynalny : doktrynalny : (przym.) doctrinal
doktryner : doktryner : (rzecz.) doctrinaire | : (rzecz.) doctrinarian
doktrynerski : doktrynerski : (przym.) doctrinarian
dokuczanie : dokuczanie : (rzecz.) annoyance | : (rzecz.) bedevilment | : (rzecz.) bother | : (rzecz.) teasing
dokuczac : dokuczać : (czas.) annoy | : (czas.) bedevil | : (czas.) grumble | : (czas.) harass | : (czas.) harrow | : (czas.) hassle | : (czas.) importune | : (czas.) molest | : (czas.) nag | : (czas.) needle | : (czas.) pester | : (czas.) pinch | : (czas.) spite | : (czas.) sting | : (czas.) taunt | : (czas.) tease | : (czas.) vex
dokuczliwie : dokuczliwie : (przysł.) importunately
dokuczliwosc : dokuczliwość : (rzecz.) annoyance | : (rzecz.) nuisance | : (rzecz.) spitefulness
dokuczliwy : dokuczliwy : (przym.) annoying | : (przym.) bothersome | : (przym.) cumbersome | : (przym.) importunate | : (przym.) irritating | : (przym.) nagging | : (przym.) pesky | : (przym.) spiteful | : (przym.) tiresome | : (przym.) troublesome | : (przym.) worrier
dokument : dokument : (rzecz.) act | : (rzecz.) certificate | : (rzecz.) doc | : (rzecz.) document | : (rzecz.) letter | : (rzecz.) voucher
dokumentacja : dokumentacja : (rzecz.) documentation | : (rzecz.) dossier | : (rzecz.) material | : (rzecz.) paperwork
dokumentalny : dokumentalny : (przym.) documentary
dokumentarny : dokumentarny : (przym.) documentary
dokumentny : dokumentny : (przym.) complete
dokumentowanie : dokumentowanie : (rzecz.) documentation
dokumentowac : dokumentować : (czas.) document
dokupic : dokupić : (czas.) buy
dokad : dokąd : (przysł.) where | : (przysł.) whither
dokadkolwiek : dokądkolwiek : (przysł.) anywhere | : (przysł.) wherever | : (przysł.) whithersoever
dokads : dokądś : (przysł.) somewhere
dokladac : dokładać : (czas.) add | : (czas.) make
dokladka : dokładka : (rzecz.) afters | : (rzecz.) makeweight
dokladnie : dokładnie : (przysł.) accurately | : (przysł.) alike | : (przysł.) carefully | : (przysł.) closely | : (przysł.) exactly | : (przysł.) fully | : (przysł.) plumb | : (przysł.) precisely | : (przysł.) right | : (przysł.) thoroughly
dokladnosc : dokładność : (rzecz.) accuracy | : (rzecz.) exactitude | : (rzecz.) exactness | : (rzecz.) faithfulness | : (rzecz.) fidelity | : (rzecz.) nicety | : (rzecz.) particularity | : (rzecz.) preciseness | : (rzecz.) precision
dokladny : dokładny : (przym.) accurate | : (przym.) businesslike | : (przym.) business-like | : (przym.) definite | : (przym.) exact | : (przym.) faithful | : (przym.) meticulous | : (przym.) near | : (przym.) orderly | : (przym.) particular | : (przym.) pinpoint | : (przym.) precise | : (przym.) specific | : (przym.) strict | : (przym.) thorough
dola : dola : (rzecz.) destiny | : (rzecz.) fortune | : (rzecz.) lot | : (rzecz.) rake-off | : (rzecz.) share
dolar : dolar : (rzecz.) buck | : (rzecz.) dollar
dolatywac : dolatywać : (czas.) come
dolac : dolać : (czas.) refill
doleciec : dolecieć : (czas.) reach
dolegac : dolegać : (czas.) ail | : (czas.) trouble
dolegliwosc : dolegliwość : (rzecz.) affection | : (rzecz.) affliction | : (rzecz.) ailment | : (rzecz.) crud | : (rzecz.) discomfort | : (rzecz.) disorder | : (rzecz.) hardship | : (rzecz.) ill
dolegliwy : dolegliwy : (przym.) painful | : (przym.) shrewd
doleryt : doleryt : (rzecz.) dolerite
dolewac : dolewać : (czas.) add
doliczac : doliczać : (czas.) add | : (czas.) record
doliczyc : doliczyć : (czas.) add
dolina : dolina : (rzecz.) daledolina(rzecz.) dell | : (rzecz.) glen | : (rzecz.) vale | : (rzecz.) valley
dolinka : dolinka : (rzecz.) coomb
dolmen : dolmen : (rzecz.) dolmen
dolnoprzepustowy : dolnoprzepustowy : (przym.) low-pass
dolny : dolny : (przym.) low
dolomit : dolomit : (rzecz.) dolomite
dom : dom : (rzecz.) abode | : (rzecz.) home | : (rzecz.) house | : (rzecz.) household | : (rzecz.) shebang | : (rzecz.) tenement-house
domagac : domagać : (czas.) assert | : (czas.) claim | : (czas.) demand | : (czas.) insist | : (czas.) solicit | : (czas.) vindicate
domator : domator : (rzecz.) stay-at-home
domatorski : domatorski : (przym.) home
domatorstwo : domatorstwo : (rzecz.) domesticity | : (rzecz.) home
domek : domek : (rzecz.) cottage | : (rzecz.) house | : (rzecz.) lodge | : (rzecz.) maisonette
domena : domena : (rzecz.) domain | : (rzecz.) field | : (rzecz.) realm | : (rzecz.) sphere
domiar : domiar : (rzecz.) surcharge | : (rzecz.) surtax
domierzac : domierzać : (czas.) give
domieszac : domieszać : (czas.) admix | : (czas.) mix
domieszka : domieszka : (rzecz.) additive | : (rzecz.) admixture | : (rzecz.) alloy | : (rzecz.) dope | : (rzecz.) impurity | : (rzecz.) tincture | : (rzecz.) tinge
dominacja : dominacja : (rzecz.) dominance | : (rzecz.) domination | : (rzecz.) supremacy
dominium : dominium : (rzecz.) dominion
domino : domino : (rzecz.) domino | : (rzecz.) dominoes
dominowac : dominować : (czas.) boss | : (czas.) dominate | : (czas.) domineer
dominujacy : dominujący : (przym.) dominant
domiesniowy : domięśniowy : (przym.) intramuscular
domniemanie : domniemanie : (rzecz.) allegation | : (rzecz.) assumption | : (rzecz.) conjecture | : (rzecz.) guess | : (rzecz.) presumption
domniemany : domniemany : (przym.) implicit | : (przym.) supposed
domniemac : domniemać : (czas.) conjecture | : (czas.) guess
domniemywac : domniemywać : (czas.) believing
domofon : domofon : (rzecz.) intercom
domokrazca : domokrążca : (rzecz.) cadger | : (rzecz.) hawker | : (rzecz.) packman | : (rzecz.) peddler
domokrazny : domokrążny : (przym.) house-to-house
domorosly : domorosły : (przym.) self-taught
domostwo : domostwo : (rzecz.) establishment | : (rzecz.) homestead | : (rzecz.) house | : (rzecz.) household
domownicy : domownicy : (przym.) household
domownik : domownik : (rzecz.) householder | : (rzecz.) inmate
domowo : domowo : (przysł.) domestically | : (przysł.) home
domowy : domowy : (przym.) domestic | : (przym.) home | : (przym.) homelike | : (przym.) homely | : (przym.) homemade | : (przym.) home-made | : (przym.) homey | : (przym.) household | : (przym.) indoor | : (przym.) pacific
domysl : domysł : (rzecz.) conjecture | : (rzecz.) guess | : (rzecz.) guesswork | : (rzecz.) guess-work | : (rzecz.) inkling | : (rzecz.) presupposition | : (rzecz.) speculation | : (rzecz.) supposition | : (rzecz.) surmise
domyslac : domyślać : (czas.) divine | : (czas.) guess | : (czas.) suppose | : (czas.) surmise
domyslec : domyśleć : (czas.) guess
domyslic : domyślić : (czas.) guess
domyslnie : domyślnie : (przysł.) implicitly
domyslnik : domyślnik : (rzecz.) hint | : (rzecz.) implication | : (rzecz.) insinuation
domyslnosc : domyślność : (rzecz.) penetration
domyslny : domyślny : (przym.) default | : (przym.) shrewd
domowic : domówić : (czas.) jibe
donica : donica : (rzecz.) bowl
doniczka : doniczka : (rzecz.) flowerpot | : (rzecz.) flower-pot | : (rzecz.) pot
doniczkowy : doniczkowy : (przym.) houseplant | : (przym.) potted | : (przym.) putted
doniesienie : doniesienie : (rzecz.) conveyance | : (rzecz.) denunciation | : (rzecz.) report
doniesc : donieść : (czas.) acquaint | : (czas.) report
donikad : donikąd : (przysł.) nowhere
donioslosc : doniosłość : (rzecz.) importance | : (rzecz.) relevance | : (rzecz.) weightiness
doniosly : doniosły : (przym.) eventful | : (przym.) far-reaching | : (przym.) fateful | : (przym.) grave | : (przym.) important | : (przym.) momentous | : (przym.) significant
doniosle : doniośle : (przysł.) importantly | : (przysł.) momentously
donkiszoteria : donkiszoteria : (rzecz.) errantry
donor : donor : (rzecz.) donor
donos : donos : (rzecz.) denunciation | : (rzecz.) information
donosiciel : donosiciel : (rzecz.) informer | : (rzecz.) repeater | : (rzecz.) sneak | : (rzecz.) whistleblower
donosicielski : donosicielski : (przym.) denunciatory
donosicielstwo : donosicielstwo : (rzecz.) informing
donosic : donosić : (czas.) denounce | : (czas.) inform | : (czas.) report | : (czas.) snitch | : (czas.) wear
donoszenie : donoszenie : (rzecz.) bringing
donosnosc : donośność : (rzecz.) loudness | : (rzecz.) range | : (rzecz.) resonance
donosny : donośny : (przym.) loud | : (przym.) plangent | : (przym.) resonant | : (przym.) resounding | : (przym.) sonorous | : (przym.) stentorian
dookola : dookoła : (przysł.) about | : (przysł.) around
dookreslenie : dookreślenie : (rzecz.) instantiation
dookreslic : dookreślić : (czas.) specified
dopalacz : dopalacz : (rzecz.) afterburner
dopalic : dopalić : (czas.) bake
dopasowanie : dopasowanie : (rzecz.) adjustment | : (rzecz.) match | : (rzecz.) matching | : (rzecz.) mating | : (rzecz.) snug
dopasowany : dopasowany : (przym.) matched
dopasowac : dopasować : (czas.) adjust | : (czas.) fit
dopasowywanie : dopasowywanie : (rzecz.) adaptive | : (rzecz.) fitting | : (rzecz.) matching
dopasowywac : dopasowywać : (czas.) readjust
dopatrywac : dopatrywać : (czas.) suspect
dopasc : dopaść : (czas.) hunt
dopelniacz : dopełniacz : (rzecz.) genitive
dopelniajacy : dopełniający : (przym.) complementary
dopelniac : dopełniać : (czas.) complement | : (czas.) complete | : (czas.) consummate | : (czas.) pad | : (czas.) recharge | : (czas.) replenish
dopelnienie : dopełnienie : (rzecz.) adjunct | : (rzecz.) complement | : (rzecz.) consummation | : (rzecz.) implementation | : (rzecz.) object | : (rzecz.) padding
dopelnieniowy : dopełnieniowy : (przym.) objective
dopelnij : dopełnij : (rzecz.) complement
dopelnic : dopełnić : (czas.) complete | : (czas.) consummate | : (czas.) recharge | : (czas.) replenish | : (czas.) supplement
dopiekac : dopiekać : (czas.) sting | : (czas.) swelter
dopilnowac : dopilnować : (czas.) see
dopinanie : dopinanie : (rzecz.) lashing
dopinac : dopinać : (czas.) button
doping : doping : (rzecz.) dope
dopingowac : dopingować : (czas.) root
dopingowy : dopingowy : (przym.) encouraging
dopisac : dopisać : (czas.) add | : (czas.) adjoin
dopisek : dopisek : (rzecz.) annotation | : (rzecz.) footnote | : (rzecz.) insertion | : (rzecz.) postscript
dopisywac : dopisywać : (czas.) add | : (czas.) added
dopiac : dopiąć : (czas.) manage
dopomagac : dopomagać : (czas.) help
dopominac : dopominać : (czas.) demand
dopowiadac : dopowiadać : (czas.) say
dopowiedzenie : dopowiedzenie : (rzecz.) adding | : (rzecz.) apposition
dopracowac : dopracować : (czas.) make | : (czas.) refine
dopracowywac : dopracowywać : (czas.) elaborate
dopraszac : dopraszać : (czas.) beg | : (czas.) solicit
doprawdy : doprawdy : (przysł.) really | : (przysł.) too | : (przysł.) truly | : (przysł.) verily
doprawiac : doprawiać : (czas.) season
doprac : doprać : (czas.) wash
doprecyzowac : doprecyzować : (czas.) clarified
doprosic : doprosić : (czas.) cadge
doproszenie : doproszenie : (rzecz.) asking
doprowadzajacy : doprowadzający : (przym.) afferent
doprowadzanie : doprowadzanie : (rzecz.) bringing
doprowadzac : doprowadzać : (czas.) escort | : (czas.) feed | : (czas.) instigate | : (czas.) lead | : (czas.) make | : (czas.) reduce | : (czas.) supply
doprowadzenie : doprowadzenie : (rzecz.) delivery | : (rzecz.) lead | : (rzecz.) lead-in | : (rzecz.) reduction
doprowadzic : doprowadzić : (czas.) contrive | : (czas.) lead | : (czas.) transact
dopust : dopust : (rzecz.) scourge | : (rzecz.) visitation
dopuszczalnosc : dopuszczalność : (rzecz.) admissibility
dopuszczalny : dopuszczalny : (przym.) acceptable | : (przym.) admissible | : (przym.) allowable | : (przym.) permissible | : (przym.) sufferable | : (przym.) supportable
dopuszczac : dopuszczać : (czas.) admit | : (czas.) afford | : (czas.) allow | : (czas.) commit | : (czas.) let
dopuszczenie : dopuszczenie : (rzecz.) admission | : (rzecz.) admittance | : (rzecz.) release
dopuscic : dopuścić : (czas.) admit | : (czas.) allowed
dopytac : dopytać : (czas.) ask
dopoki : dopóki : (spójnik) till | : (spójnik) until
dopoty : dopóty : (spójnik) till | : (spójnik) until
dopedzac : dopędzać : (czas.) drive | : (czas.) forereach | : (czas.) fore-reach | : (czas.) overhaul
doplacac : dopłacać : (czas.) meet
doplacenie : dopłacenie : (rzecz.) supplement
doplacic : dopłacić : (czas.) pay
doplata : dopłata : (rzecz.) after-payment | : (rzecz.) extra | : (rzecz.) surcharge
doplyw : dopływ : (rzecz.) admission | : (rzecz.) affluent | : (rzecz.) feeder | : (rzecz.) flow | : (rzecz.) inflow | : (rzecz.) influx | : (rzecz.) inlet | : (rzecz.) supply | : (rzecz.) tributary
dorabiac : dorabiać : (czas.) replace
dorada : dorada : (rzecz.) gilthead
doradca : doradca : (rzecz.) adviser | : (rzecz.) advisor | : (rzecz.) aide | : (rzecz.) consultant | : (rzecz.) counsel | : (rzecz.) counsellor
doradczy : doradczy : (przym.) advisory | : (przym.) consultative
doradczyni : doradczyni : (rzecz.) adviser | : (rzecz.) counsellor
doradzac : doradzać : (czas.) advise
doradzic : doradzić : (czas.) advise | : (czas.) advises
doradztwo : doradztwo : (rzecz.) advice | : (rzecz.) consulting | : (rzecz.) expert
dorastanie : dorastanie : (rzecz.) adolescence | : (rzecz.) growing
dorastac : dorastać : (czas.) grow
doraznie : doraźnie : (przysł.) extemporaneously
dorazny : doraźny : (przym.) casual | : (przym.) immediate | : (przym.) random | : (przym.) temporary
dordzeniowy : dordzeniowy : (przym.) spinal
doregulowac : doregulować : (czas.) regulate
dorobek : dorobek : (rzecz.) acquisition | : (rzecz.) fortune | : (rzecz.) output | : (rzecz.) property
dorobkiewicz : dorobkiewicz : (rzecz.) upstart
doroczny : doroczny : (przym.) anniversary | : (przym.) annual | : (przym.) yearly
dorodny : dorodny : (przym.) buxom | : (przym.) diminutive | : (przym.) good-looking | : (przym.) handsome | : (przym.) ripe | : (przym.) robust | : (przym.) shapely
doroslosc : dorosłość : (rzecz.) adulthood | : (rzecz.) maturity
dorosly : dorosły : (przym.) adult | : (przym.) big | : (przym.) grownup | : (przym.) grown-up
dorozumiec : dorozumieć : (czas.) guess | : (czas.) infer
dorozka : dorożka : (rzecz.) cab | : (rzecz.) hackney | : (rzecz.) hackney-carriage | : (rzecz.) taxi
dorozkarz : dorożkarz : (rzecz.) cabby | : (rzecz.) cabman | : (rzecz.) rcabman
dorsz : dorsz : (rzecz.) cod | : (rzecz.) hake | : (rzecz.) ling
dorwac : dorwać : (czas.) grab | : (czas.) seize
dorywcza : dorywcza : (rzecz.) odd
dorywczo : dorywczo : (przysł.) casually
dorywczy : dorywczy : (przym.) casual | : (przym.) fitful | : (przym.) haphazard
dorzecze : dorzecze : (rzecz.) basin
dorzecznosc : dorzeczność : (rzecz.) efficiency
dorzeczny : dorzeczny : (przym.) adequate | : (przym.) logic | : (przym.) reasonable
dorzucac : dorzucać : (czas.) comment | : (czas.) throw
dorzucenie : dorzucenie : (rzecz.) adding
dorzucic : dorzucić : (czas.) add
dorownywac : dorównywać : (czas.) equal | : (czas.) equalize
doreczac : doręczać : (czas.) deliver
doreczenie : doręczenie : (rzecz.) delivery | : (rzecz.) service
doreczyciel : doręczyciel : (rzecz.) deliverer | : (rzecz.) postman
dosadnie : dosadnie : (przysł.) bluntly | : (przysł.) pointedly
dosadnosc : dosadność : (rzecz.) explicitness
dosadny : dosadny : (przym.) blunt | : (przym.) plain | : (przym.) round
dosiadanie : dosiadanie : (rzecz.) horsing | : (rzecz.) mounting | : (rzecz.) swoop
dosiadac : dosiadać : (czas.) mount
dosieczna : dosieczna : (rzecz.) cosecant
dosiasc : dosiąść : (czas.) mount
dosieganie : dosięganie : (rzecz.) reaches
dosiegac : dosięgać : (czas.) attain | : (czas.) reach | : (czas.) win
dosiegnac : dosięgnąć : (czas.) reach
doskonale : doskonale : (przysł.) famously | : (przysł.) perfectly | : (przysł.) supremely
doskonalenie : doskonalenie : (rzecz.) development | : (rzecz.) improvement | : (rzecz.) perfection
doskonalic : doskonalić : (czas.) accomplish | : (czas.) ameliorate | : (czas.) develop | : (czas.) improve | : (czas.) perfect | : (czas.) refine | : (czas.) train
doskonalosc : doskonałość : (rzecz.) excellence | : (rzecz.) finesse | : (rzecz.) perfection
doskonaly : doskonały : (przym.) excellent | : (przym.) perfect | : (przym.) ripe | : (przym.) splendid | : (przym.) tiptop
doskwierac : doskwierać : (czas.) trouble | : (czas.) worry
dosolic : dosolić : (czas.) sting
dospac : dospać : (czas.) sleep
dostarczac : dostarczać : (czas.) adduce | : (czas.) assure | : (czas.) cater | : (czas.) deliver | : (czas.) feed | : (czas.) furnish | : (czas.) provide | : (czas.) purvey | : (czas.) ship | : (czas.) supply | : (czas.) yield
dostarczenie : dostarczenie : (rzecz.) submersion
dostarczyciel : dostarczyciel : (rzecz.) caterer | : (rzecz.) purveyor | : (rzecz.) source
dostarczyc : dostarczyć : (czas.) afford | : (czas.) contribute | : (czas.) deliver | : (czas.) procure | : (czas.) provide | : (czas.) purvey | : (czas.) submit | : (czas.) supply
dostatecznie : dostatecznie : (rzecz.) well
dostatecznosc : dostateczność : (rzecz.) adequacy | : (rzecz.) sufficiency
dostateczny : dostateczny : (przym.) adequate | : (przym.) enough | : (przym.) fair | : (przym.) passable | : (przym.) passing | : (przym.) satisfactory | : (przym.) sufficient
dostatek : dostatek : (rzecz.) abundance | : (rzecz.) affluence | : (rzecz.) ease | : (rzecz.) prosperity | : (rzecz.) wealth
dostatni : dostatni : (przym.) affluent | : (przym.) ample | : (przym.) prosperous
dostatnio : dostatnio : (przysł.) richly
dostatniosc : dostatniość : (rzecz.) ampleness
dostawa : dostawa : (rzecz.) cosine | : (rzecz.) delivery | : (rzecz.) supply
dostawac : dostawać : (czas.) get | : (czas.) have | : (czas.) obtain
dostawca : dostawca : (rzecz.) caterer | : (rzecz.) contractor | : (rzecz.) deliverer | : (rzecz.) distributor | : (rzecz.) furnisher | : (rzecz.) provider | : (rzecz.) purveyor | : (rzecz.) supplier | : (rzecz.) tradesman | : (rzecz.) vendor
dostawczyni : dostawczyni : (rzecz.) caterer | : (rzecz.) provider
dostawianie : dostawianie : (rzecz.) supply
dostawiac : dostawiać : (czas.) fetch | : (czas.) supply
dostawka : dostawka : (rzecz.) bed
dostac : dostać : (czas.) get | : (czas.) got | : (czas.) procure
dostojenstwo : dostojeństwo : (rzecz.) dignity | : (rzecz.) portliness
dostojnik : dostojnik : (rzecz.) dignitary | : (rzecz.) notable
dostojnosc : dostojność : (rzecz.) grandeur | : (rzecz.) lordliness
dostojny : dostojny : (przym.) august | : (przym.) dignified | : (przym.) distinguished | : (przym.) imperial | : (przym.) lordly | : (przym.) portly | : (przym.) solemn
dostosowanie : dostosowanie : (rzecz.) accommodation | : (rzecz.) adaptation | : (rzecz.) adjustment | : (rzecz.) conformity | : (rzecz.) customization | : (rzecz.) expedience | : (rzecz.) expediency
dostosowac : dostosować : (czas.) accommodate | : (czas.) adapt | : (czas.) adjust | : (czas.) comply | : (czas.) conform | : (czas.) fit | : (czas.) readjust | : (czas.) submit
dostosowywanie : dostosowywanie : (rzecz.) adapting | : (rzecz.) alignment | : (rzecz.) customization
dostosowywac : dostosowywać : (czas.) adapt | : (czas.) conform | : (czas.) customize | : (czas.) frame | : (czas.) suit
dostrajacz : dostrajacz : (rzecz.) tuner
dostrajanie : dostrajanie : (rzecz.) tuning
dostrajac : dostrajać : (czas.) detect | : (czas.) tune
dostroic : dostroić : (czas.) attune | : (czas.) conform | : (czas.) tune
dostrojenie : dostrojenie : (rzecz.) adjustment | : (rzecz.) tune
dostrzegalnie : dostrzegalnie : (przysł.) discernibly | : (przysł.) noticeably | : (przysł.) perceptibly | : (przysł.) visibly
dostrzegalnosc : dostrzegalność : (rzecz.) perceptibility | : (rzecz.) visibility
dostrzegalny : dostrzegalny : (przym.) noticeable | : (przym.) observable
dostrzeganie : dostrzeganie : (rzecz.) perception | : (rzecz.) perceptiveness
dostrzegac : dostrzegać : (czas.) detect | : (czas.) discern | : (czas.) perceive | : (czas.) see | : (czas.) spot
dostukac : dostukać : (czas.) rattle
dostapic : dostąpić : (czas.) approach
dostep : dostęp : (rzecz.) access | : (rzecz.) accession | : (rzecz.) admission | : (rzecz.) admittance | : (rzecz.) approach | : (rzecz.) doorway | : (rzecz.) entrance
dostepnie : dostępnie : (przysł.) availably
dostepnosc : dostępność : (rzecz.) accessibility | : (rzecz.) availability | : (rzecz.) visibility
dostepny : dostępny : (przym.) accessible | : (przym.) amenable | : (przym.) approachable | : (przym.) available | : (przym.) hospitable | : (przym.) off-the-shelf
dosuszac : dosuszać : (czas.) dry
dosuw : dosuw : (rzecz.) traverse
dosuwanie : dosuwanie : (rzecz.) justification
dosyt : dosyt : (rzecz.) satiation
dosyc : dosyć : (przysł.) enough | : (przysł.) fairly | : (przysł.) quite | : (przysł.) sufficiently
doszczelniacz : doszczelniacz : (rzecz.) caulker
doszczetnie : doszczętnie : (przysł.) completely
doszczetny : doszczętny : (przym.) complete | : (przym.) radical | : (przym.) thorough
doszlifowac : doszlifować : (czas.) scrub
doszlusowac : doszlusować : (czas.) join
doszukac : doszukać : (czas.) detect | : (czas.) found
doszukiwac : doszukiwać : (czas.) read | : (czas.) suspect
doslownie : dosłownie : (przysł.) literally | : (przysł.) textually | : (przysł.) verbatim
doslownosc : dosłowność : (rzecz.) literality | : (rzecz.) literalness
doslowny : dosłowny : (przym.) literal | : (przym.) verbal | : (przym.) verbatim
doslyszalnosc : dosłyszalność : (rzecz.) audibility
doslyszec : dosłyszeć : (czas.) catch | : (czas.) hear
dotacja : dotacja : (rzecz.) donation | : (rzecz.) endowment | : (rzecz.) grant | : (rzecz.) grant-in-aid | : (rzecz.) subsidy
dotkliwie : dotkliwie : (przysł.) acutely | : (przysł.) badly | : (przysł.) painfully | : (przysł.) severely | : (przysł.) soundly
dotkliwosc : dotkliwość : (rzecz.) severity
dotkliwy : dotkliwy : (przym.) acute | : (przym.) heavy | : (przym.) intense | : (przym.) keen | : (przym.) painful | : (przym.) severe | : (przym.) smart
dotkniecie : dotknięcie : (rzecz.) dab | : (rzecz.) knock | : (rzecz.) touch
dotkniety : dotknięty : (przym.) resentful
dotknac : dotknąć : (czas.) pique | : (czas.) touch
dotowac : dotować : (czas.) subsidise | : (czas.) subsidize
dotrwac : dotrwać : (czas.) survive
dotrzec : dotrzeć : (czas.) get | : (czas.) reach
dotrzymac : dotrzymać : (czas.) keep
dotrzymywac : dotrzymywać : (czas.) keep
dotychczas : dotychczas : (przysł.) heretofore | : (przysł.) hitherto | : (przysł.) yet
dotychczasowosc : dotychczasowość : (rzecz.) elder
dotychczasowy : dotychczasowy : (przym.) current
dotyczyc : dotyczyć : (czas.) apply | : (czas.) attract | : (czas.) belong | : (czas.) concern | : (czas.) deal | : (czas.) interest | : (czas.) pertain | : (czas.) refer | : (czas.) regard
dotyczacy : dotyczący : (przym.) relative
dotyk : dotyk : (rzecz.) feel | : (rzecz.) feeling | : (rzecz.) touch
dotykalnosc : dotykalność : (rzecz.) tangibility
dotykalny : dotykalny : (przym.) tangible
dotykanie : dotykanie : (rzecz.) finger
dotykac : dotykać : (czas.) afflict | : (czas.) dab | : (czas.) feel | : (czas.) handle | : (czas.) reach | : (czas.) touch
dotykowy : dotykowy : (przym.) tactile | : (przym.) tactual
dotad : dotąd : (przysł.) hitherto | : (przysł.) yet
douczac : douczać : (czas.) coach
doustny : doustny : (przym.) oral
dowcip : dowcip : (rzecz.) esprit | : (rzecz.) jest | : (rzecz.) joke | : (rzecz.) pleasantry | : (rzecz.) quip | : (rzecz.) wit | : (rzecz.) witticism
dowcipkowac : dowcipkować : (czas.) joke
dowcipnie : dowcipnie : (przysł.) ingeniously | : (przysł.) pointedly | : (przysł.) wittily
dowcipnis : dowcipniś : (rzecz.) joker | : (rzecz.) smart | : (rzecz.) wit | : (rzecz.) witling
dowcipny : dowcipny : (przym.) facetious | : (przym.) humorous | : (przym.) jocose | : (przym.) jocular | : (przym.) witty
dowiadywac : dowiadywać : (czas.) enquire | : (czas.) find | : (czas.) inquire | : (czas.) learn
dowiedziec : dowiedzieć : (czas.) get | : (czas.) hear | : (czas.) know | : (czas.) learn
dowierzac : dowierzać : (czas.) confide
dowierzchnia : dowierzchnia : (rzecz.) brow
dowiezienie : dowiezienie : (rzecz.) bringing
dowiesc : dowieść : (czas.) argue | : (czas.) show
dowiezc : dowieźć : (czas.) drive
dowiazac : dowiązać : (czas.) bind
dowodowy : dowodowy : (przym.) demonstrative | : (przym.) evidential | : (przym.) probative
dowodzenie : dowodzenie : (rzecz.) argumentation | : (rzecz.) command | : (rzecz.) contention | : (rzecz.) demonstration | : (rzecz.) submersion | : (rzecz.) vindication
dowodzic : dowodzić : (czas.) argue | : (czas.) assert | : (czas.) command | : (czas.) confirm | : (czas.) demonstrate | : (czas.) lead | : (czas.) prove | : (czas.) submit | : (czas.) vindicate
dowodzacy : dowodzący : (przym.) demonstrative
dowolnie : dowolnie : (przysł.) free | : (przysł.) freely | : (przysł.) optionally
dowolnosc : dowolność : (rzecz.) flexibility
dowolny : dowolny : (przym.) any | : (przym.) arbitrary | : (przym.) discretional | : (przym.) discretionary | : (przym.) free-form | : (przym.) optional | : (przym.) volitional
dowozic : dowozić : (czas.) transport
dowolac : dowołać : (czas.) call
dowod : dowód : (rzecz.) affirmation | : (rzecz.) argument | : (rzecz.) averment | : (rzecz.) evidence | : (rzecz.) obviousness | : (rzecz.) plea | : (rzecz.) proof | : (rzecz.) record
dowodca : dowódca : (rzecz.) captain | : (rzecz.) commander | : (rzecz.) commodore
dowodczy : dowódczy : (przym.) commander's
dowodztwo : dowództwo : (rzecz.) command | : (rzecz.) headquarters
dowoz : dowóz : (rzecz.) delivery | : (rzecz.) supply
doza : doza : (rzecz.) dose | : (rzecz.) element
dozator : dozator : (rzecz.) batcher
dozbrajanie : dozbrajanie : (rzecz.) rearmament
dozbrajac : dozbrajać : (czas.) rearm
dozbrojenie : dozbrojenie : (rzecz.) rearmament
dozgonny : dozgonny : (przym.) lifelong | : (przym.) undying
doznanie : doznanie : (rzecz.) experience | : (rzecz.) sensation
doznawanie : doznawanie : (rzecz.) encounter
doznawac : doznawać : (czas.) experience | : (czas.) sustain
doznac : doznać : (czas.) experience
dozorca : dozorca : (rzecz.) attendant | : (rzecz.) caretaker | : (rzecz.) concierge | : (rzecz.) custodian | : (rzecz.) doorkeeper | : (rzecz.) jailer | : (rzecz.) janitor | : (rzecz.) keeper | : (rzecz.) porter | : (rzecz.) turnkey | : (rzecz.) warder
dozorczyni : dozorczyni : (rzecz.) caretaker | : (rzecz.) housekeeper
dozorowanie : dozorowanie : (rzecz.) inspection | : (rzecz.) supervision
dozorowac : dozorować : (czas.) inspect | : (czas.) supervise | : (czas.) tend
dozorowy : dozorowy : (przym.) supervisory
dozowanie : dozowanie : (rzecz.) batching | : (rzecz.) dosage | : (rzecz.) metering
dozowac : dozować : (czas.) dispense | : (czas.) dose
dozownik : dozownik : (rzecz.) batcher | : (rzecz.) dispenser | : (rzecz.) feeder
dozwolic : dozwolić : (czas.) permit
dozymetr : dozymetr : (rzecz.) dosimeter
dozor : dozór : (rzecz.) care | : (rzecz.) inspection | : (rzecz.) supervision
doladowanie : doładowanie : (rzecz.) supercharging
doladowywac : doładowywać : (czas.) supercharge
dolek : dołek : (rzecz.) dimple | : (rzecz.) hole
dolowac : dołować : (czas.) pit
dolozyc : dołożyć : (czas.) add | : (czas.) make | : (czas.) put | : (czas.) walloping
dolaczac : dołączać : (czas.) add | : (czas.) annotate | : (czas.) attach | : (czas.) enclose | : (czas.) join
dolaczony : dołączony : (przym.) attached | : (przym.) in-line
dolaczyc : dołączyć : (czas.) accede | : (czas.) add | : (czas.) adjoin | : (czas.) affix | : (czas.) annex | : (czas.) append | : (czas.) associate | : (czas.) attach | : (czas.) join | : (czas.) subjoin
doscigniecie : doścignięcie : (rzecz.) attainment
dospiewac : dośpiewać : (czas.) sing
dosrodkowo : dośrodkowo : (przysł.) centripetally | : (przysł.) concentrically
dosrodkowosc : dośrodkowość : (rzecz.) concentricity
dosrodkowy : dośrodkowy : (przym.) affective | : (przym.) afferent | : (przym.) centripetal
dosrubowac : dośrubować : (czas.) screw
doswiadczalnie : doświadczalnie : (przysł.) empirically | : (przysł.) experimentally
doswiadczalny : doświadczalny : (przym.) experimental
doswiadczac : doświadczać : (czas.) experience | : (czas.) experiment | : (czas.) feel | : (czas.) try | : (czas.) undergo
doswiadczenie : doświadczenie : (rzecz.) experience | : (rzecz.) experiment | : (rzecz.) expertise | : (rzecz.) ordeal
doswiadczony : doświadczony : (przym.) able | : (przym.) adept | : (przym.) conversant | : (przym.) experienced | : (przym.) expert | : (przym.) skilled | : (przym.) versed
doswiadczyc : doświadczyć : (czas.) experience | : (czas.) undergo
dosc : dość : (przysł.) enough | : (przysł.) fairly | : (przysł.) quite | : (przysł.) rather | : (przysł.) reasonably | : (przysł.) so
doza : doża : (rzecz.) doge
dozylny : dożylny : (przym.) intravenous
dozynki : dożynki : (rzecz.) harvest
dozywianie : dożywianie : (rzecz.) feed
dozywocie : dożywocie : (rzecz.) annuity | : (rzecz.) jointure | : (rzecz.) life | : (rzecz.) pension
dozywotni : dożywotni : (przym.) lifelong
dozywotnik : dożywotnik : (rzecz.) lifer
drab : drab : (rzecz.) rascal
drabina : drabina : (rzecz.) ladder | : (rzecz.) stepladder
drabinka : drabinka : (rzecz.) ladder
drachma : drachma : (rzecz.) dram
draga : draga : (rzecz.) dredge
dragoman : dragoman : (rzecz.) dragoman
dragon : dragon : (rzecz.) dragoon
dragowac : dragować : (czas.) dredge
draka : draka : (rzecz.) row
drakonski : drakoński : (przym.) draconian | : (przym.) severe
dramat : dramat : (rzecz.) drama | : (rzecz.) legit
dramatopisarstwo : dramatopisarstwo : (rzecz.) dramaturgy
dramatopisarz : dramatopisarz : (rzecz.) playwright
dramaturg : dramaturg : (rzecz.) dramatist | : (rzecz.) playwright
dramaturgia : dramaturgia : (rzecz.) drama | : (rzecz.) dramaturgy
dramaturgiczny : dramaturgiczny : (przym.) dramaturgic
dramatycznie : dramatycznie : (przysł.) dramatically
dramatyczny : dramatyczny : (przym.) dramatic | : (przym.) histrionic
dramatyzacja : dramatyzacja : (rzecz.) dramatization
dramatyzowac : dramatyzować : (czas.) dramatize
drapacz : drapacz : (rzecz.) scraper
drapak : drapak : (rzecz.) bolt
drapac : drapać : (czas.) claw | : (czas.) grate | : (czas.) scramble | : (czas.) scrape | : (czas.) scratch
draperia : draperia : (rzecz.) drapery | : (rzecz.) sari
drapichrust : drapichrust : (rzecz.) rogue
drapiezca : drapieżca : (rzecz.) predator
drapiezczy : drapieżczy : (przym.) grasping
drapieznictwo : drapieżnictwo : (rzecz.) predation
drapieznik : drapieżnik : (rzecz.) predator
drapieznosc : drapieżność : (rzecz.) rapacity
drapiezny : drapieżny : (przym.) predacious | : (przym.) predatory | : (przym.) rapacious | : (przym.) raptorial | : (przym.) ravenous
drapniecie : drapnięcie : (rzecz.) bolt
drapowanie : drapowanie : (rzecz.) drapery
drapowac : drapować : (czas.) drape
drastycznie : drastycznie : (przysł.) drastically
drastycznosc : drastyczność : (rzecz.) indecency
drastyczny : drastyczny : (przym.) drastic | : (przym.) risqué
dratwa : dratwa : (rzecz.) twine
dran : drań : (rzecz.) bastard | : (rzecz.) cad | : (rzecz.) scoundrel | : (rzecz.) villain
dranski : drański : (przym.) mean
dranstwo : draństwo : (rzecz.) meanness | : (rzecz.) riffraff | : (rzecz.) roguery
drasniecie : draśnięcie : (rzecz.) graze | : (rzecz.) scrape | : (rzecz.) scratch
drazetka : drażetka : (rzecz.) pill
drazliwosc : drażliwość : (rzecz.) fretfulness | : (rzecz.) irritability | : (rzecz.) petulance | : (rzecz.) sensitivity | : (rzecz.) touchiness
drazliwy : drażliwy : (przym.) edgy | : (przym.) fretful | : (przym.) huffish | : (przym.) huffy | : (przym.) irascible | : (przym.) irritable | : (przym.) peevish | : (przym.) pettish | : (przym.) sensitive | : (przym.) slippery | : (przym.) squeamish | : (przym.) susceptible | : (przym.) tetchy | : (przym.) thorny | : (przym.) ticklish | : (przym.) touchy
draznienie : drażnienie : (rzecz.) provocation
draznic : drażnić : (czas.) anger | : (czas.) annoy | : (czas.) bait | : (czas.) banter | : (czas.) chafe | : (czas.) displease | : (czas.) exasperate | : (czas.) fret | : (czas.) irk | : (czas.) irritate | : (czas.) jar | : (czas.) nettle | : (czas.) rasp | : (czas.) ruffle | : (czas.) tantalize | : (czas.) tease | : (czas.) vex | : (czas.) zap
drelich : drelich : (rzecz.) denim | : (rzecz.) drill | : (rzecz.) dungaree | : (rzecz.) jean
drelichowy : drelichowy : (przym.) denim
dren : dren : (rzecz.) drain | : (rzecz.) drainpipe
drenaz : drenaż : (rzecz.) drain | : (rzecz.) drainage
drenowanie : drenowanie : (rzecz.) drainage
drenowac : drenować : (czas.) ditch | : (czas.) drain
dreptanie : dreptanie : (rzecz.) toddle | : (rzecz.) tripping
dreptac : dreptać : (czas.) mince | : (czas.) patter | : (czas.) scurry | : (czas.) toddle
dres : dres : (rzecz.) tracksuit | : (rzecz.) track-suit
dreszcz : dreszcz : (rzecz.) chill | : (rzecz.) shiver | : (rzecz.) shudder | : (rzecz.) thrill | : (rzecz.) throb | : (rzecz.) tremor
dreszcze : dreszcze : (rzecz.) ague | : (rzecz.) rigor
dreszczowiec : dreszczowiec : (rzecz.) family | : (rzecz.) thriller
dreszczowy : dreszczowy : (przym.) creepy | : (przym.) thrilling
dreszczyk : dreszczyk : (rzecz.) shudder | : (rzecz.) thrill
drewienko : drewienko : (rzecz.) stick
drewniak : drewniak : (rzecz.) clod | : (rzecz.) clog | : (rzecz.) sabot
drewniaki : drewniaki : (rzecz.) clogs
drewniany : drewniany : (przym.) ligneous | : (przym.) timbered | : (przym.) wooden | : (przym.) woodenly | : (przym.) woody
drewnienie : drewnienie : (rzecz.) lignifying
drewno : drewno : (rzecz.) lumber | : (rzecz.) timber | : (rzecz.) tree | : (rzecz.) wood | : (rzecz.) woodworking
drewutnia : drewutnia : (rzecz.) wood-shed
drezyna : drezyna : (rzecz.) car | : (rzecz.) go-devil | : (rzecz.) trolley
drganie : drganie : (rzecz.) chatter | : (rzecz.) flicker | : (rzecz.) jitter | : (rzecz.) oscillation | : (rzecz.) palpitation | : (rzecz.) quiver | : (rzecz.) throb | : (rzecz.) trembling | : (rzecz.) tremor | : (rzecz.) twitch | : (rzecz.) vibration
drgawka : drgawka : (rzecz.) convulsion | : (rzecz.) spasm | : (rzecz.) twitch
drgawkowy : drgawkowy : (przym.) convulsive
drgac : drgać : (czas.) flicker | : (czas.) oscillate | : (czas.) palpitate | : (czas.) throb | : (czas.) tremble | : (czas.) twitch | : (czas.) vibrate | : (czas.) wince
drgnienie : drgnienie : (rzecz.) shiver
drgniecie : drgnięcie : (rzecz.) jerk
driada : driada : (rzecz.) dryad
drobiarski : drobiarski : (przym.) poultry-farming
drobiazg : drobiazg : (rzecz.) biggie | : (rzecz.) fingerling | : (rzecz.) knickknack | : (rzecz.) knick-knack | : (rzecz.) little | : (rzecz.) mite | : (rzecz.) trifle | : (rzecz.) trinket
drobiazgowo : drobiazgowo : (przysł.) meticulously | : (przysł.) minutely
drobiazgowosc : drobiazgowość : (rzecz.) hair-splitting | : (rzecz.) lengthiness | : (rzecz.) pedantry
drobiazgowy : drobiazgowy : (przym.) detailed | : (przym.) finicky | : (przym.) fussy | : (przym.) meticulous | : (przym.) minute | : (przym.) narrow | : (przym.) niggling | : (przym.) painstaking | : (przym.) pernickety | : (przym.) punctilious | : (przym.) searching | : (przym.) thorough | : (przym.) verbose
drobina : drobina : (rzecz.) fraction | : (rzecz.) molecule | : (rzecz.) particle
drobic : drobić : (czas.) crumble | : (czas.) mince | : (czas.) toddle
drobne : drobne : (rzecz.) change
drobniak : drobniak : (rzecz.) coin
drobniec : drobnieć : (czas.) lessen
drobno : drobno : (przysł.) fine | : (przysł.) finely
drobnokrystaliczny : drobnokrystaliczny : (przym.) fine-crystalline
drobnomieszczanski : drobnomieszczański : (przym.) smug
drobnostka : drobnostka : (rzecz.) biggie | : (rzecz.) fleabite | : (rzecz.) flea-bite | : (rzecz.) jot | : (rzecz.) littleness | : (rzecz.) nothing | : (rzecz.) trifle
drobnostkowy : drobnostkowy : (przym.) mean | : (przym.) meticulous
drobnoustroj : drobnoustrój : (rzecz.) animalcule | : (rzecz.) germ | : (rzecz.) microbe | : (rzecz.) micro-organism
drobnoziarnisty : drobnoziarnisty : (przym.) fine | : (przym.) fine-grained
drobnosc : drobność : (rzecz.) pettiness
drobny : drobny : (przym.) dainty | : (przym.) delicate | : (przym.) fine | : (przym.) fine-grained | : (przym.) granular | : (przym.) inconsiderable | : (przym.) minute | : (przym.) paltry | : (przym.) petite | : (przym.) petty | : (przym.) puny | : (przym.) slight | : (przym.) small | : (przym.) tenuous | : (przym.) tiny | : (przym.) trifling | : (przym.) wee | : (przym.) wispy
droczyc : droczyć : (czas.) banter | : (czas.) tease
droga : droga : (rzecz.) avenue | : (rzecz.) highway | : (rzecz.) journey | : (rzecz.) lane | : (rzecz.) pad | : (rzecz.) path | : (rzecz.) pathname | : (rzecz.) pathway | : (rzecz.) road | : (rzecz.) roadway | : (rzecz.) route | : (rzecz.) street | : (rzecz.) track | : (rzecz.) trail | : (rzecz.) walk | : (rzecz.) way
drogeria : drogeria : (rzecz.) chemist's | : (rzecz.) drugstore | : (rzecz.) drug-store
drogi : drogi : (przym.) beloved | : (przym.) dear | : (przym.) expensive | : (przym.) pricey
drogo : drogo : (przysł.) dearly | : (przysł.) expensively
drogocennosc : drogocenność : (rzecz.) preciousness
drogocenny : drogocenny : (przym.) precious | : (przym.) valuable
drogomierz : drogomierz : (rzecz.) distance
drogowiec : drogowiec : (rzecz.) roadman
drogowskaz : drogowskaz : (rzecz.) directory | : (rzecz.) fingerpost | : (rzecz.) finger-post | : (rzecz.) guidepost | : (rzecz.) guide-post | : (rzecz.) signpost | : (rzecz.) sign-post
dromader : dromader : (rzecz.) dromedary
drop : drop : (rzecz.) bustard
drozd : drozd : (rzecz.) robin | : (rzecz.) thrush
drozdze : drożdże : (rzecz.) leaven | : (rzecz.) yeast
drozdzowka : drożdżówka : (rzecz.) bun
droznosc : drożność : (rzecz.) permeability
drozny : drożny : (przym.) permeable
drozyna : drożyna : (rzecz.) footpath | : (rzecz.) lane
drozyzna : drożyzna : (rzecz.) dearness | : (rzecz.) dearth
druciany : druciany : (przym.) wiry
druciarz : druciarz : (rzecz.) tinker | : (rzecz.) wiredrawer
druczek : druczek : (rzecz.) leaflet
drugi : drugi : (przym.) another | : (przym.) farther | : (przym.) latter | : (przym.) other | : (przym.) second
drugoplanowy : drugoplanowy : (przym.) peripheral
drugorzedny : drugorzędny : (przym.) accidental | : (przym.) minor | : (przym.) secondary | : (przym.) second-class | : (przym.) second-rate | : (przym.) subsidiary
drugorzedowy : drugorzędowy : (przym.) secondary
druh : druh : (rzecz.) companion | : (rzecz.) scout | : (rzecz.) scoutmaster
druhna : druhna : (rzecz.) bridesmaid
druidyczny : druidyczny : (przym.) druidic
druk : druk : (rzecz.) impression | : (rzecz.) press | : (rzecz.) print | : (rzecz.) printing | : (rzecz.) type
drukarka : drukarka : (rzecz.) printer
drukarnia : drukarnia : (rzecz.) printing | : (rzecz.) printing-house | : (rzecz.) print-works
drukarski : drukarski : (przym.) printer's
drukarstwo : drukarstwo : (rzecz.) printing
drukarz : drukarz : (rzecz.) printer | : (rzecz.) typo | : (rzecz.) typographer
drukowalny : drukowalny : (przym.) printable
drukowanie : drukowanie : (rzecz.) print | : (rzecz.) printing
drukowany : drukowany : (przym.) printed
drukowac : drukować : (czas.) print
drumla : drumla : (rzecz.) jew's-harp
drut : drut : (rzecz.) needle | : (rzecz.) wire
drutowac : drutować : (czas.) wire
druty : druty : (rzecz.) tag
druza : druza : (rzecz.) geode
druzgocacy : druzgocący : (przym.) smashing
druzgotac : druzgotać : (czas.) comminute | : (czas.) crush | : (czas.) smash
druzba : drużba : (rzecz.) groomsman
druzka : drużka : (rzecz.) bridesmaid
druzyna : drużyna : (rzecz.) line-up | : (rzecz.) squad | : (rzecz.) team
drwal : drwal : (rzecz.) feller | : (rzecz.) logger | : (rzecz.) lumberjack | : (rzecz.) lumberman | : (rzecz.) woodcutter | : (rzecz.) woodman
drwalnia : drwalnia : (rzecz.) wood-shed
drwina : drwina : (rzecz.) derision | : (rzecz.) jeer | : (rzecz.) mockery | : (rzecz.) sneer | : (rzecz.) taunt
drwinkowac : drwinkować : (czas.) joke
drwic : drwić : (czas.) gibe | : (czas.) jeer | : (czas.) mock | : (czas.) scoff | : (czas.) sneer
drybling : drybling : (rzecz.) dribble
dryblowac : dryblować : (czas.) dribble
dryf : dryf : (rzecz.) drift | : (rzecz.) drift-anchor | : (rzecz.) leeway
dryfkotwa : dryfkotwa : (rzecz.) drogue
dryfowanie : dryfowanie : (rzecz.) drift
dryfowac : dryfować : (czas.) drift | : (czas.) drifting | : (czas.) float
dryft : dryft : (rzecz.) drift
dryfter : dryfter : (rzecz.) drifter
dryg : dryg : (rzecz.) flair | : (rzecz.) knack
dryl : dryl : (rzecz.) drill
drylowac : drylować : (czas.) stone
drynda : drynda : (rzecz.) growler
dryndziarz : dryndziarz : (rzecz.) cabby | : (rzecz.) cabman
drzazga : drzazga : (rzecz.) chip | : (rzecz.) sliver | : (rzecz.) splinter
drzemac : drzemać : (czas.) doze | : (czas.) drowse | : (czas.) lurk | : (czas.) nap | : (czas.) nod | : (czas.) slumber | : (czas.) snooze
drzemka : drzemka : (rzecz.) doze | : (rzecz.) drowse | : (rzecz.) nap | : (rzecz.) slumber | : (rzecz.) snooze
drzewce : drzewce : (rzecz.) flagstaff | : (rzecz.) shaft | : (rzecz.) spar | : (rzecz.) staffs | : (rzecz.) truncheon
drzewiasty : drzewiasty : (przym.) ligneous | : (przym.) treelike | : (przym.) woody
drzewko : drzewko : (rzecz.) sapling | : (rzecz.) tree
drzewnik : drzewnik : (rzecz.) lignin
drzewny : drzewny : (przym.) arboreal | : (przym.) woody
drzewo : drzewo : (rzecz.) timber | : (rzecz.) tree | : (rzecz.) wood
drzeworyt : drzeworyt : (rzecz.) engraving | : (rzecz.) woodcut | : (rzecz.) xylograph
drzeworytnictwo : drzeworytnictwo : (rzecz.) woodcarving | : (rzecz.) wood-carving | : (rzecz.) wood-engraving | : (rzecz.) xylography
drzeworytniczy : drzeworytniczy : (przym.) xylographic
drzeworytnik : drzeworytnik : (rzecz.) wood | : (rzecz.) woodcutter
drzewozbior : drzewozbiór : (rzecz.) arboretum
drzewoznawstwo : drzewoznawstwo : (rzecz.) dendrology
drzec : drzeć : (czas.) quarrel | : (czas.) rip | : (czas.) tear
drzwi : drzwi : (rzecz.) door | : (rzecz.) doors | : (rzecz.) trapdoor
drzwiczki : drzwiczki : (rzecz.) door | : (rzecz.) hatch
drob : drób : (rzecz.) crumble | : (rzecz.) fowl | : (rzecz.) poultry
drobka : dróbka : (rzecz.) giblets
drog : dróg : (rzecz.) road | : (rzecz.) roads
drozka : dróżka : (rzecz.) lane | : (rzecz.) path
droznik : dróżnik : (rzecz.) ditcher | : (rzecz.) gatekeeper | : (rzecz.) gate-keeper | : (rzecz.) gateman | : (rzecz.) linesman
drag : drąg : (rzecz.) boathook | : (rzecz.) heaver | : (rzecz.) pole | : (rzecz.) rod | : (rzecz.) spar
dragal : drągal : (rzecz.) lout
drazek : drążek : (rzecz.) joystick | : (rzecz.) lever | : (rzecz.) rod | : (rzecz.) shaft | : (rzecz.) stick
drazyc : drążyć : (czas.) bore | : (czas.) cave | : (czas.) drill
dreczenie : dręczenie : (rzecz.) trouble
dreczyciel : dręczyciel : (rzecz.) molester | : (rzecz.) tormentor | : (rzecz.) torturer
dreczyc : dręczyć : (czas.) afflict | : (czas.) agonize | : (czas.) beset | : (czas.) bother | : (czas.) exasperate | : (czas.) gnaw | : (czas.) harass | : (czas.) hassle | : (czas.) heckle | : (czas.) lacerate | : (czas.) mortify | : (czas.) nag | : (czas.) pester | : (czas.) rankle | : (czas.) tantalize | : (czas.) torment | : (czas.) vex | : (czas.) worry
dretwienie : drętwienie : (rzecz.) numbness
dretwiec : drętwieć : (czas.) benumb | : (czas.) stiffen
dretwo : drętwo : (przysł.) lifelessly
dretwota : drętwota : (rzecz.) numbness
dretwy : drętwy : (przym.) dreary | : (przym.) dry | : (przym.) numb
drzenie : drżenie : (rzecz.) dither | : (rzecz.) quake | : (rzecz.) quaver | : (rzecz.) quiver | : (rzecz.) shiver | : (rzecz.) shudder | : (rzecz.) thrill | : (rzecz.) tremble | : (rzecz.) trembling | : (rzecz.) tremor | : (rzecz.) trepidation
drzec : drżeć : (czas.) creep | : (czas.) quake | : (czas.) quaver | : (czas.) quiver | : (czas.) shake | : (czas.) shiver | : (czas.) shudder | : (czas.) thrill | : (czas.) tremble | : (czas.) vibrate
drzaco : drżąco : (przysł.) shakily
drzacy : drżący : (przym.) shaky | : (przym.) tremulous
drzaczka : drżączka : (rzecz.) tizzy
dualizm : dualizm : (rzecz.) dualism | : (rzecz.) duality
dualnosc : dualność : (rzecz.) duality
dubbingowac : dubbingować : (czas.) dub
dubeltowka : dubeltówka : (rzecz.) shotgun
dubler : dubler : (rzecz.) double | : (rzecz.) doubler | : (rzecz.) stand-in | : (rzecz.) understudy
dublet : dublet : (rzecz.) dipole | : (rzecz.) doublet
dublon : dublon : (rzecz.) doubloon
dublowanie : dublowanie : (rzecz.) double | : (rzecz.) doubling | : (rzecz.) duplication
dublowac : dublować : (czas.) double | : (czas.) redouble
duby : duby : (rzecz.) balderdash
duch : duch : (rzecz.) apparition | : (rzecz.) esprit | : (rzecz.) ghost | : (rzecz.) mettle | : (rzecz.) mind | : (rzecz.) morale | : (rzecz.) pecker | : (rzecz.) revenant | : (rzecz.) soul | : (rzecz.) spectre | : (rzecz.) spirit | : (rzecz.) spook
duchowienstwo : duchowieństwo : (rzecz.) clergy | : (rzecz.) priesthood
duchowny : duchowny : (przym.) clerical | : (przym.) divine | : (przym.) ecclesiastic | : (przym.) ecclesiastical
duchowo : duchowo : (przysł.) inwardly | : (przysł.) spiritually
duchowosc : duchowość : (rzecz.) inwardness | : (rzecz.) spirituality
duchowy : duchowy : (przym.) ghostly | : (przym.) inward | : (przym.) nonmaterial | : (przym.) psychical | : (przym.) spiritual
duda : duda : (rzecz.) bagpipe | : (rzecz.) fathead | : (rzecz.) pipe
dudek : dudek : (rzecz.) cully | : (rzecz.) hoopoe
dudka : dudka : (rzecz.) hoopoe | : (rzecz.) pipe
dudki : dudki : (rzecz.) hoopoes
dudnienie : dudnienie : (rzecz.) beat | : (rzecz.) rumble
dudnic : dudnić : (czas.) resound | : (czas.) rumble | : (czas.) thump
dudy : dudy : (rzecz.) bagpipes
dudziarz : dudziarz : (rzecz.) bag-piper | : (rzecz.) piper
duet : duet : (rzecz.) duel | : (rzecz.) duet
dufny : dufny : (przym.) self-confident | : (przym.) smug
dukat : dukat : (rzecz.) ducat
dukac : dukać : (czas.) stammer
dukt : dukt : (rzecz.) duet | : (rzecz.) product
dulka : dulka : (rzecz.) oarlock | : (rzecz.) rowlock
duma : duma : (rzecz.) haughtiness | : (rzecz.) hauteur | : (rzecz.) pride | : (rzecz.) swagger
dumanie : dumanie : (rzecz.) musing | : (rzecz.) reverie
dumac : dumać : (czas.) meditate
dumnie : dumnie : (przysł.) highly | : (przysł.) proudly
dumny : dumny : (przym.) haughty | : (przym.) high | : (przym.) lordly | : (przym.) overbearing | : (przym.) proud | : (przym.) prouder | : (przym.) supercilious
dupa : dupa : (rzecz.) arse | : (rzecz.) ass | : (rzecz.) asshole | : (rzecz.) butt | : (rzecz.) buttocks | : (rzecz.) duff | : (rzecz.) duster
dupek : dupek : (rzecz.) asshole | : (rzecz.) ass-hole | : (rzecz.) klutz
dupleksowy : dupleksowy : (przym.) duplex | : (przym.) full-duplex
duplikacja : duplikacja : (rzecz.) duplication | : (rzecz.) duplications
duplikat : duplikat : (rzecz.) counterpart | : (rzecz.) duplicate
duplikowac : duplikować : (czas.) duplicate
dur : dur : (rzecz.) major | : (rzecz.) typhoid
dural : dural : (rzecz.) duralumin
duraluminium : duraluminium : (rzecz.) duralumin
duren : dureń : (rzecz.) blockhead | : (rzecz.) booby | : (rzecz.) idiot | : (rzecz.) jackass | : (rzecz.) juggins | : (rzecz.) loggerhead | : (rzecz.) numskull | : (rzecz.) tit | : (rzecz.) twerp | : (rzecz.) twit
durnowaty : durnowaty : (przym.) dotty | : (przym.) dumb
durny : durny : (przym.) daft | : (przym.) dumb | : (przym.) foolish | : (przym.) goofy | : (przym.) silly | : (przym.) stupid
durowy : durowy : (przym.) major | : (przym.) typhoid
durszlak : durszlak : (rzecz.) colander | : (rzecz.) sieve | : (rzecz.) strainer
durzyc : durzyć : (czas.) dupe | : (czas.) fool
dusiciel : dusiciel : (rzecz.) constrictor | : (rzecz.) strangler
dusigrosz : dusigrosz : (rzecz.) cheapskate | : (rzecz.) miser | : (rzecz.) niggard | : (rzecz.) penny-pincher | : (rzecz.) tightwad
dusic : dusić : (czas.) braise | : (czas.) choke | : (czas.) simmer | : (czas.) smother | : (czas.) squeeze | : (czas.) squelch | : (czas.) stew | : (czas.) stifle | : (czas.) strangle | : (czas.) strangulate | : (czas.) suffocate | : (czas.) sulk | : (czas.) suppress | : (czas.) throttle
dusza : dusza : (rzecz.) psyche | : (rzecz.) soul | : (rzecz.) spirit
duszenie : duszenie : (rzecz.) asphyxia | : (rzecz.) simmer
dusznica : dusznica : (rzecz.) angina | : (rzecz.) asthma
duszno : duszno : (przysł.) stiflingly | : (przysł.) sultrily
duszny : duszny : (przym.) airless | : (przym.) airtight | : (przym.) air-tight | : (przym.) frowsty | : (przym.) frowzy | : (przym.) fuggy | : (przym.) muggy | : (przym.) oppressive | : (przym.) sticky | : (przym.) stuffy | : (przym.) sultry
duszony : duszony : (przym.) braised | : (przym.) stewed
duszpasterski : duszpasterski : (przym.) pastoral | : (przym.) priestly
duszpasterstwo : duszpasterstwo : (rzecz.) ministry | : (rzecz.) priesthood
duszpasterz : duszpasterz : (rzecz.) priest
duzo : dużo : (przysł.) plenty
duzy : duży : (przym.) ample | : (przym.) big | : (przym.) bulky | : (przym.) capital | : (przym.) goodly | : (przym.) grand | : (przym.) great | : (przym.) gross | : (przym.) large | : (przym.) massive | : (przym.) massy | : (przym.) sizable
dwoisty : dwoisty : (przym.) dual
dwoic : dwoić : (czas.) divide
dwojaki : dwojaki : (przym.) twofold
dwojakosc : dwojakość : (rzecz.) ambivalence
dwojenie : dwojenie : (rzecz.) doubling | : (rzecz.) skiving | : (rzecz.) two
dworak : dworak : (rzecz.) courtier | : (rzecz.) farmhand
dworek : dworek : (rzecz.) manor-house
dworkowy : dworkowy : (przym.) manorial
dworny : dworny : (przym.) courtly
dworowac : dworować : (czas.) ridicule
dworski : dworski : (przym.) courtly
dworskosc : dworskość : (rzecz.) courtliness
dworzanin : dworzanin : (rzecz.) courtier
dworzec : dworzec : (rzecz.) depot | : (rzecz.) station | : (rzecz.) terminal
dwuatomowy : dwuatomowy : (przym.) diatomic
dwubajtowy : dwubajtowy : (przym.) double-byte
dwubarwny : dwubarwny : (przym.) two-colour
dwubiegun : dwubiegun : (rzecz.) dipole
dwubiegunowosc : dwubiegunowość : (rzecz.) bipolarity | : (rzecz.) tension
dwubiegunowy : dwubiegunowy : (przym.) bipolar | : (przym.) dipolar | : (przym.) double-pole
dwuboj : dwubój : (rzecz.) biathlon
dwuchromian : dwuchromian : (rzecz.) dichromate
dwuczasteczkowy : dwucząsteczkowy : (przym.) bimolecular
dwudzielnosc : dwudzielność : (rzecz.) bipartition | : (rzecz.) dichotomy | : (rzecz.) duality
dwudzielny : dwudzielny : (przym.) bifid | : (przym.) bipartite
dwudziesty : dwudziesty : (przym.) twentieth | : (przym.) twenty
dwufazowy : dwufazowy : (przym.) diphase
dwugarmond : dwugarmond : (rzecz.) paragon
dwugloska : dwugłoska : (rzecz.) diphthong
dwujezycznosc : dwujęzyczność : (rzecz.) bilingualism
dwujezyczny : dwujęzyczny : (przym.) bilingual
dwukierunkowosc : dwukierunkowość : (rzecz.) bi-direction
dwukierunkowy : dwukierunkowy : (przym.) bidirectional
dwukolowiec : dwukołowiec : (rzecz.) hansom
dwukropek : dwukropek : (rzecz.) colon
dwukrotnie : dwukrotnie : (przysł.) twice | : (przysł.) twofold
dwukrotny : dwukrotny : (przym.) twofold
dwukolka : dwukółka : (rzecz.) dray | : (rzecz.) gig
dwulicowosc : dwulicowość : (rzecz.) double-dealing | : (rzecz.) duplicity | : (rzecz.) obliqueness
dwuliniowy : dwuliniowy : (przym.) bilinear
dwulufowy : dwulufowy : (przym.) twin-barrel
dwumetaliczny : dwumetaliczny : (przym.) bimetallic
dwumian : dwumian : (rzecz.) binomial
dwumiesiecznik : dwumiesięcznik : (rzecz.) bimonthly
dwunastkowy : dwunastkowy : (przym.) duodecimal
dwunastnica : dwunastnica : (rzecz.) duodenum
dwunastokat : dwunastokąt : (rzecz.) dodecagon
dwunastoscian : dwunastościan : (rzecz.) dodecahedron
dwunasty : dwunasty : (przym.) twelfth
dwunitkowy : dwunitkowy : (przym.) bifilar
dwunozny : dwunożny : (przym.) bipedal
dwuobiektywowy : dwuobiektywowy : (przym.) binocular
dwuoczny : dwuoczny : (przym.) binocular
dwuogniskowy : dwuogniskowy : (przym.) bifocal
dwupostaciowosc : dwupostaciowość : (rzecz.) dimorphism
dwupostaciowy : dwupostaciowy : (przym.) dimorphic
dwuplat : dwupłat : (rzecz.) biplane
dwuplatowiec : dwupłatowiec : (rzecz.) biplane
dwuplciowosc : dwupłciowość : (rzecz.) androgyny
dwurzedowy : dwurzędowy : (przym.) double-breasted
dwusiarczek : dwusiarczek : (rzecz.) disulfide
dwusieczna : dwusieczna : (rzecz.) bisector
dwustronnie : dwustronnie : (przysł.) bilaterally
dwustronny : dwustronny : (przym.) double-ended | : (przym.) double-sided | : (przym.) two-sided
dwuteownik : dwuteownik : (rzecz.) I-bar | : (rzecz.) I-section | : (rzecz.) joist
dwutlenek : dwutlenek : (rzecz.) dioxide
dwutygodniowy : dwutygodniowy : (przym.) fortnightly
dwuuszny : dwuuszny : (przym.) binaural
dwuwarstwowy : dwuwarstwowy : (przym.) two-tier
dwuwartosciowy : dwuwartościowy : (przym.) bivalent | : (przym.) divalent
dwuwiersz : dwuwiersz : (rzecz.) couplet | : (rzecz.) distich
dwuwklesly : dwuwklęsły : (przym.) biconcave | : (przym.) concavo-concave
dwuwymiarowy : dwuwymiarowy : (przym.) two-dimensional
dwuwypukly : dwuwypukły : (przym.) biconvex | : (przym.) convexo-convex
dwuweglan : dwuwęglan : (rzecz.) bicarbonate
dwuzasadowy : dwuzasadowy : (przym.) dibasic
dwuzgloskowiec : dwuzgłoskowiec : (rzecz.) disyllable
dwuznacznie : dwuznacznie : (przysł.) ambiguously | : (przysł.) equivocally | : (przysł.) insinuatingly
dwuznacznik : dwuznacznik : (rzecz.) ambiguity | : (rzecz.) equivoque | : (rzecz.) prevarication | : (rzecz.) pun
dwuznacznosc : dwuznaczność : (rzecz.) ambiguity | : (rzecz.) amphibology | : (rzecz.) equivocation | : (rzecz.) equivoque
dwuznaczny : dwuznaczny : (przym.) ambiguous | : (przym.) equivocal
dwuznak : dwuznak : (rzecz.) digraph
dwuzenstwo : dwużeństwo : (rzecz.) bigamy
dwochsetny : dwóchsetny : (przym.) two-hundredth
dwoja : dwója : (rzecz.) two
dwojka : dwójka : (rzecz.) deuce | : (rzecz.) dyad | : (rzecz.) twain | : (rzecz.) two
dwojkowo-dziesietny : dwójkowo-dziesiętny : (przym.) binary-decimal | : (przym.) binary-to-decimal
dwojkowo-szesnastkowy : dwójkowo-szesnastkowy : (przym.) binary-to-hexadecimal
dwojkowo-osemkowy : dwójkowo-ósemkowy : (przym.) binary-to-octal
dwojkowy : dwójkowy : (przym.) binary
dwojnasob : dwójnasób : (przysł.) double | : (przysł.) doubly | : (przysł.) twofold
dwojnog : dwójnóg : (rzecz.) bipod
dwojlomnosc : dwójłomność : (rzecz.) birefringence
dwor : dwór : (rzecz.) court | : (rzecz.) manor | : (rzecz.) manor-house | : (rzecz.) mansion | : (rzecz.) yard
dworka : dwórka : (rzecz.) maid
dybel : dybel : (rzecz.) dowel
dyby : dyby : (rzecz.) cangue | : (rzecz.) pillory
dychawica : dychawica : (rzecz.) asthma
dychawiczny : dychawiczny : (przym.) asthmatic | : (przym.) pursy
dychac : dychać : (czas.) breathe
dychotomia : dychotomia : (rzecz.) dichotomy
dychotomiczny : dychotomiczny : (przym.) dichotomous
dydaktycznie : dydaktycznie : (przysł.) didactically
dydaktyczny : dydaktyczny : (przym.) didactic | : (przym.) didactical
dydaktyka : dydaktyka : (rzecz.) didactics | : (rzecz.) teaching
dydaktyzm : dydaktyzm : (rzecz.) didacticism
dyferencja : dyferencja : (rzecz.) difference
dyferencjalny : dyferencjalny : (przym.) differential
dyferencjal : dyferencjał : (rzecz.) differential
dyfrakcja : dyfrakcja : (rzecz.) diffraction
dyfrakcyjny : dyfrakcyjny : (przym.) diffractive
dyfteria : dyfteria : (rzecz.) diphtheria
dyfteryt : dyfteryt : (rzecz.) diphtheria
dyftong : dyftong : (rzecz.) diphthong
dyftongizacja : dyftongizacja : (rzecz.) breaking
dyftongizowac : dyftongizować : (czas.) diphthongize
dyfuzja : dyfuzja : (rzecz.) diffusion
dyfuzor : dyfuzor : (rzecz.) diffuser
dyfuzyjny : dyfuzyjny : (przym.) diffusive
dyg : dyg : (rzecz.) bob | : (rzecz.) curtsey | : (rzecz.) curtsy
dygac : dygać : (czas.) curtsey
dygnitarstwo : dygnitarstwo : (rzecz.) dignity
dygnitarz : dygnitarz : (rzecz.) dignitary
dygotanie : dygotanie : (rzecz.) shake
dygotac : dygotać : (czas.) dither | : (czas.) flutter | : (czas.) shake | : (czas.) tremble
dygresja : dygresja : (rzecz.) digression | : (rzecz.) flashback
dygresyjny : dygresyjny : (przym.) discursive
dykcja : dykcja : (rzecz.) diction | : (rzecz.) elocution
dykta : dykta : (rzecz.) plywood
dyktafon : dyktafon : (rzecz.) recorder
dyktando : dyktando : (rzecz.) dictation
dyktat : dyktat : (rzecz.) dictate
dyktator : dyktator : (rzecz.) dictation | : (rzecz.) dictator
dyktatorski : dyktatorski : (przym.) dictatorial
dyktatorstwo : dyktatorstwo : (rzecz.) dictatorship
dyktatura : dyktatura : (rzecz.) dictatorship
dykteryjka : dykteryjka : (rzecz.) anecdote | : (rzecz.) story
dyktowanie : dyktowanie : (rzecz.) dictation
dyktowac : dyktować : (czas.) dictate | : (czas.) tell
dylatacja : dylatacja : (rzecz.) dilatation
dylatometr : dylatometr : (rzecz.) dilatometer
dylemat : dylemat : (rzecz.) dilemma | : (rzecz.) predicament | : (rzecz.) tickler
dyletancki : dyletancki : (przym.) amateurish | : (przym.) unprofessional
dyletanctwo : dyletanctwo : (rzecz.) dilettantism
dyletant : dyletant : (rzecz.) amateur | : (rzecz.) dilettante | : (rzecz.) layman
dyletantyzm : dyletantyzm : (rzecz.) amateurishness | : (rzecz.) dilettantism
dylizans : dyliżans : (rzecz.) coach | : (rzecz.) stagecoach
dylowac : dylować : (czas.) board
dyluwium : dyluwium : (rzecz.) diluvium
dym : dym : (rzecz.) burn | : (rzecz.) fume | : (rzecz.) reek | : (rzecz.) smoke
dymac : dymać : (czas.) balloon | : (czas.) bloat | : (czas.) bulge | : (czas.) flaunt | : (czas.) inflate | : (czas.) pout
dymek : dymek : (rzecz.) balloon | : (rzecz.) diaper | : (rzecz.) fume
dymienica : dymienica : (rzecz.) bubo
dymienie : dymienie : (rzecz.) smoke | : (rzecz.) smoking
dymisja : dymisja : (rzecz.) demission | : (rzecz.) dismissal | : (rzecz.) resignation | : (rzecz.) retirement
dymisjonowac : dymisjonować : (czas.) depose | : (czas.) resign | : (czas.) retire
dymic : dymić : (czas.) fume | : (czas.) irritate | : (czas.) reek | : (czas.) smoke
dymnica : dymnica : (rzecz.) fumitory | : (rzecz.) smoke-box
dymnik : dymnik : (rzecz.) skylight
dymny : dymny : (przym.) smoky
dymorfizm : dymorfizm : (rzecz.) dimorphism
dyna : dyna : (rzecz.) dyne
dynamicznie : dynamicznie : (przysł.) dynamically
dynamicznosc : dynamiczność : (rzecz.) dynamism
dynamiczny : dynamiczny : (przym.) brisk | : (przym.) dynamic | : (przym.) energetic
dynamika : dynamika : (rzecz.) dynamics
dynamit : dynamit : (rzecz.) dynamite
dynamizm : dynamizm : (rzecz.) dynamic | : (rzecz.) dynamism
dynamizowac : dynamizować : (czas.) actuate
dynamometr : dynamometr : (rzecz.) dynamometer
dynasta : dynasta : (rzecz.) dynast
dynastia : dynastia : (rzecz.) dynasty
dynastyczny : dynastyczny : (przym.) dynastic
dynatron : dynatron : (rzecz.) dynatron | : (rzecz.) negatron
dyndac : dyndać : (czas.) dangle
dynia : dynia : (rzecz.) pumpkin
dyniasty : dyniasty : (przym.) bulbous
dynoda : dynoda : (rzecz.) dynode
dyplom : dyplom : (rzecz.) certificate | : (rzecz.) diploma | : (rzecz.) sheepskin
dyplomacja : dyplomacja : (rzecz.) diplomacy
dyplomata : dyplomata : (rzecz.) diplomat | : (rzecz.) diplomatist
dyplomatycznie : dyplomatycznie : (przysł.) diplomatically
dyplomatyczny : dyplomatyczny : (przym.) diplomatic
dyplomowany : dyplomowany : (przym.) qualified
dyplomowac : dyplomować : (czas.) certificate
dyplomowy : dyplomowy : (przym.) qualifying
dyptych : dyptych : (rzecz.) diptych
dyptyk : dyptyk : (rzecz.) diptych
dyrekcja : dyrekcja : (rzecz.) boardroom | : (rzecz.) direction | : (rzecz.) management
dyrekcyjny : dyrekcyjny : (przym.) director's
dyrektor : dyrektor : (rzecz.) chief | : (rzecz.) director | : (rzecz.) executive | : (rzecz.) governor | : (rzecz.) head | : (rzecz.) headmaster | : (rzecz.) manager | : (rzecz.) president | : (rzecz.) principal | : (rzecz.) producer | : (rzecz.) schoolmaster | : (rzecz.) superintendent | : (rzecz.) warden
dyrektoriat : dyrektoriat : (rzecz.) directorate
dyrektorka : dyrektorka : (rzecz.) headmistress
dyrektorowac : dyrektorować : (czas.) dispense
dyrektorski : dyrektorski : (przym.) managerial
dyrektorstwo : dyrektorstwo : (rzecz.) directory
dyrektywa : dyrektywa : (rzecz.) directive | : (rzecz.) statement
dyrygent : dyrygent : (rzecz.) bandmaster | : (rzecz.) concertmaster | : (rzecz.) conductor | : (rzecz.) supervisor
dyrygentura : dyrygentura : (rzecz.) conducting
dyrygowac : dyrygować : (czas.) conduct | : (czas.) lead
dyscyplina : dyscyplina : (rzecz.) branch | : (rzecz.) discipline | : (rzecz.) event
dyscyplinarny : dyscyplinarny : (przym.) disciplinary
dyscyplinowac : dyscyplinować : (czas.) discipline
dysertacja : dysertacja : (rzecz.) dissertation | : (rzecz.) thesis
dysfunkcja : dysfunkcja : (rzecz.) dysfunction
dysharmonia : dysharmonia : (rzecz.) disharmony | : (rzecz.) jangle | : (rzecz.) mismatch
dysharmonijny : dysharmonijny : (przym.) disharmonious
dyshonor : dyshonor : (rzecz.) disgrace | : (rzecz.) dishonour
dysjunkcja : dysjunkcja : (rzecz.) disjunction
dysjunkcyjny : dysjunkcyjny : (przym.) disjunctive
dysjunktywny : dysjunktywny : (przym.) disjunctive
dysk : dysk : (rzecz.) disc | : (rzecz.) discus | : (rzecz.) disk | : (rzecz.) platter
dyskietka : dyskietka : (rzecz.) disc | : (rzecz.) disk | : (rzecz.) diskette | : (rzecz.) floppy
dyskobol : dyskobol : (rzecz.) thrower
dyskografia : dyskografia : (rzecz.) discography
dyskomfort : dyskomfort : (rzecz.) discomfort
dyskont : dyskont : (rzecz.) discounts
dyskonto : dyskonto : (rzecz.) discount
dyskontowanie : dyskontowanie : (rzecz.) negotiation
dyskontowac : dyskontować : (czas.) discount
dyskoteka : dyskoteka : (rzecz.) club | : (rzecz.) disco | : (rzecz.) discotheque
dyskrecja : dyskrecja : (rzecz.) discretion | : (rzecz.) secrecy
dyskrecjonalny : dyskrecjonalny : (przym.) discretional | : (przym.) discretionary
dyskredytowanie : dyskredytowanie : (rzecz.) disparagement
dyskredytowac : dyskredytować : (czas.) discredit | : (czas.) disparage
dyskretnie : dyskretnie : (przysł.) discreetly
dyskretny : dyskretny : (przym.) discreet | : (przym.) discrete | : (przym.) keyed | : (przym.) quiet | : (przym.) secret | : (przym.) unobtrusive
dyskretyzator : dyskretyzator : (rzecz.) digitizer
dyskretyzowany : dyskretyzowany : (przym.) digitise
dyskretyzowac : dyskretyzować : (czas.) digitize
dyskryminacja : dyskryminacja : (rzecz.) discrimination
dyskryminacyjny : dyskryminacyjny : (przym.) discriminatory
dyskryminator : dyskryminator : (rzecz.) discriminator
dyskryminowanie : dyskryminowanie : (rzecz.) discrimination
dyskryminowac : dyskryminować : (czas.) discriminate | : (czas.) incriminate
dyskurs : dyskurs : (rzecz.) discourse
dyskursywny : dyskursywny : (przym.) discursive
dyskusja : dyskusja : (rzecz.) argument | : (rzecz.) debate | : (rzecz.) discourse | : (rzecz.) discussion | : (rzecz.) gaggle
dyskusyjny : dyskusyjny : (przym.) arguable | : (przym.) contestable | : (przym.) controversial | : (przym.) debatable
dyskutant : dyskutant : (rzecz.) argumentation | : (rzecz.) debater | : (rzecz.) disputant | : (rzecz.) panellist
dyskutowac : dyskutować : (czas.) argue | : (czas.) debate | : (czas.) discuss | : (czas.) dispute
dyskwalifikacja : dyskwalifikacja : (rzecz.) disqualification
dyskwalifikowanie : dyskwalifikowanie : (rzecz.) disqualification
dyskwalifikowac : dyskwalifikować : (czas.) disqualify | : (czas.) incapacitate
dysleksja : dysleksja : (rzecz.) dyslexia
dyslektyczny : dyslektyczny : (przym.) dyslexic
dyslokacja : dyslokacja : (rzecz.) dislocation | : (rzecz.) disposition
dyslokowac : dyslokować : (czas.) dislocate
dysocjacja : dysocjacja : (rzecz.) dissociation
dysocjowac : dysocjować : (czas.) decompose | : (czas.) dissociate
dysonans : dysonans : (rzecz.) discord | : (rzecz.) discordance | : (rzecz.) dissonance
dysonansowy : dysonansowy : (przym.) discordant
dyspensa : dyspensa : (rzecz.) dispensation | : (rzecz.) dyspepsia | : (rzecz.) indult
dyspensowac : dyspensować : (czas.) dispense
dyspergator : dyspergator : (rzecz.) dispersant
dyspergowac : dyspergować : (czas.) disperse
dyspersja : dyspersja : (rzecz.) dispersal | : (rzecz.) dispersion
dysponent : dysponent : (rzecz.) disposer | : (rzecz.) officer | : (rzecz.) trustee
dysponowanie : dysponowanie : (rzecz.) disposal
dysponowac : dysponować : (czas.) arrange | : (czas.) dispose | : (czas.) have
dyspozycja : dyspozycja : (rzecz.) disposal | : (rzecz.) disposition | : (rzecz.) instruction
dyspozycyjnosc : dyspozycyjność : (rzecz.) availability | : (rzecz.) flexibility | : (rzecz.) high-availability
dyspozycyjny : dyspozycyjny : (przym.) available | : (przym.) disposable | : (przym.) flexible
dyspozytor : dyspozytor : (rzecz.) dispatcher
dysproporcja : dysproporcja : (rzecz.) disproportion | : (rzecz.) imbalance
dysproz : dysproz : (rzecz.) dysprosium
dysputa : dysputa : (rzecz.) controversy | : (rzecz.) dispute
dysputant : dysputant : (rzecz.) disputant
dysputowac : dysputować : (czas.) dispute
dyssypacja : dyssypacja : (rzecz.) dissipation
dystans : dystans : (rzecz.) detachment | : (rzecz.) distance | : (rzecz.) length
dystansowac : dystansować : (czas.) distance | : (czas.) outpace | : (czas.) outstrip
dystorsja : dystorsja : (rzecz.) distortion
dystrakcja : dystrakcja : (rzecz.) distraction
dystrofia : dystrofia : (rzecz.) dystrophy
dystrybucja : dystrybucja : (rzecz.) distribution
dystrybucyjny : dystrybucyjny : (przym.) distributional
dystrybuowanie : dystrybuowanie : (rzecz.) distribution
dystrybuowac : dystrybuować : (czas.) distribute
dystrybutor : dystrybutor : (rzecz.) dispenser | : (rzecz.) distributor | : (rzecz.) pump
dystrykt : dystrykt : (rzecz.) district
dystych : dystych : (rzecz.) distich
dystyngowany : dystyngowany : (przym.) capital | : (przym.) dignified | : (przym.) distinguee | : (przym.) distinguished | : (przym.) genteel | : (przym.) ladylike | : (przym.) refined
dystynkcja : dystynkcja : (rzecz.) dignity | : (rzecz.) distinction | : (rzecz.) gentility | : (rzecz.) refinement
dysydent : dysydent : (rzecz.) dissenter | : (rzecz.) dissident | : (rzecz.) nonconformist
dysymilacja : dysymilacja : (rzecz.) dissimilation
dysza : dysza : (rzecz.) jet | : (rzecz.) nozzle | : (rzecz.) snout | : (rzecz.) sprinkler
dyszel : dyszel : (rzecz.) beam | : (rzecz.) drawbar | : (rzecz.) gaud | : (rzecz.) pole | : (rzecz.) shaft | : (rzecz.) shafts
dyszenie : dyszenie : (rzecz.) gasp | : (rzecz.) nozzles
dyszec : dyszeć : (czas.) chug | : (czas.) gasp | : (czas.) pant | : (czas.) puff | : (czas.) wheeze
dyszka : dyszka : (rzecz.) nozzle
dyszkant : dyszkant : (rzecz.) descant | : (rzecz.) soprano | : (rzecz.) treble
dyszkantowy : dyszkantowy : (przym.) treble
dytyramb : dytyramb : (rzecz.) dithyramb
dytyrambiczny : dytyrambiczny : (przym.) dithyrambic
dywagacja : dywagacja : (rzecz.) divagation
dywan : dywan : (rzecz.) carpet | : (rzecz.) rug | : (rzecz.) runner | : (rzecz.) wool
dywanik : dywanik : (rzecz.) carpet | : (rzecz.) rug
dywergencja : dywergencja : (rzecz.) divergence
dywersant : dywersant : (rzecz.) saboteur
dywersja : dywersja : (rzecz.) diversion | : (rzecz.) sabotage
dywersyfikacja : dywersyfikacja : (rzecz.) diversification
dywersyjny : dywersyjny : (przym.) diversionary
dywidenda : dywidenda : (rzecz.) dividend | : (rzecz.) divvy
dywizja : dywizja : (rzecz.) division
dywizjon : dywizjon : (rzecz.) command | : (rzecz.) squadron
dywizorek : dywizorek : (rzecz.) copy-holder
dywizyjny : dywizyjny : (przym.) divisional
dyzenteria : dyzenteria : (rzecz.) dysentery
dyzenteryjny : dyzenteryjny : (przym.) dysenteric
dyzur : dyżur : (rzecz.) duty
dyzurny : dyżurny : (przym.) attendant | : (przym.) orderly
dzban : dzban : (rzecz.) cruse | : (rzecz.) ewer | : (rzecz.) jar | : (rzecz.) jug | : (rzecz.) mug | : (rzecz.) pitcher | : (rzecz.) vase
dzbanek : dzbanek : (rzecz.) crock | : (rzecz.) ewer | : (rzecz.) jug | : (rzecz.) pot | : (rzecz.) teapot
dziabac : dziabać : (czas.) bound
dziad : dziad : (rzecz.) lout
dziadek : dziadek : (rzecz.) dummy | : (rzecz.) gaffer | : (rzecz.) granddad | : (rzecz.) grandfather | : (rzecz.) grandpa | : (rzecz.) grandparent
dziadkowie : dziadkowie : (rzecz.) grandparents
dziadostwo : dziadostwo : (rzecz.) poverty | : (rzecz.) slum | : (rzecz.) trash
dziadowski : dziadowski : (przym.) beggarly | : (przym.) foul | : (przym.) trashy
dziadunio : dziadunio : (rzecz.) granddad | : (rzecz.) grandpa | : (rzecz.) grandpapa
dziadzio : dziadzio : (rzecz.) granddad | : (rzecz.) grandpa
dziadzius : dziadziuś : (rzecz.) grandpa
dzianet : dzianet : (rzecz.) jennet
dzianie : dzianie : (rzecz.) knitting
dzianina : dzianina : (rzecz.) knitwear
dziarski : dziarski : (przym.) brisk | : (przym.) dashing | : (przym.) game | : (przym.) spry
dziarskosc : dziarskość : (rzecz.) dapper | : (rzecz.) dash
dziatwa : dziatwa : (rzecz.) brood | : (rzecz.) children
dziac : dziać : (czas.) knit | : (czas.) stir
dzial : dział : (rzecz.) branch | : (rzecz.) column | : (rzecz.) department | : (rzecz.) division | : (rzecz.) section
dzialacz : działacz : (rzecz.) activist | : (rzecz.) campaigner
dzialajacy : działający : (przym.) operative
dzialalnosc : działalność : (rzecz.) action | : (rzecz.) activity | : (rzecz.) brokerage
dzialanie : działanie : (rzecz.) acting | : (rzecz.) action | : (rzecz.) activity | : (rzecz.) agency | : (rzecz.) effect | : (rzecz.) function | : (rzecz.) impact | : (rzecz.) operation | : (rzecz.) proceeding
dzialac : działać : (czas.) act | : (czas.) execute | : (czas.) function | : (czas.) operate | : (czas.) work
dzialka : działka : (rzecz.) allotment | : (rzecz.) count | : (rzecz.) division | : (rzecz.) lot | : (rzecz.) plot | : (rzecz.) share | : (rzecz.) site
dzialko : działko : (rzecz.) cannon
dzialo : działo : (rzecz.) cannon | : (rzecz.) gun | : (rzecz.) ordnance | : (rzecz.) piece
dzialowy : działowy : (przym.) departmental
dzicz : dzicz : (rzecz.) barbarian | : (rzecz.) barbarians | : (rzecz.) wilderness
dziczka : dziczka : (rzecz.) wilding
dziczyzna : dziczyzna : (rzecz.) game | : (rzecz.) venison
dzida : dzida : (rzecz.) assegai | : (rzecz.) spear
dzidzius : dzidziuś : (rzecz.) baby
dzieci : dzieci : (rzecz.) children
dzieciak : dzieciak : (rzecz.) brat | : (rzecz.) child | : (rzecz.) gamin | : (rzecz.) kid | : (rzecz.) nestling
dzieciarnia : dzieciarnia : (rzecz.) children
dziecina : dziecina : (rzecz.) baby
dziecinada : dziecinada : (rzecz.) childishness | : (rzecz.) puerility
dzieciniec : dzieciniec : (rzecz.) kindergarten
dziecinka : dziecinka : (rzecz.) babe | : (rzecz.) baby
dziecinny : dziecinny : (przym.) babyish | : (przym.) childish | : (przym.) childlike | : (przym.) infantile | : (przym.) infantine | : (przym.) puerile
dzieciobojca : dzieciobójca : (rzecz.) child-murderer | : (rzecz.) infanticide
dzieciobojstwo : dzieciobójstwo : (rzecz.) infanticide
dzieciorob : dzieciorób : (rzecz.) cock
dzieciuch : dzieciuch : (rzecz.) baby
dzieciatko : dzieciątko : (rzecz.) babe | : (rzecz.) baby | : (rzecz.) infant
dziecie : dziecię : (rzecz.) kid
dzieciectwo : dziecięctwo : (rzecz.) infancy
dzieciecy : dziecięcy : (przym.) childlike | : (przym.) infantile | : (przym.) infantine | : (przym.) puerile
dziecinstwo : dzieciństwo : (rzecz.) childhood | : (rzecz.) infancy | : (rzecz.) puerility
dziecko : dziecko : (rzecz.) babe | : (rzecz.) baby | : (rzecz.) child | : (rzecz.) chit | : (rzecz.) infant | : (rzecz.) kid | : (rzecz.) papoose | : (rzecz.) toddler | : (rzecz.) tot | : (rzecz.) weanling | : (rzecz.) youngling | : (rzecz.) youngster
dziedzic : dziedzic : (rzecz.) heir | : (rzecz.) heritor | : (rzecz.) laird | : (rzecz.) squire | : (rzecz.) successor
dziedzictwo : dziedzictwo : (rzecz.) devolution | : (rzecz.) heirloom | : (rzecz.) heritage | : (rzecz.) inheritance | : (rzecz.) patrimony | : (rzecz.) succession
dziedziczenie : dziedziczenie : (rzecz.) inheritance | : (rzecz.) succession
dziedzicznosc : dziedziczność : (rzecz.) heredity | : (rzecz.) inheritance | : (rzecz.) succession
dziedziczny : dziedziczny : (przym.) ancestral | : (przym.) hereditable | : (przym.) hereditary | : (przym.) heritable | : (przym.) inheritable | : (przym.) patrimonial
dziedziczyc : dziedziczyć : (czas.) descend | : (czas.) inherit
dziedzina : dziedzina : (rzecz.) area | : (rzecz.) arena | : (rzecz.) discipline | : (rzecz.) domain | : (rzecz.) field | : (rzecz.) province | : (rzecz.) realm | : (rzecz.) scope | : (rzecz.) sphere
dziedziniec : dziedziniec : (rzecz.) backyard | : (rzecz.) churchyard | : (rzecz.) corral | : (rzecz.) court | : (rzecz.) courtyard | : (rzecz.) farmyard | : (rzecz.) forecourt | : (rzecz.) piazza | : (rzecz.) quadrangle | : (rzecz.) yard
dziegiec : dziegieć : (rzecz.) tar
dzieje : dzieje : (rzecz.) history | : (rzecz.) story
dziejopis : dziejopis : (rzecz.) historian | : (rzecz.) historiographer
dziejopisarstwo : dziejopisarstwo : (rzecz.) historiography
dziejopisarz : dziejopisarz : (rzecz.) historian
dziejowy : dziejowy : (przym.) historic | : (przym.) historical
dziekan : dziekan : (rzecz.) archpriest | : (rzecz.) deacon | : (rzecz.) dean
dziekanat : dziekanat : (rzecz.) deanery | : (rzecz.) deanship
dziekanski : dziekański : (przym.) decanal
dzielenie : dzielenie : (rzecz.) divide | : (rzecz.) division | : (rzecz.) fission | : (rzecz.) segmentation
dzielic : dzielić : (czas.) bisect | : (czas.) carve | : (czas.) distribute | : (czas.) divide | : (czas.) group | : (czas.) partake | : (czas.) partition | : (czas.) share | : (czas.) split | : (czas.) stream
dzielnica : dzielnica : (rzecz.) district | : (rzecz.) estate | : (rzecz.) neighbourhood | : (rzecz.) precinct | : (rzecz.) quarter | : (rzecz.) ward
dzielnie : dzielnie : (przysł.) bravely | : (przysł.) gamely | : (przysł.) valiantly
dzielnik : dzielnik : (rzecz.) divider | : (rzecz.) divisor
dzielnosc : dzielność : (rzecz.) bravery | : (rzecz.) gallantry | : (rzecz.) intrepidity | : (rzecz.) prowess | : (rzecz.) valour
dzielny : dzielny : (przym.) brave | : (przym.) doughty | : (przym.) gallant | : (przym.) manful | : (przym.) manly | : (przym.) stalwart | : (przym.) stout | : (przym.) strenuous | : (przym.) strong | : (przym.) valiant
dzielony : dzielony : (przym.) sectional
dziennie : dziennie : (przysł.) daily
dziennik : dziennik : (rzecz.) daily | : (rzecz.) daybook | : (rzecz.) day-book | : (rzecz.) diary | : (rzecz.) journal | : (rzecz.) log | : (rzecz.) logbook | : (rzecz.) newspaper | : (rzecz.) register | : (rzecz.) workbook
dziennikarstwo : dziennikarstwo : (rzecz.) journalism
dziennikarz : dziennikarz : (rzecz.) broadcaster | : (rzecz.) gazetteer | : (rzecz.) journalist | : (rzecz.) pressman | : (rzecz.) reporter
dzienny : dzienny : (przym.) daily | : (przym.) diurnal
dziergac : dziergać : (czas.) border | : (czas.) knit
dzierlatka : dzierlatka : (rzecz.) chit | : (rzecz.) filly
dzierzba : dzierzba : (rzecz.) shrike
dzierzawa : dzierżawa : (rzecz.) hire | : (rzecz.) holding | : (rzecz.) lease | : (rzecz.) leasehold | : (rzecz.) leasing | : (rzecz.) rent | : (rzecz.) rental | : (rzecz.) tenacity | : (rzecz.) tenancy | : (rzecz.) tenure
dzierzawca : dzierżawca : (rzecz.) copyholder | : (rzecz.) leaseholder | : (rzecz.) lease-holder | : (rzecz.) lessee | : (rzecz.) occupier | : (rzecz.) tenant
dzierzawczy : dzierżawczy : (przym.) possessive
dzierzawienie : dzierżawienie : (rzecz.) leasing
dzierzawic : dzierżawić : (czas.) lease | : (czas.) rent | : (czas.) tenant
dzierzawny : dzierżawny : (przym.) leasehold
dzierzymorda : dzierżymorda : (rzecz.) tyrant
dzierzyc : dzierżyć : (czas.) hold | : (czas.) wield
dziesiata : dziesiąta : (rzecz.) ten
dziesiatkowanie : dziesiątkowanie : (rzecz.) decimation
dziesiatkowac : dziesiątkować : (czas.) decimate
dziesiatkowy : dziesiątkowy : (przym.) decal | : (przym.) decimal
dziesiaty : dziesiąty : (przym.) tenth
dziesiecina : dziesięcina : (rzecz.) tithe
dziesieciobok : dziesięciobok : (rzecz.) decagon
dziesieciokrotnie : dziesięciokrotnie : (przysł.) tenfold
dziesieciokrotnosc : dziesięciokrotność : (rzecz.) decuple
dziesieciokrotny : dziesięciokrotny : (przym.) tenfold
dziesieciokat : dziesięciokąt : (rzecz.) decagon
dziesieciolecie : dziesięciolecie : (rzecz.) decade
dziesiecioscian : dziesięciościan : (rzecz.) decahedron
dziesietno-dwojkowy : dziesiętno-dwójkowy : (przym.) decimal-to-binary
dziesietno-osemkowy : dziesiętno-ósemkowy : (przym.) decimal-to-octal
dziesietny : dziesiętny : (przym.) decimal | : (przym.) denary
dzietny : dzietny : (przym.) decimal
dziewanna : dziewanna : (rzecz.) mullein
dziewczyna : dziewczyna : (rzecz.) adolescent | : (rzecz.) colleen | : (rzecz.) damsel | : (rzecz.) floozy | : (rzecz.) girl | : (rzecz.) girlfriend | : (rzecz.) lass | : (rzecz.) lassie | : (rzecz.) maid
dziewczynka : dziewczynka : (rzecz.) girl | : (rzecz.) lass
dziewczatko : dziewczątko : (rzecz.) lass
dziewcze : dziewczę : (rzecz.) lass
dziewczecy : dziewczęcy : (przym.) girlish
dziewiarka : dziewiarka : (rzecz.) knitter
dziewiarstwo : dziewiarstwo : (rzecz.) knitting
dziewiarz : dziewiarz : (rzecz.) knitter
dziewica : dziewica : (rzecz.) damsel | : (rzecz.) girl | : (rzecz.) maiden | : (rzecz.) vestal | : (rzecz.) virgin
dziewictwo : dziewictwo : (rzecz.) virginity
dziewiczosc : dziewiczość : (rzecz.) chastity | : (rzecz.) innocence
dziewiczy : dziewiczy : (przym.) intact | : (przym.) maiden | : (przym.) virgin | : (przym.) virginal
dziewiaty : dziewiąty : (przym.) ninth
dziewietnasty : dziewiętnasty : (przym.) nineteenth
dziewiecdziesiaty : dziewięćdziesiąty : (przym.) ninetieth
dziewka : dziewka : (rzecz.) maid | : (rzecz.) wench | : (rzecz.) whore
dziewoja : dziewoja : (rzecz.) wench
dzieworodztwo : dzieworództwo : (rzecz.) parthenogenesis
dziewucha : dziewucha : (rzecz.) girl | : (rzecz.) wench
dziewuszka : dziewuszka : (rzecz.) lass
dzielo : dzieło : (rzecz.) artwork | : (rzecz.) creation | : (rzecz.) deed | : (rzecz.) masterpiece | : (rzecz.) opus | : (rzecz.) print | : (rzecz.) work | : (rzecz.) workmanship
dzien : dzień : (rzecz.) date | : (rzecz.) day | : (rzecz.) days | : (rzecz.) daytime | : (rzecz.) valentine
dzieza : dzieża : (rzecz.) kneading-trough | : (rzecz.) store
dzik : dzik : (rzecz.) boar | : (rzecz.) wild
dziki : dziki : (przym.) farouche | : (przym.) fell | : (przym.) ferocious | : (przym.) fierce | : (przym.) haggard | : (przym.) natural | : (przym.) savage | : (przym.) truculent | : (przym.) wild | : (przym.) wildcat
dzikie : dzikie : (rzecz.) wild
dziko : dziko : (przysł.) ferociously | : (przysł.) fiercely | : (przysł.) savagely | : (przysł.) wildly
dzikosc : dzikość : (rzecz.) ferocity | : (rzecz.) savagery | : (rzecz.) wildness
dzikus : dzikus : (rzecz.) barbarian
dziobak : dziobak : (rzecz.) duckbill | : (rzecz.) platypus
dziobanie : dziobanie : (rzecz.) nibble | : (rzecz.) peck
dziobaty : dziobaty : (przym.) pockmarked | : (przym.) pock-marked
dziobac : dziobać : (czas.) peck
dziobek : dziobek : (rzecz.) beak | : (rzecz.) mouth | : (rzecz.) nozzle | : (rzecz.) spout
dziobnica : dziobnica : (rzecz.) stem
dziobnik : dziobnik : (rzecz.) bowsprit
dziobniecie : dziobnięcie : (rzecz.) dab
dziobowy : dziobowy : (przym.) fore | : (przym.) forward
dziobowka : dziobówka : (rzecz.) forecastle
dzionek : dzionek : (rzecz.) day
dzisiaj : dzisiaj : (przysł.) today
dziupla : dziupla : (rzecz.) hollow
dziura : dziura : (rzecz.) burrow | : (rzecz.) cavity | : (rzecz.) chink | : (rzecz.) chuckhole | : (rzecz.) dropout | : (rzecz.) hole | : (rzecz.) hollow | : (rzecz.) leak | : (rzecz.) pit | : (rzecz.) puncture
dziurawic : dziurawić : (czas.) bore | : (czas.) perforate | : (czas.) pounce
dziurawy : dziurawy : (przym.) dodgy | : (przym.) holey | : (przym.) hollow | : (przym.) leaky
dziurka : dziurka : (rzecz.) buttonhole | : (rzecz.) hole | : (rzecz.) keyhole
dziurkacz : dziurkacz : (rzecz.) perforator | : (rzecz.) punch | : (rzecz.) puncher
dziurkarka : dziurkarka : (rzecz.) perforator | : (rzecz.) pink | : (rzecz.) punch
dziurkowanie : dziurkowanie : (rzecz.) perforation | : (rzecz.) piercing | : (rzecz.) punch
dziurkowaty : dziurkowaty : (przym.) porous
dziurkowac : dziurkować : (czas.) perforate | : (czas.) pink | : (czas.) punch
dziw : dziw : (rzecz.) miracle
dziwa : dziwa : (rzecz.) queer
dziwactwo : dziwactwo : (rzecz.) crank | : (rzecz.) eccentricity | : (rzecz.) fad | : (rzecz.) foible | : (rzecz.) nondescript | : (rzecz.) oddity | : (rzecz.) quirk
dziwacznie : dziwacznie : (przysł.) weirdly
dziwacznosc : dziwaczność : (rzecz.) eccentricity | : (rzecz.) fantasticality | : (rzecz.) oddity | : (rzecz.) queer | : (rzecz.) queerness | : (rzecz.) singularity
dziwaczny : dziwaczny : (przym.) antic | : (przym.) bizarre | : (przym.) droll | : (przym.) eccentric | : (przym.) extravagant | : (przym.) fanciful | : (przym.) fantastic | : (przym.) fantastical | : (przym.) freak | : (przym.) freakish | : (przym.) freaky | : (przym.) kinky | : (przym.) nondescript | : (przym.) odd | : (przym.) odd-looking | : (przym.) outlandish | : (przym.) peculiar | : (przym.) queer | : (przym.) quizzical | : (przym.) rum | : (przym.) screwy | : (przym.) singular | : (przym.) uncouth | : (przym.) ungainly | : (przym.) wayward | : (przym.) weird | : (przym.) whimsical
dziwadlo : dziwadło : (rzecz.) freak | : (rzecz.) oddness
dziwak : dziwak : (rzecz.) character | : (rzecz.) crank | : (rzecz.) dork | : (rzecz.) freak | : (rzecz.) guy | : (rzecz.) kook | : (rzecz.) nondescript | : (rzecz.) oddball
dziwic : dziwić : (czas.) marvel | : (czas.) surprise | : (czas.) wonder
dziwka : dziwka : (rzecz.) bitch | : (rzecz.) hooker | : (rzecz.) moll | : (rzecz.) slag | : (rzecz.) slut | : (rzecz.) trollop | : (rzecz.) whore
dziwkarz : dziwkarz : (rzecz.) rake
dziwnie : dziwnie : (przysł.) curiously | : (przysł.) funnily | : (przysł.) oddly | : (przysł.) queerly | : (przysł.) strangely | : (przysł.) weirdly
dziwnosc : dziwność : (rzecz.) oddity | : (rzecz.) queer | : (rzecz.) strangeness
dziwny : dziwny : (przym.) aberrant | : (przym.) bizarre | : (przym.) eerie | : (przym.) foreign | : (przym.) funny | : (przym.) odd | : (przym.) odd-looking | : (przym.) outré | : (przym.) peculiar | : (przym.) quaint | : (przym.) queer | : (przym.) quirky | : (przym.) rum | : (przym.) rummy | : (przym.) singular | : (przym.) strange | : (przym.) surprising | : (przym.) weird
dziwolag : dziwoląg : (rzecz.) freak | : (rzecz.) monster
dziwotwor : dziwotwór : (rzecz.) monster
dziwowac : dziwować : (czas.) marvel
dziwowisko : dziwowisko : (rzecz.) oddity
dziob : dziób : (rzecz.) beak | : (rzecz.) billing | : (rzecz.) bow | : (rzecz.) nib | : (rzecz.) nose | : (rzecz.) prow
dziobek : dzióbek : (rzecz.) beak | : (rzecz.) mouth | : (rzecz.) nib | : (rzecz.) nozzle
dziaslo : dziąsło : (rzecz.) gum
dziaslowy : dziąsłowy : (przym.) alveolar | : (przym.) cacuminal | : (przym.) gingival
dzieciol : dzięcioł : (rzecz.) pecker | : (rzecz.) woodpecker
dziegiel : dzięgiel : (rzecz.) angelica
dziekczynienie : dziękczynienie : (rzecz.) thankfulness | : (rzecz.) thanks | : (rzecz.) thanksgiving
dziekczynny : dziękczynny : (przym.) thankful
dziekowanie : dziękowanie : (rzecz.) thanks
dziekowac : dziękować : (czas.) appreciate | : (czas.) thank
dzis : dziś : (przysł.) today
dzwon : dzwon : (rzecz.) bell | : (rzecz.) dingdong | : (rzecz.) ding-dong | : (rzecz.) umbrella
dzwonek : dzwonek : (rzecz.) bell | : (rzecz.) bellflower | : (rzecz.) bell-flower | : (rzecz.) bleep | : (rzecz.) bluebell | : (rzecz.) doorbell | : (rzecz.) ring | : (rzecz.) ringer | : (rzecz.) trumpet
dzwoniec : dzwoniec : (rzecz.) greenfinch | : (rzecz.) linnet
dzwonienie : dzwonienie : (rzecz.) clink | : (rzecz.) dingdong | : (rzecz.) ding-dong | : (rzecz.) jangle | : (rzecz.) jingle | : (rzecz.) knell | : (rzecz.) sounding | : (rzecz.) tinkle | : (rzecz.) toll
dzwonic : dzwonić : (czas.) associate | : (czas.) call | : (czas.) chime | : (czas.) clang | : (czas.) clink | : (czas.) jangle | : (czas.) jingle | : (czas.) phone | : (czas.) ring | : (czas.) sound | : (czas.) ting | : (czas.) tinkle | : (czas.) toll
dzwonnica : dzwonnica : (rzecz.) belfry
dzwonnik : dzwonnik : (rzecz.) bell-ringer | : (rzecz.) ringer
dzwono : dzwono : (rzecz.) felloe
dzwonowaty : dzwonowaty : (przym.) bell-shaped
dzwonowy : dzwonowy : (przym.) bell-shaped
dzwony : dzwony : (przym.) flares
doj : dój : (rzecz.) milk | : (rzecz.) milking
dojka : dójka : (rzecz.) dig | : (rzecz.) milkmaid | : (rzecz.) teat
dol : dół : (rzecz.) bottom | : (rzecz.) bottoming | : (rzecz.) down | : (rzecz.) foot | : (rzecz.) hollow | : (rzecz.) pit
dab : dąb : (rzecz.) blackjack | : (rzecz.) oak
das : dąs : (rzecz.) mumps
dasac : dąsać : (czas.) pout | : (czas.) sulk
dac : dąć : (czas.) blow
dazenie : dążenie : (rzecz.) ambition | : (rzecz.) aspiration | : (rzecz.) drift | : (rzecz.) pursuance | : (rzecz.) pursuit | : (rzecz.) striving
daznosc : dążność : (rzecz.) drift | : (rzecz.) tendency | : (rzecz.) trend
dazyc : dążyć : (czas.) aim | : (czas.) aspire | : (czas.) endeavour | : (czas.) pursue | : (czas.) seek | : (czas.) strive | : (czas.) tend | : (czas.) trend
debianka : dębianka : (rzecz.) oak-gall
debina : dębina : (rzecz.) oak-wood
debowy : dębowy : (przym.) oaken
decie : dęcie : (rzecz.) blow
detka : dętka : (rzecz.) bladder | : (rzecz.) tube
dlawica : dławica : (rzecz.) gland
dlawiec : dławiec : (rzecz.) croup
dlawienie : dławienie : (rzecz.) choking | : (rzecz.) damping
dlawik : dławik : (rzecz.) choking | : (rzecz.) gland | : (rzecz.) reactor
dlawic : dławić : (czas.) choke | : (czas.) squelch | : (czas.) stifle | : (czas.) strangle | : (czas.) throttle
dlawnica : dławnica : (rzecz.) gland | : (rzecz.) stuffing-box
dloniasty : dłoniasty : (przym.) palmate
dlon : dłoń : (rzecz.) hand | : (rzecz.) palm
dlubanie : dłubanie : (rzecz.) tinker
dlubanina : dłubanina : (rzecz.) drudgery
dlubac : dłubać : (czas.) gouge | : (czas.) poke | : (czas.) tinker
dlug : dług : (rzecz.) arrear | : (rzecz.) debt | : (rzecz.) duty | : (rzecz.) indebtedness | : (rzecz.) length
dlugi : długi : (przym.) long
dlugo : długo : (przysł.) long
dlugodystansowy : długodystansowy : (przym.) long-distance
dlugofalowy : długofalowy : (przym.) long-range | : (przym.) long-term
dlugoletni : długoletni : (przym.) long
dlugonogi : długonogi : (przym.) leggy
dlugookresowy : długookresowy : (przym.) long-term
dlugopis : długopis : (rzecz.) ball-pen | : (rzecz.) ballpoint | : (rzecz.) biro | : (rzecz.) pen
dlugoterminowy : długoterminowy : (przym.) long-term
dlugotrwalosc : długotrwałość : (rzecz.) length
dlugotrwaly : długotrwały : (przym.) livelong | : (przym.) long-lasting | : (przym.) prolonged
dlugowiecznosc : długowieczność : (rzecz.) longevity
dlugowieczny : długowieczny : (przym.) long | : (przym.) long-lived
dlugowlosy : długowłosy : (przym.) long | : (przym.) longhaired | : (przym.) long-haired
dlugosc : długość : (rzecz.) length | : (rzecz.) lengthiness | : (rzecz.) longitude | : (rzecz.) span
dluto : dłuto : (rzecz.) chisel
dlutowac : dłutować : (czas.) chisel
dluznik : dłużnik : (rzecz.) borrower | : (rzecz.) debtor
dluzny : dłużny : (przym.) beholden | : (przym.) indebted | : (przym.) owing
dluzyca : dłużyca : (rzecz.) log
dluzyc : dłużyć : (czas.) drag
dzgac : dźgać : (czas.) jab | : (czas.) prod | : (czas.) stab
dzgniecie : dźgnięcie : (rzecz.) jab | : (rzecz.) job | : (rzecz.) prod | : (rzecz.) stab | : (rzecz.) thrust
dzwig : dźwig : (rzecz.) crab | : (rzecz.) crane | : (rzecz.) derrick | : (rzecz.) elevator | : (rzecz.) hoist | : (rzecz.) lift | : (rzecz.) ram
dzwigacz : dźwigacz : (rzecz.) elevator
dzwiganie : dźwiganie : (rzecz.) elevation
dzwigar : dźwigar : (rzecz.) beam | : (rzecz.) girder
dzwigac : dźwigać : (czas.) bear | : (czas.) carry | : (czas.) heave | : (czas.) hoist | : (czas.) lift | : (czas.) load | : (czas.) raise | : (czas.) uplift | : (czas.) upraise
dzwigienka : dźwigienka : (rzecz.) slide
dzwignia : dźwignia : (rzecz.) arm | : (rzecz.) heaver | : (rzecz.) jack | : (rzecz.) lever | : (rzecz.) leverage
dzwignica : dźwignica : (rzecz.) crane
dzwignik : dźwignik : (rzecz.) crane
dzwigniecie : dźwignięcie : (rzecz.) heave | : (rzecz.) leverage
dzwignac : dźwignąć : (czas.) upraise
dzwieczenie : dźwięczenie : (rzecz.) clangour | : (rzecz.) tingle | : (rzecz.) tingling | : (rzecz.) tinkle
dzwieczec : dźwięczeć : (czas.) chink | : (czas.) clang | : (czas.) clink | : (czas.) jingle | : (czas.) peal | : (czas.) resonate | : (czas.) resound | : (czas.) ring | : (czas.) sound | : (czas.) tingle | : (czas.) tinkle
dzwiecznosc : dźwięczność : (rzecz.) resonance
dzwieczny : dźwięczny : (przym.) canorous | : (przym.) glottal | : (przym.) musical | : (przym.) orotund | : (przym.) resonant | : (przym.) sonorous | : (przym.) tingled | : (przym.) vocal | : (przym.) voiced
dzwiek : dźwięk : (rzecz.) clink | : (rzecz.) hollow | : (rzecz.) sound | : (rzecz.) tone
dzwiekochlonny : dźwiękochłonny : (przym.) deadener | : (przym.) sound-absorbing
dzwiekonasladowczy : dźwiękonaśladowczy : (przym.) echoic | : (przym.) onomatopoeic
dzwiekoszczelny : dźwiękoszczelny : (przym.) soundproof | : (przym.) sound-proof | : (przym.) sound-proofed
dzwiekowy : dźwiękowy : (przym.) acoustic | : (przym.) phonic | : (przym.) sonic | : (przym.) sound
dzdzownica : dżdżownica : (rzecz.) earthworm | : (rzecz.) lobworm
dzdzystosc : dżdżystość : (rzecz.) rain
dzdzysty : dżdżysty : (przym.) drizzly | : (przym.) rainy | : (przym.) wet
dzem : dżem : (rzecz.) jam | : (rzecz.) marmalade
dzentelmen : dżentelmen : (rzecz.) gent | : (rzecz.) gentleman
dzentelmenski : dżentelmeński : (przym.) gentlemanlike | : (przym.) gentlemanly
dzet : dżet : (rzecz.) jet
dzez : dżez : (rzecz.) jazz
dzihad : dżihad : (rzecz.) jihad
dzin : dżin : (rzecz.) gin
dzins : dżins : (rzecz.) denim | : (rzecz.) jean | : (rzecz.) jeans
dzinsowy : dżinsowy : (przym.) vaquero
dzinsy : dżinsy : (rzecz.) jeans
dzip : dżip : (rzecz.) jeep
dzojstik : dżojstik : (rzecz.) joystick
dzokej : dżokej : (rzecz.) jockey | : (rzecz.) rider
dzoker : dżoker : (rzecz.) joker
dzonka : dżonka : (rzecz.) junk
dzudo : dżudo : (rzecz.) judo
dzul : dżul : (rzecz.) joule
dzuma : dżuma : (rzecz.) pest | : (rzecz.) plague
dzungla : dżungla : (rzecz.) jungle
dzyn : dżyn : (rzecz.) clang
