h-hydrogen : H-hydrogen : (rzecz.) wodór
harriet : Harriet : (rzecz.) Henryka
hebrew : Hebrew : (przym.) hebrajski
hegelianism : Hegelianism : (rzecz.) heglizm
helen : Helen : (rzecz.) Halina
hellenism : Hellenism : (rzecz.) hellenizm
hellenist : Hellenist : (rzecz.) hellenista
hellenistic : Hellenistic : (przym.) hellenistyczny
henry : Henry : (rzecz.) Henryk
herculean : Herculean : (przym.) herkulesowy
hinduism : Hinduism : (rzecz.) hinduizm
holocene : Holocene : (rzecz.) holocen
homeric : Homeric : (przym.) homeryczny
huguenot : Huguenot : (rzecz.) hugenot
h-hour : h-hour : (rzecz.) godzina
ha-hectare : ha-hectare : (rzecz.) hektar
haberdasher : haberdasher : (rzecz.) szmuklerz
haberdasher's : haberdasher's : (przym.) pasmanteryjny
haberdashery : haberdashery : (rzecz.) galanteria | : (rzecz.) pasmanteria
habergeon : habergeon : (rzecz.) kolczuga
habile : habile : (przym.) zręczny
habiliment : habiliment : (rzecz.) odzież | : (rzecz.) ubiór
habit : habit : (rzecz.) budowa | : (rzecz.) habit | : (rzecz.) habitus | : (rzecz.) nałóg | : (rzecz.) nawyk | : (rzecz.) obyczaj | : (rzecz.) odzież | : (rzecz.) przyzwyczajenie | : (rzecz.) właściwość | : (rzecz.) zwyczaj
habitable : habitable : (przym.) mieszkalny
habitant : habitant : (rzecz.) mieszkaniec
habitat : habitat : (rzecz.) środowisko
habitation : habitation : (rzecz.) mieszkanie | : (rzecz.) zamieszkanie | : (rzecz.) zamieszkiwanie
habitual : habitual : (przym.) charakterystyczny | : (przym.) nałogowy | : (przym.) nawykowy | : (przym.) notoryczny | : (przym.) powszedni | : (przym.) zwyczajny | : (przym.) zwykły
habitually : habitually : (przysł.) nałogowo | : (przysł.) notorycznie
habituation : habituation : (rzecz.) nawyk | : (rzecz.) wdrożenie
hachure : hachure : (czas.) kreskować
hacienda : hacienda : (rzecz.) gospodarstwo | : (rzecz.) hacjenda | : (rzecz.) rezydencja
hack : hack : (czas.) ciosać | : (czas.) kopać | : (czas.) pokaszliwać | : (czas.) rąbać | : (czas.) siekać | : (rzecz.) cięcie | : (rzecz.) kilof | : (rzecz.) motyka | : (rzecz.) pismak
hackamore : hackamore : (rzecz.) powróz | : (rzecz.) wędzidło
hacker : hacker : (rzecz.) hacker | : (rzecz.) haker | : (rzecz.) pirat | : (rzecz.) włamywacz
hackle : hackle : (rzecz.) cierlica | : (rzecz.) konopi
hackly : hackly : (przym.) ostry
hackney : hackney : (rzecz.) dorożka | : (rzecz.) najemnik | : (rzecz.) powóz
hackney-carriage : hackney-carriage : (rzecz.) dorożka
hackneyed : hackneyed : (przym.) banalny | : (przym.) oklepany | : (przym.) szablonowy | : (przym.) tuzinkowy
hackwork : hackwork : (rzecz.) chałtura | : (rzecz.) wyrobnictwo
hack« : hack« : (rzecz.) murzyn | : (rzecz.) najemnik
haddock : haddock : (rzecz.) łupacz | : (rzecz.) plamiak
hade : hade : (rzecz.) góra
haematologist : haematologist : (rzecz.) hematolog
haematology : haematology : (rzecz.) hematologia
haematoma : haematoma : (rzecz.) krwiak
haemin : haemin : (rzecz.) hemina
haemoglobin : haemoglobin : (rzecz.) hemoglobina
haemolysis : haemolysis : (rzecz.) hemoliza
haemolytic : haemolytic : (przym.) hemolityczny
haemophilia : haemophilia : (rzecz.) hemofilia
haemorrhage : haemorrhage : (rzecz.) krwotok | : (rzecz.) wylew
haemorrhagic : haemorrhagic : (przym.) krwotoczny
haemorrhoid : haemorrhoid : (rzecz.) hemoroid
haemorrhoidal : haemorrhoidal : (przym.) hemoroidalny
haemostatic : haemostatic : (przym.) hemostatyczny
hafnium : hafnium : (rzecz.) hafn
haft : haft : (rzecz.) rękojeść
hag : hag : (rzecz.) czarownica | : (rzecz.) jędza | : (rzecz.) wiedźma
haggard : haggard : (przym.) dziki | : (przym.) wymizerowany
haggis : haggis : (rzecz.) serce
haggish : haggish : (przym.) jędzowaty
haggle : haggle : (czas.) targować
hagiographic : hagiographic : (przym.) hagiograficzny
hagiography : hagiography : (rzecz.) hagiografia
hail : hail : (czas.) obwołać | : (czas.) pochodzić | : (czas.) pozdrawiać | : (czas.) przywołać | : (czas.) witać | : (rzecz.) grad | : (rzecz.) gradobicie | : (rzecz.) pocisk | : (rzecz.) powitanie | : (rzecz.) pozdrowienie
hail-stone : hail-stone : (rzecz.) gradzina
hailstorm : hailstorm : (rzecz.) grad | : (rzecz.) gradobicie
hair : hair : (rzecz.) owłosienie | : (rzecz.) sierść | : (rzecz.) włos | : (rzecz.) włosie | : (rzecz.) włosy | : (rzecz.) zarost
hair-cutting : hair-cutting : (rzecz.) strzyżenie
hair-do : hair-do : (rzecz.) fryzura | : (rzecz.) uczesanie
hair-slide : hair-slide : (rzecz.) wsuwka
hair-splitting : hair-splitting : (rzecz.) drobiazgowość
hair-spring : hair-spring : (rzecz.) włos
hairbrush : hairbrush : (rzecz.) szczotka
haircloth : haircloth : (rzecz.) włosianka
haircut : haircut : (rzecz.) fryzura | : (rzecz.) ostrzyżenie | : (rzecz.) strzyżenie
haircutting : haircutting : (rzecz.) strzyżenie
hairdo : hairdo : (rzecz.) fryzura | : (rzecz.) uczesanie
hairdresser : hairdresser : (rzecz.) fryzjer
hairdresser's : hairdresser's : (przym.) fryzjerski
hairdressing : hairdressing : (rzecz.) fryzjerstwo
hairdryer : hairdryer : (rzecz.) suszarka
hairiness : hairiness : (rzecz.) kosmatość | : (rzecz.) włochatość
hairless : hairless : (przym.) bezwłosy
hairlines : hairlines : (rzecz.) ryski
hairpiece : hairpiece : (rzecz.) peruka
hairpin : hairpin : (rzecz.) szpilka
hairs : hairs : (rzecz.) sierść
hairspring : hairspring : (rzecz.) włos
hairstyle : hairstyle : (rzecz.) fryzura | : (rzecz.) uczesanie
hairstylist : hairstylist : (rzecz.) fryzjer
hairworm : hairworm : (rzecz.) trychina
hairy : hairy : (przym.) kosmaty | : (przym.) kudłaty | : (przym.) włochaty | : (przym.) włosisty
hake : hake : (rzecz.) dorsz | : (rzecz.) miętus | : (rzecz.) morszczuk
halation : halation : (rzecz.) aureola | : (rzecz.) halo
halberd : halberd : (rzecz.) halabarda
halberdier : halberdier : (rzecz.) halabardnik | : (rzecz.) halabardzista
halcyon : halcyon : (przym.) błogi | : (rzecz.) zimorodek
hale : hale : (przym.) czerstwy | : (przym.) krzepki | : (przym.) zdrowy
half : half : (rzecz.) połowa | : (rzecz.) połowica | : (rzecz.) połówka | : (rzecz.) półrocze
half-adder : half-adder : (rzecz.) półsumator
half-back : half-back : (rzecz.) obrońca
half-baked : half-baked : (przym.) wpółsurowy
half-bleaching : half-bleaching : (rzecz.) podbielanie
half-breed : half-breed : (rzecz.) mieszaniec
half-byte : half-byte : (rzecz.) półbajt
half-carcase : half-carcase : (rzecz.) półtusza
half-carcass : half-carcass : (rzecz.) półtusza
half-caste : half-caste : (rzecz.) mieszaniec
half-cell : half-cell : (rzecz.) półogniwo
half-century : half-century : (rzecz.) półwiecze
half-cloth : half-cloth : (rzecz.) półpłótno
half-conscious : half-conscious : (przym.) półprzytomny
half-crown : half-crown : (rzecz.) półkoronówka
half-dead : half-dead : (przym.) półmartwy | : (przym.) półżywy
half-element : half-element : (rzecz.) półogniwo
half-grown : half-grown : (przym.) niewyrośnięty
half-hourly : half-hourly : (przym.) półgodzinny
half-kilogramme : half-kilogramme : (przym.) półkilogramowy
half-kilometre : half-kilometre : (przym.) półkilometrowy
half-life : half-life : (rzecz.) półokres
half-light : half-light : (rzecz.) półświatło
half-litre : half-litre : (przym.) półlitrowy
half-loop : half-loop : (rzecz.) półpętla
half-matt : half-matt : (rzecz.) półmat
half-measure : half-measure : (rzecz.) półśrodek
half-moon : half-moon : (rzecz.) półksiężyc
half-open : half-open : (przym.) półotwarty | : (przym.) rozchylony
half-product : half-product : (rzecz.) półfabrykat
half-round : half-round : (przym.) półokrągły
half-shadow : half-shadow : (rzecz.) półcień
half-smile : half-smile : (rzecz.) półuśmiech
half-stuff : half-stuff : (rzecz.) półmasa
half-timbered : half-timbered : (przym.) ryglowy
half-time : half-time : (rzecz.) przerwa
half-title : half-title : (rzecz.) przedtytuł
half-tone : half-tone : (rzecz.) półton
half-truth : half-truth : (rzecz.) półprawda
half-turn : half-turn : (rzecz.) półobrót
half-wit : half-wit : (rzecz.) półgłówek
half-witted : half-witted : (przym.) głupkowaty
half-year : half-year : (rzecz.) półrocze | : (rzecz.) semestr
half-yearly : half-yearly : (przym.) półroczny
halfback : halfback : (rzecz.) obrońca | : (rzecz.) stoper
halftime : halftime : (rzecz.) połowa | : (rzecz.) przerwa
halftone : halftone : (rzecz.) półcienie | : (rzecz.) półton
halfwit : halfwit : (rzecz.) półgłówek
halibut : halibut : (rzecz.) halibut | : (rzecz.) płastuga
halide : halide : (rzecz.) halogenek
halite : halite : (rzecz.) halit
hall : hall : (rzecz.) aula | : (rzecz.) hala | : (rzecz.) hall | : (rzecz.) hol | : (rzecz.) korytarz | : (rzecz.) przedpokój | : (rzecz.) sala
hall-mark : hall-mark : (rzecz.) cecha | : (rzecz.) oznaka | : (rzecz.) piętno
halleluiah : halleluiah : (wykrzyknik) alleluja
hallelujah : hallelujah : (wykrzyknik) alleluja
hallmark : hallmark : (rzecz.) cecha | : (rzecz.) oznaka | : (rzecz.) piętno | : (rzecz.) próba
halloo : halloo : (czas.) poszczuć
hallow : hallow : (czas.) poświęcać | : (czas.) święcić | : (czas.) uświęcać
hallowed : hallowed : (przym.) czcigodny | : (przym.) święty
halls : halls : (rzecz.) salami
hallucination : hallucination : (rzecz.) halucynacja | : (rzecz.) majaczenie | : (rzecz.) omam
hallucinations : hallucinations : (rzecz.) majaczenie
hallucinatory : hallucinatory : (przym.) halucynacyjny
hallucinogen : hallucinogen : (rzecz.) halucynogen
hallucinogenic : hallucinogenic : (przym.) halucynogenny
hallway : hallway : (rzecz.) korytarz | : (rzecz.) sień
halo : halo : (rzecz.) aureola | : (rzecz.) nimb | : (rzecz.) odblask
halogen : halogen : (rzecz.) chlorowiec
halt : halt : (czas.) rozłączyć | : (czas.) stać | : (czas.) stawać | : (czas.) zatrzymać | : (czas.) zatrzymywać | : (czas.) zawahać | : (czas.) zawiesić | : (rzecz.) popas | : (rzecz.) postój | : (rzecz.) powstrzymanie | : (rzecz.) przystanek | : (rzecz.) stacja | : (rzecz.) utykanie | : (rzecz.) zatrzymanie
halter : halter : (rzecz.) kantar | : (rzecz.) postronek | : (rzecz.) stryczek | : (rzecz.) uździenica
halting : halting : (przym.) postojowy
haltingly : haltingly : (przysł.) wahająco
halva : halva : (rzecz.) chałwa
halvah : halvah : (rzecz.) chałwa
halve : halve : (czas.) przepoławiać | : (czas.) przepołowić | : (czas.) rozpołowić
halyard : halyard : (rzecz.) fał | : (rzecz.) flaglinka | : (rzecz.) podnośnica
ham : ham : (rzecz.) baleron | : (rzecz.) radioamator | : (rzecz.) szynka | : (rzecz.) zad
ham-fisted : ham-fisted : (przym.) nieporadny | : (przym.) niezdarny | : (przym.) niezręczny
ham-handed : ham-handed : (przym.) niezdarny | : (przym.) niezręczny
hamburger : hamburger : (rzecz.) hamburger
hamlet : hamlet : (rzecz.) osada | : (rzecz.) sioło | : (rzecz.) wioska
hammer : hammer : (czas.) uderzać | : (czas.) walić | : (czas.) wbijać | : (czas.) zaklepać | : (rzecz.) młot | : (rzecz.) młotek
hammer-smith : hammer-smith : (przym.) młotowy
hammerer : hammerer : (rzecz.) młotnik
hammering : hammering : (rzecz.) młotkowanie | : (rzecz.) młotowanie | : (rzecz.) wbijanie
hammock : hammock : (rzecz.) hamak
hammy : hammy : (przym.) kabotyński
hamper : hamper : (czas.) hamować | : (czas.) przeszkadzać | : (czas.) utrudniać | : (rzecz.) hamowanie | : (rzecz.) kosz | : (rzecz.) koszałka | : (rzecz.) ograniczanie | : (rzecz.) przeszkadzanie
hamster : hamster : (rzecz.) chomik
hamstring : hamstring : (rzecz.) sparaliżowanie
hand : hand : (czas.) podawać | : (czas.) wręczać | : (czas.) wręczyć | : (rzecz.) chwyt | : (rzecz.) dłoń | : (rzecz.) pracownik | : (rzecz.) ręka | : (rzecz.) rozdanie | : (rzecz.) udział | : (rzecz.) wskazówka
hand-axe : hand-axe : (rzecz.) toporek
hand-barrow : hand-barrow : (rzecz.) nosze
hand-bill : hand-bill : (rzecz.) ulotka
hand-cart : hand-cart : (rzecz.) wózek
hand-held : hand-held : (przym.) podręczny | : (przym.) ręczny
hand-made : hand-made : (przym.) odręczny
hand-rail : hand-rail : (rzecz.) balustrada | : (rzecz.) poręcz
handbag : handbag : (rzecz.) torebka
handbill : handbill : (rzecz.) ulotka
handbook : handbook : (rzecz.) informator | : (rzecz.) podręcznik | : (rzecz.) poradnik | : (rzecz.) wademekum
handcart : handcart : (rzecz.) wózek
handcuff : handcuff : (rzecz.) kajdanki | : (rzecz.) kajdany
handcuffs : handcuffs : (rzecz.) kajdanek | : (rzecz.) kajdanki | : (rzecz.) kajdany
handful : handful : (rzecz.) garść | : (rzecz.) garstka
handgun : handgun : (rzecz.) pistolet | : (rzecz.) rewolwer
handheld : handheld : (przym.) kieszonkowy | : (przym.) podręczny | : (przym.) ręczny
handhold : handhold : (rzecz.) poręczhand
handicap : handicap : (rzecz.) fory | : (rzecz.) niepełnosprawność | : (rzecz.) obciążenie | : (rzecz.) przeszkoda | : (rzecz.) ułomność | : (rzecz.) upośledzenie | : (rzecz.) utrudnienie | : (rzecz.) zawada
handicapped : handicapped : (przym.) niepełnosprawny | : (przym.) ułomny
handicraft : handicraft : (rzecz.) rękodzielnictwo | : (rzecz.) rękodzieło | : (rzecz.) rzemiosło
handicraftsman : handicraftsman : (rzecz.) rękodzielnik | : (rzecz.) rzemieślnik
handily : handily : (przysł.) łatwo | : (przysł.) zręcznie
handiness : handiness : (rzecz.) zręczność | : (rzecz.) zwrotność
handkerchief : handkerchief : (rzecz.) chusteczka | : (rzecz.) chustka
handle : handle : (czas.) dotykać | : (czas.) kierować | : (czas.) manipulować | : (czas.) obchodzić | : (czas.) obracać | : (czas.) obsługiwać | : (czas.) obsłużyć | : (czas.) odcinać | : (czas.) posługiwać | : (czas.) przerabiać | : (czas.) traktować | : (rzecz.) antaba | : (rzecz.) chwyt | : (rzecz.) dojście | : (rzecz.) klamka | : (rzecz.) rączka | : (rzecz.) rękojeść | : (rzecz.) stylisko | : (rzecz.) trzonek | : (rzecz.) ucho | : (rzecz.) uchwyt | : (rzecz.) uszko | : (rzecz.) zacisk
handle-bar : handle-bar : (rzecz.) kierownica | : (rzecz.) poręcz
handlebar : handlebar : (rzecz.) kierownica | : (rzecz.) poręcz
handled : handled : (czas.) obchodzić
handler : handler : (rzecz.) farba | : (rzecz.) trener | : (rzecz.) treser
handles : handles : (rzecz.) kolportaż
handling : handling : (rzecz.) obchodzenie | : (rzecz.) obsługa | : (rzecz.) obsługiwanie | : (rzecz.) opracowanie | : (rzecz.) przeładunek | : (rzecz.) załatwienie
handmade : handmade : (przym.) odręczny
handmaid : handmaid : (rzecz.) służebnica
handmaiden : handmaiden : (rzecz.) służebnica
handout : handout : (rzecz.) datek | : (rzecz.) jałmużna | : (rzecz.) ulotka
handrail : handrail : (rzecz.) balustrada | : (rzecz.) bariera | : (rzecz.) poręcz
hands-off : hands-off : (przym.) nieinterwencyjny
handset : handset : (rzecz.) mikrotelefon | : (rzecz.) słuchawka
handshake : handshake : (rzecz.) chwyt | : (rzecz.) uścisk | : (rzecz.) uzgodnienie | : (rzecz.) zacisk
handshaking : handshaking : (rzecz.) uzgadnianie
handsome : handsome : (przym.) atrakcyjny | : (przym.) dorodny | : (przym.) foremny | : (przym.) hojny | : (przym.) ładny | : (przym.) nadobny | : (przym.) pokaźny | : (przym.) postawny | : (przym.) przystojny | : (przym.) urodziwy
handsomely : handsomely : (przysł.) elegancko | : (przysł.) ładnie
handstand : handstand : (rzecz.) stójka
handwork : handwork : (rzecz.) rękodzieło
handwriting : handwriting : (rzecz.) pismo
handwritten : handwritten : (przym.) odręczny
handy : handy : (przym.) dogodny | : (przym.) podręczny | : (przym.) poręczny | : (przym.) przydatny | : (przym.) sprytny | : (przym.) wygodny | : (przym.) zręczny
handy-man : handy-man : (przym.) zręczny
handyman : handyman : (rzecz.) majster | : (rzecz.) majsterkowicz
hang : hang : (czas.) obijać | : (czas.) powiesić | : (czas.) wałęsać | : (czas.) wieszać | : (czas.) wisieć | : (czas.) zawiesić | : (czas.) zawieszać | : (czas.) zwisać
hang-glider : hang-glider : (rzecz.) lotnia | : (rzecz.) lotniarz
hang-gliding : hang-gliding : (rzecz.) lotniarstwo | : (rzecz.) paralotniarstwo
hang-over : hang-over : (rzecz.) kac
hang-up : hang-up : (rzecz.) obawa | : (rzecz.) rozejm | : (rzecz.) zahamowanie | : (rzecz.) zawieszenie
hangar : hangar : (rzecz.) hangar
hangdog : hangdog : (rzecz.) szubienicznik
hanger : hanger : (rzecz.) pasożyt | : (rzecz.) pieczeniarz | : (rzecz.) wieszak | : (rzecz.) zapychacz
hanger-on : hanger-on : (rzecz.) pieczeniarz | : (rzecz.) pochlebca
hanging : hanging : (rzecz.) obwieszenie | : (rzecz.) powieszenie | : (rzecz.) wieszanie | : (rzecz.) wiszenie | : (rzecz.) zawieszenie | : (rzecz.) zwisanie
hangman : hangman : (rzecz.) kat | : (rzecz.) oprawca | : (rzecz.) wisielec
hangnail : hangnail : (rzecz.) zadzior
hangover : hangover : (rzecz.) kac | : (rzecz.) kociokwik | : (rzecz.) pozostałość | : (rzecz.) przeżytek
hank : hank : (rzecz.) kłębek | : (rzecz.) motek | : (rzecz.) pełzacz
hanker : hanker : (czas.) tęsknić | : (czas.) wzdychać
hankering : hankering : (rzecz.) potrzeba | : (rzecz.) pożądanie | : (rzecz.) pragnienie | : (rzecz.) tęsknota
hanky-panky : hanky-panky : (rzecz.) oszustwo
hansom : hansom : (rzecz.) dwukołowiec
haphazard : haphazard : (przym.) dorywczy | : (przym.) niesystematyczny | : (przym.) przypadkowy | : (przysł.) przypadkowo | : (rzecz.) przypadek
haphazardly : haphazardly : (przysł.) przypadkowo
hapless : hapless : (przym.) feralny | : (przym.) nieszczęśliwy
haplite : haplite : (rzecz.) aplit
haploid : haploid : (rzecz.) haploid
happen : happen : (czas.) natrafić | : (czas.) przydarzać | : (czas.) przydarzyć | : (czas.) trafić | : (czas.) wydarzyć | : (czas.) zaistnieć | : (czas.) zdarzać | : (czas.) zdarzyć | : (czas.) znajdować
happening : happening : (rzecz.) wydarzenie | : (rzecz.) zdarzenie
happenstance : happenstance : (rzecz.) ewentualność
happily : happily : (przysł.) szczęśliwie | : (przysł.) wesoło
happiness : happiness : (rzecz.) błogostan | : (rzecz.) szczęście | : (rzecz.) szczęśliwość | : (rzecz.) uszczęśliwienie
happy : happy : (przym.) radosny | : (przym.) szczęśliwy
happy-go-lucky : happy-go-lucky : (przym.) beztroski | : (przym.) niefrasobliwy
hara-kiri : hara-kiri : (rzecz.) harakiri
harangue : harangue : (rzecz.) przemowa | : (rzecz.) przemówienie
harass : harass : (czas.) dokuczać | : (czas.) dręczyć | : (czas.) gnębić | : (czas.) morzyć | : (czas.) nacierać | : (czas.) nękać | : (czas.) niepokoić
harassment : harassment : (rzecz.) molestowanie | : (rzecz.) napastowanie | : (rzecz.) nękanie | : (rzecz.) prześladowanie | : (rzecz.) szykana | : (rzecz.) szykanowanie
harbinger : harbinger : (rzecz.) zwiastowanie | : (rzecz.) zwiastun
harbour : harbour : (czas.) żywić | : (rzecz.) port | : (rzecz.) przystań | : (rzecz.) schronienie
harbourage : harbourage : (rzecz.) przystań | : (rzecz.) schronienie
hard : hard : (przym.) ciężki | : (przym.) ostry | : (przym.) przenikliwy | : (przym.) surowy | : (przym.) trudny | : (przym.) twardy | : (przym.) usilny | : (przysł.) ciężko | : (przysł.) mocno | : (przysł.) obficie | : (przysł.) silnie | : (przysł.) trudno | : (przysł.) twardo
hard-boiled : hard-boiled : (przym.) bezwzględny | : (przym.) niezmienny | : (przym.) twardy
hard-coded : hard-coded : (przym.) niezmienny | : (przym.) ustalony
hard-core : hard-core : (przym.) niezmienny | : (przym.) twardy | : (przym.) wulgarny
hard-fisted : hard-fisted : (przym.) skąpy
hard-headed : hard-headed : (przym.) praktyczny
hard-hearted : hard-hearted : (przym.) bezwzględny
hard-wired : hard-wired : (przym.) układowy
hard-working : hard-working : (przym.) pracowity | : (przym.) robotny
hardboiled : hardboiled : (przym.) bezwzględny | : (przym.) niezmienny | : (przym.) twardy | : (przym.) uparty
hardcopy : hardcopy : (rzecz.) wydruk
hardcore : hardcore : (przym.) niezmienny | : (przym.) twardy | : (przym.) wulgarny | : (rzecz.) trzon
harden : harden : (czas.) hartować | : (czas.) stężeć | : (czas.) twardnieć | : (czas.) umacniać | : (czas.) umocnić | : (czas.) uodpornić | : (czas.) utwardzać | : (czas.) wapnieć | : (czas.) wzmacniać
hardener : hardener : (rzecz.) utwardzacz | : (rzecz.) zaprawa
hardening : hardening : (rzecz.) hartowanie | : (rzecz.) stwardnienie | : (rzecz.) twardnienie | : (rzecz.) utwardzanie | : (rzecz.) utwardzenie | : (rzecz.) zahartowanie
hardhearted : hardhearted : (przym.) bezwzględny
hardihood : hardihood : (rzecz.) odwaga | : (rzecz.) zuchwalstwo
hardiness : hardiness : (rzecz.) hardość | : (rzecz.) wytrzymałość
hardly : hardly : (przysł.) ledwie | : (przysł.) ledwo | : (przysł.) prawie | : (przysł.) zaledwie
hardness : hardness : (rzecz.) twardość | : (rzecz.) wytrzymałość
hardpan : hardpan : (rzecz.) orsztyn | : (rzecz.) rudawiec
hardship : hardship : (rzecz.) bieda | : (rzecz.) dolegliwość | : (rzecz.) męka | : (rzecz.) niedostatek | : (rzecz.) niewygoda | : (rzecz.) trud | : (rzecz.) trudność | : (rzecz.) znój
hardtack : hardtack : (rzecz.) suchar
hardware : hardware : (rzecz.) hardware | : (rzecz.) informatyk | : (rzecz.) osprzęt | : (rzecz.) sprzęt | : (rzecz.) żelastwo
hardworking : hardworking : (przym.) robotny
hardy : hardy : (przym.) mocny | : (przym.) odporny | : (przym.) odważny | : (przym.) śmiały
hare : hare : (rzecz.) szarak | : (rzecz.) zając
hark : hark : (czas.) posłuchać | : (czas.) słuchać
harlequin : harlequin : (rzecz.) arlekin | : (rzecz.) pajac
harlequinade : harlequinade : (rzecz.) arlekinada
harlot : harlot : (rzecz.) jawnogrzesznica | : (rzecz.) ladacznica | : (rzecz.) nierządnica
harlotry : harlotry : (rzecz.) nierząd | : (rzecz.) wszeteczeństwo
harm : harm : (rzecz.) krzywda | : (rzecz.) krzywdzenie | : (rzecz.) skrzywdzenie | : (rzecz.) szkoda | : (rzecz.) szkodliwość | : (rzecz.) szwank | : (rzecz.) zło
harmful : harmful : (przym.) szkodliwy | : (przym.) ujemny
harmfully : harmfully : (przysł.) szkodliwie
harmfulness : harmfulness : (rzecz.) szkodliwość
harmless : harmless : (przym.) niegroźny | : (przym.) nieszkodliwy | : (przym.) niewinny
harmlessly : harmlessly : (przysł.) nieszkodliwie | : (przysł.) niewinnie
harmlessness : harmlessness : (rzecz.) nieszkodliwość
harmonic : harmonic : (przym.) harmoniczny | : (przym.) harmonijny | : (rzecz.) harmoniczna
harmonica : harmonica : (rzecz.) harmonijka | : (rzecz.) harmonika
harmonics : harmonics : (rzecz.) harmonika
harmonious : harmonious : (przym.) harmonijny | : (przym.) melodyjny | : (przym.) zgodny
harmoniously : harmoniously : (przysł.) harmonijnie
harmoniousness : harmoniousness : (rzecz.) harmoniczność
harmonise : harmonise : (czas.) współbrzmieć
harmonist : harmonist : (rzecz.) harmonista
harmonium : harmonium : (rzecz.) fisharmonia
harmonization : harmonization : (rzecz.) harmonizacja
harmonize : harmonize : (czas.) harmonizować | : (czas.) ujednolicać | : (czas.) współbrzmieć | : (czas.) zharmonizować
harmony : harmony : (rzecz.) harmonia | : (rzecz.) zestrój | : (rzecz.) zestrojenie | : (rzecz.) zgoda | : (rzecz.) zgodność | : (rzecz.) zgranie
harness : harness : (czas.) zaprzęgać | : (rzecz.) okablowanie | : (rzecz.) uprząż
harnessed : harnessed : (czas.) ujarzmić
harp : harp : (czas.) ględzić | : (rzecz.) harfa
harpist : harpist : (rzecz.) harfiarz
harpoon : harpoon : (rzecz.) harpun
harpooner : harpooner : (rzecz.) harpunnik
harpsichord : harpsichord : (rzecz.) klawesyn | : (rzecz.) klawikord
harpy : harpy : (rzecz.) harpia | : (rzecz.) jędza
harquebus : harquebus : (rzecz.) rusznica
harridan : harridan : (rzecz.) wiedźma
harrier : harrier : (rzecz.) błotniak | : (rzecz.) ciskacz | : (rzecz.) grabieżca | : (rzecz.) rabuś | : (rzecz.) wozak
harrow : harrow : (czas.) bronować | : (czas.) dokuczać | : (czas.) męczyć | : (czas.) pustoszyć | : (czas.) wybronować | : (czas.) wymęczyć | : (czas.) zabronować | : (rzecz.) brona
harsh : harsh : (przym.) brutalny | : (przym.) chrapliwy | : (przym.) chropowaty | : (przym.) cierpki | : (przym.) ciężki | : (przym.) nieprzyjemny | : (przym.) ostry | : (przym.) przykry | : (przym.) srogi | : (przym.) surowy | : (przym.) szorstki | : (przym.) zgrzytliwy
harshly : harshly : (przysł.) cierpko | : (przysł.) opryskliwie | : (przysł.) szorstko | : (przysł.) zgryźliwie
harshness : harshness : (rzecz.) chropowatość | : (rzecz.) opryskliwość | : (rzecz.) surowość | : (rzecz.) szorstkość
hart : hart : (rzecz.) jeleń | : (rzecz.) rogacz
harum-scarum : harum-scarum : (rzecz.) postrzeleniec
harvest : harvest : (czas.) zbierać | : (rzecz.) dożynki | : (rzecz.) plon | : (rzecz.) urodzaj | : (rzecz.) zbiór | : (rzecz.) żniwa | : (rzecz.) żniwo
harvester : harvester : (rzecz.) kombajn | : (rzecz.) podbieracz | : (rzecz.) żniwiarz
harvesting : harvesting : (rzecz.) żęcie
has : has : (czas.) mieć | : (czas.) musieć
hash : hash : (czas.) posiekać | : (czas.) siekać | : (rzecz.) hasz | : (rzecz.) mieszanie | : (rzecz.) mieszanina | : (rzecz.) pomyłkowe | : (rzecz.) siekanina | : (rzecz.) siekanka | : (rzecz.) szumy
hashish : hashish : (rzecz.) haszysz
hasp : hasp : (rzecz.) klamka | : (rzecz.) skobel | : (rzecz.) zasuwka
hassle : hassle : (czas.) dokuczać | : (czas.) dręczyć | : (czas.) zamęczać | : (rzecz.) kłopot
hassock : hassock : (rzecz.) pęk
haste : haste : (rzecz.) pośpiech
hasten : hasten : (czas.) pędzić | : (czas.) pospieszyć | : (czas.) przynaglać | : (czas.) przyspieszać | : (czas.) przyśpieszać | : (czas.) spieszyć | : (czas.) śpieszyć
hastily : hastily : (przysł.) lekkomyślnie | : (przysł.) naprędce | : (przysł.) pochopnie | : (przysł.) pospiesznie | : (przysł.) pośpiesznie | : (przysł.) szybko
hastiness : hastiness : (rzecz.) nierozwaga | : (rzecz.) pochopność | : (rzecz.) porywczość | : (rzecz.) pośpiech
hasty : hasty : (przym.) gwałtowny | : (przym.) pochopny | : (przym.) popędliwy | : (przym.) pospieszny | : (przym.) pośpieszny | : (przym.) szybki
hat : hat : (rzecz.) czapka | : (rzecz.) kapelusz | : (rzecz.) mycka
hatch : hatch : (czas.) kreskować | : (czas.) legnąć | : (czas.) lęgnąć | : (czas.) spiskować | : (czas.) wykluwać | : (czas.) wylegać | : (czas.) wylęgać | : (czas.) wysiadywać | : (czas.) zakreskować | : (rzecz.) drzwiczki | : (rzecz.) luk | : (rzecz.) śluza | : (rzecz.) właz | : (rzecz.) wyklucie | : (rzecz.) wyląg | : (rzecz.) wylęg
hatchery : hatchery : (rzecz.) wylęgarnia
hatchet : hatchet : (rzecz.) ciupaga | : (rzecz.) siekiera | : (rzecz.) siekierka | : (rzecz.) topór | : (rzecz.) toporek
hatching : hatching : (rzecz.) klucie | : (rzecz.) kreskowanie | : (rzecz.) wyklucie | : (rzecz.) wylęganie
hatchway : hatchway : (rzecz.) luk | : (rzecz.) właz
hate : hate : (czas.) nienawidzić | : (rzecz.) nienawiść
hateful : hateful : (przym.) nienawistny | : (przym.) okropny
hatefully : hatefully : (przysł.) nienawistnie
hater : hater : (rzecz.) przeciwnik
hating : hating : (czas.) nienawidzić | : (rzecz.) nienawiść
hatred : hatred : (rzecz.) nienawiść
hatter : hatter : (rzecz.) kapelusznik
hauberk : hauberk : (rzecz.) kolczuga
haughtily : haughtily : (przysł.) wyniośle | : (przysł.) wysoko
haughtiness : haughtiness : (rzecz.) arogancja | : (rzecz.) duma | : (rzecz.) hardość | : (rzecz.) pycha | : (rzecz.) wyniosłość
haughty : haughty : (przym.) butny | : (przym.) dumny | : (przym.) hardy | : (przym.) wyniosły
haul : haul : (czas.) holować | : (czas.) transportować | : (rzecz.) ciągnienie | : (rzecz.) holowanie | : (rzecz.) połów | : (rzecz.) wleczenie | : (rzecz.) zaciąg
haulage : haulage : (rzecz.) holowanie | : (rzecz.) odstawa | : (rzecz.) transport
hauler : hauler : (rzecz.) holownik | : (rzecz.) przewoźnik | : (rzecz.) spedytor | : (rzecz.) wozak | : (rzecz.) woźnica
haulm : haulm : (rzecz.) łodyga | : (rzecz.) nać
haunch : haunch : (rzecz.) biodro | : (rzecz.) pośladek | : (rzecz.) udziec
haunt : haunt : (czas.) nawiedzać | : (czas.) niepokoić | : (czas.) odwiedzać | : (czas.) straszyć | : (czas.) zwiedzać | : (rzecz.) kryjówka | : (rzecz.) spelunka
haunting : haunting : (przym.) natrętny
hautboy : hautboy : (rzecz.) obój
hauteur : hauteur : (rzecz.) duma
have : have : (czas.) być | : (czas.) cechować | : (czas.) dostawać | : (czas.) dysponować | : (czas.) jeść | : (czas.) mieć | : (czas.) miewać | : (czas.) posiadać
haven : haven : (rzecz.) przystań | : (rzecz.) schronienie
haversack : haversack : (rzecz.) chlebak | : (rzecz.) plecak
having : having : (przysł.) żmudnie | : (rzecz.) dobytek | : (rzecz.) własność
havoc : havoc : (rzecz.) spustoszenie | : (rzecz.) zamieszanie | : (rzecz.) zniszczenie
haw : haw : (rzecz.) głóg | : (rzecz.) rechot
hawfinch : hawfinch : (rzecz.) grubodziób
hawk : hawk : (czas.) kolportować | : (czas.) odchrząkiwać | : (rzecz.) jastrząb | : (rzecz.) łupieżca | : (rzecz.) sokół
hawker : hawker : (rzecz.) domokrążca | : (rzecz.) sprzedawca
hawkish : hawkish : (przym.) jastrzębi | : (przym.) konfrontacyjny
hawser : hawser : (rzecz.) cuma | : (rzecz.) lina
hawthorn : hawthorn : (rzecz.) głóg
hay : hay : (rzecz.) siano
hay-maker : hay-maker : (rzecz.) grabiarka
hay-making : hay-making : (rzecz.) sianokosy
hay-rake : hay-rake : (rzecz.) grabiarka
haymaker : haymaker : (rzecz.) grabiarka | : (rzecz.) kosiarz
haymaking : haymaking : (rzecz.) sianokosy
haystack : haystack : (rzecz.) bróg | : (rzecz.) stóg
hazard : hazard : (czas.) ryzykować | : (rzecz.) hazard | : (rzecz.) niebezpieczeństwo | : (rzecz.) przypadek | : (rzecz.) ryzyko | : (rzecz.) zagrożenie
hazardous : hazardous : (przym.) awanturniczy | : (przym.) hazardowy | : (przym.) niebezpieczny | : (przym.) ryzykowny
haze : haze : (rzecz.) mgiełka | : (rzecz.) mgła | : (rzecz.) opar | : (rzecz.) otumanienie | : (rzecz.) zamglenie
hazel : hazel : (rzecz.) leszczyna
hazel-grouse : hazel-grouse : (rzecz.) jarząbek
hazel-hen : hazel-hen : (rzecz.) jarząbek
haziness : haziness : (rzecz.) mglistość | : (rzecz.) niejasność
hazy : hazy : (przym.) mglisty | : (przym.) niewyraźny | : (przym.) zamglony
head : head : (rzecz.) czub | : (rzecz.) dyrektor | : (rzecz.) głowa | : (rzecz.) głowica | : (rzecz.) głowizna | : (rzecz.) główka | : (rzecz.) kierownik | : (rzecz.) kożuch | : (rzecz.) kurs | : (rzecz.) łeb | : (rzecz.) łepetyna | : (rzecz.) makówka | : (rzecz.) mózgownica | : (rzecz.) naczelnik | : (rzecz.) nadlew | : (rzecz.) nagłówek | : (rzecz.) obuch | : (rzecz.) ordynator | : (rzecz.) piana | : (rzecz.) przywódca | : (rzecz.) szczyt | : (rzecz.) szef | : (rzecz.) umysł
head-dress : head-dress : (rzecz.) fryzura | : (rzecz.) ufryzowanie
head-light : head-light : (rzecz.) reflektor
head-line : head-line : (rzecz.) nagłówek
head-piece : head-piece : (rzecz.) hełm | : (rzecz.) stropnica
head-rest : head-rest : (rzecz.) podgłówek
head-voice : head-voice : (rzecz.) falset
headache : headache : (rzecz.) zmartwienie
headband : headband : (rzecz.) kapitałka | : (rzecz.) opaska | : (rzecz.) pałąk
headcheese : headcheese : (rzecz.) salceson
headdress : headdress : (rzecz.) fryzura | : (rzecz.) ufryzowanie
headed : headed : (przym.) głowiasty
header : header : (rzecz.) cegła | : (rzecz.) główka | : (rzecz.) komora | : (rzecz.) kuźniarka | : (rzecz.) nagłówek | : (rzecz.) sekcja | : (rzecz.) skrzynia
headiness : headiness : (rzecz.) nierozwaga | : (rzecz.) porywczość
heading : heading : (rzecz.) kurs | : (rzecz.) nagłówek | : (rzecz.) wyrobisko
headlamp : headlamp : (rzecz.) reflektor
headland : headland : (rzecz.) cypel | : (rzecz.) przylądek
headlight : headlight : (rzecz.) reflektor
headline : headline : (rzecz.) nagłówek
headlines : headlines : (rzecz.) nagłówki
headman : headman : (rzecz.) ciskacz | : (rzecz.) przodownik | : (rzecz.) przywódca | : (rzecz.) wódz | : (rzecz.) wozak
headmaster : headmaster : (rzecz.) dyrektor
headmistress : headmistress : (rzecz.) dyrektorka
headphone : headphone : (rzecz.) słuchawka
headphones : headphones : (rzecz.) słuchawki
headpiece : headpiece : (rzecz.) hełm | : (rzecz.) winieta
headquarters : headquarters : (rzecz.) centrala | : (rzecz.) dowództwo | : (rzecz.) komenda | : (rzecz.) komendantura | : (rzecz.) kwatera | : (rzecz.) sztab
headrest : headrest : (rzecz.) podgłówek | : (rzecz.) zagłówek
headroom : headroom : (rzecz.) prześwit
headscarf : headscarf : (rzecz.) chusta
headset : headset : (rzecz.) hełmofon | : (rzecz.) słuchawka
headsman : headsman : (rzecz.) kat
headstall : headstall : (rzecz.) naczółek
headstone : headstone : (rzecz.) nagrobek
headstrong : headstrong : (przym.) nieustępliwy
headway : headway : (rzecz.) postęp | : (rzecz.) posuw | : (rzecz.) powodzenie
headword : headword : (rzecz.) hasło
heady : heady : (przym.) gwałtowny | : (przym.) mocny | : (przym.) upojny
heal : heal : (czas.) bliźnić | : (czas.) goić | : (czas.) łagodzić | : (czas.) leczyć | : (czas.) uleczyć | : (czas.) uśmierzyć | : (czas.) uspokajać | : (czas.) uzdrawiać | : (czas.) uzdrowić | : (czas.) wydobrzeć | : (czas.) wyleczyć | : (czas.) zagoić
healable : healable : (przym.) wyleczalny
healer : healer : (rzecz.) uzdrawiacz | : (rzecz.) uzdrowiciel
healing : healing : (przym.) leczniczy | : (rzecz.) gojenie | : (rzecz.) leczenie | : (rzecz.) uzdrawianie | : (rzecz.) uzdrowienie | : (rzecz.) wygojenie | : (rzecz.) zagojenie | : (rzecz.) zgojenie
health : health : (rzecz.) zdrowie | : (rzecz.) zdrowotność
healthful : healthful : (przym.) odżywczy | : (przym.) zdrowy
healthily : healthily : (przysł.) zdrowo
healthy : healthy : (przym.) silny | : (przym.) zdrów | : (przym.) zdrowotny | : (przym.) zdrowy
heap : heap : (czas.) gromadzić | : (czas.) obładować | : (czas.) piętrzyć | : (czas.) spiętrzać | : (czas.) zładować | : (rzecz.) fura | : (rzecz.) góra | : (rzecz.) gromada | : (rzecz.) hałda | : (rzecz.) kupa | : (rzecz.) kupka | : (rzecz.) mnóstwo | : (rzecz.) pryzma | : (rzecz.) pudło | : (rzecz.) sterta | : (rzecz.) stóg | : (rzecz.) stos | : (rzecz.) usypisko | : (rzecz.) zwał
hear : hear : (czas.) dosłyszeć | : (czas.) dowiedzieć | : (czas.) nasłuchać | : (czas.) przesłuchać | : (czas.) przesłuchiwać | : (czas.) słuchać | : (czas.) słychać | : (czas.) słyszeć | : (czas.) usłyszeć | : (czas.) wiedzieć
heard : heard : (czas.) słyszeć
hearer : hearer : (rzecz.) słuchacz
hearing : hearing : (rzecz.) próba | : (rzecz.) przesłuchanie | : (rzecz.) rozprawa | : (rzecz.) słuch | : (rzecz.) słuchanie | : (rzecz.) słyszenie | : (rzecz.) wysłuchanie | : (rzecz.) zmysł
hearken : hearken : (czas.) słuchać
hearsay : hearsay : (rzecz.) plotka | : (rzecz.) pogłoska
hearse : hearse : (rzecz.) karawan | : (rzecz.) katafalk
heart : heart : (rzecz.) głąb | : (rzecz.) kardiolog | : (rzecz.) męstwo | : (rzecz.) rdzeń | : (rzecz.) sedno | : (rzecz.) serce
heart-burn : heart-burn : (rzecz.) zgaga
heart-burning : heart-burning : (rzecz.) zawiść
heart-felt : heart-felt : (przym.) szczery
heart-shaped : heart-shaped : (przym.) sercowaty
heart-to-heart : heart-to-heart : (przym.) szczery
heart-wood : heart-wood : (rzecz.) twardziel
heartache : heartache : (rzecz.) cierpienie | : (rzecz.) smutek | : (rzecz.) strapienie
heartbeat : heartbeat : (rzecz.) uderzenie
heartbreak : heartbreak : (rzecz.) boleść | : (rzecz.) żal | : (rzecz.) zawód
heartburn : heartburn : (rzecz.) zgaga
heartburning : heartburning : (rzecz.) zawiść
hearten : hearten : (czas.) dodawać | : (czas.) pocieszać
heartfelt : heartfelt : (przym.) szczery
hearth : hearth : (rzecz.) kominek | : (rzecz.) krata | : (rzecz.) ognisko | : (rzecz.) palenisko | : (rzecz.) spód | : (rzecz.) spodek | : (rzecz.) topnisko | : (rzecz.) trzon
heartiest : heartiest : (przym.) obfity | : (przym.) serdeczny | : (przym.) szczery
heartily : heartily : (przysł.) ochoczo | : (przysł.) serdecznie
heartiness : heartiness : (rzecz.) serdeczność
heartland : heartland : (rzecz.) centrum
heartlessness : heartlessness : (rzecz.) nieczułość
hearts : hearts : (rzecz.) kier
hearty : hearty : (przym.) kordialny | : (przym.) obfity | : (przym.) serdeczny | : (przym.) silny | : (przym.) szczery
heat : heat : (czas.) dogrzać | : (czas.) grzać | : (czas.) nagrzać | : (czas.) nagrzewać | : (czas.) napalić | : (czas.) ogrzać | : (czas.) ogrzewać | : (czas.) palić | : (czas.) podgrzać | : (czas.) podgrzewać | : (czas.) pogrzać | : (czas.) rozżarzać | : (czas.) wygrzać | : (czas.) zagrzewać | : (przym.) cieplny | : (rzecz.) cieczka | : (rzecz.) ciepło | : (rzecz.) ciepłownictwo | : (rzecz.) gorąco | : (rzecz.) ogrzewanie | : (rzecz.) skwar | : (rzecz.) spiekota | : (rzecz.) upał | : (rzecz.) wytop | : (rzecz.) żar
heat-hardening : heat-hardening : (przym.) termoutwardzalny
heat-insulating : heat-insulating : (przym.) termoizolacyjny
heat-proof : heat-proof : (przym.) żaroodporny
heat-resistant : heat-resistant : (przym.) żaroodporny
heat-resisting : heat-resisting : (przym.) termoodporny | : (przym.) żaroodporny
heat-sink : heat-sink : (rzecz.) radiator
heated : heated : (przym.) gorący | : (przym.) ożywiony | : (przym.) zapalczywy
heater : heater : (rzecz.) grzałka | : (rzecz.) grzejnik | : (rzecz.) nagrzewacz | : (rzecz.) nagrzewnica | : (rzecz.) ogrzewacz | : (rzecz.) piecyk | : (rzecz.) podgrzewacz
heath : heath : (rzecz.) pustkowie | : (rzecz.) wrzos | : (rzecz.) wrzosiec | : (rzecz.) wrzosowisko
heath-cock : heath-cock : (rzecz.) cietrzew
heathen : heathen : (rzecz.) poganin | : (rzecz.) pogaństwo
heathenish : heathenish : (przym.) pogański
heathenism : heathenism : (rzecz.) pogaństwo
heather : heather : (rzecz.) wrzos
heating : heating : (rzecz.) ciepłomierz | : (rzecz.) grzanie | : (rzecz.) nagrzewanie | : (rzecz.) ogrzewanie | : (rzecz.) ogrzewnictwo | : (rzecz.) opalenie | : (rzecz.) podgrzewanie | : (rzecz.) rozgrzanie
heatproof : heatproof : (przym.) żaroodporny
heave : heave : (czas.) dźwigać | : (czas.) podźwigać | : (czas.) wydobywać | : (rzecz.) dźwignięcie | : (rzecz.) nurzanie | : (rzecz.) podniesienie | : (rzecz.) wysadzina
heaven : heaven : (rzecz.) niebiosa | : (rzecz.) niebo
heaven-sent : heaven-sent : (przym.) opatrznościowy
heavenly : heavenly : (przym.) cudowny | : (przym.) nadziemski | : (przym.) niebiański | : (przym.) niebieski | : (przym.) rajski
heavens : heavens : (rzecz.) niebiosa
heaver : heaver : (rzecz.) drąg | : (rzecz.) dźwignia
heaviest : heaviest : (przym.) ciężki
heavily : heavily : (przysł.) ciężko | : (przysł.) mocno | : (przysł.) obficie | : (przysł.) ociężale
heaviness : heaviness : (rzecz.) ciężkość | : (rzecz.) ociężałość
heavy : heavy : (przym.) ciężarny | : (przym.) ciężki | : (przym.) dotkliwy | : (przym.) gruby | : (przym.) intensywny | : (przym.) mocny | : (przym.) obfity | : (przym.) silny | : (przym.) wielki
heavy-duty : heavy-duty : (przym.) wysokowydajny
heavy-handed : heavy-handed : (przym.) brutalny | : (przym.) niesprawiedliwy | : (przym.) nietaktowny | : (przym.) niezgrabny
heavy-walled : heavy-walled : (przym.) grubościenny
hecatomb : hecatomb : (rzecz.) hekatomba
heck : heck : (rzecz.) jaz | : (rzecz.) zapora | : (rzecz.) zastawa
heckle : heckle : (czas.) dręczyć | : (czas.) przeszkadzać
heckler : heckler : (rzecz.) krzykacz
hectare : hectare : (rzecz.) hektar
hectic : hectic : (przym.) gorączkowy | : (przym.) hektyczny | : (przym.) malaryczny | : (przym.) suchotniczy
hectograph : hectograph : (rzecz.) powielacz
hectolitre : hectolitre : (rzecz.) hektolitr
hector : hector : (czas.) awanturować | : (czas.) dokazywać | : (rzecz.) zawadiaka
heddle : heddle : (czas.) nawlekać
hedge : hedge : (rzecz.) ogrodzenie | : (rzecz.) szpaler | : (rzecz.) unik | : (rzecz.) zabezpieczenie | : (rzecz.) żywopłot
hedge-row : hedge-row : (rzecz.) żywopłot
hedgehog : hedgehog : (rzecz.) jeż
hedger : hedger : (rzecz.) osoba
hedgerow : hedgerow : (rzecz.) żywopłot
hedonism : hedonism : (rzecz.) hedonizm
hedonist : hedonist : (rzecz.) hedonista
hedonistic : hedonistic : (przym.) hedonistyczny
hee-haw : hee-haw : (czas.) ryczeć
heed : heed : (czas.) uważać | : (rzecz.) uwaga
heedful : heedful : (przym.) baczny | : (przym.) dbały | : (przym.) ostrożny | : (przym.) uważny
heedless : heedless : (przym.) lekkomyślny | : (przym.) niebaczny | : (przym.) niedbały | : (przym.) nieostrożny | : (przym.) nieuważny
heedlessly : heedlessly : (przysł.) niedbale
heedlessness : heedlessness : (rzecz.) nieostrożność
heel : heel : (rzecz.) napiętek | : (rzecz.) obcas | : (rzecz.) pięta | : (rzecz.) piętka | : (rzecz.) ścięgno
heel-tap : heel-tap : (rzecz.) flek
heeltap : heeltap : (rzecz.) flek
heft : heft : (rzecz.) waga
hefty : hefty : (przym.) masywny | : (przym.) mocny
hegemonic : hegemonic : (przym.) władczy
hegemony : hegemony : (rzecz.) hegemonia
heifer : heifer : (rzecz.) jałowica | : (rzecz.) jałówka
height : height : (rzecz.) apogeum | : (rzecz.) pagórek | : (rzecz.) rozkwit | : (rzecz.) szczyt | : (rzecz.) wyniosłość | : (rzecz.) wysokość | : (rzecz.) wzrost
heighten : heighten : (czas.) podnosić | : (czas.) podwyższać | : (czas.) potęgować | : (czas.) powiększać | : (czas.) rozdymać | : (czas.) spotęgować
heinous : heinous : (przym.) haniebny | : (przym.) nienawistny | : (przym.) obrzydliwy | : (przym.) ohydny | : (przym.) potworny
heinousness : heinousness : (rzecz.) ohyda
heir : heir : (rzecz.) dziedzic | : (rzecz.) następca | : (rzecz.) spadkobierca | : (rzecz.) sukcesor
heirloom : heirloom : (rzecz.) dziedzictwo | : (rzecz.) scheda | : (rzecz.) spadek
heist : heist : (rzecz.) kradzież | : (rzecz.) napad
heliacal : heliacal : (przym.) heliakalny
helianthus : helianthus : (rzecz.) słonecznik
helical : helical : (przym.) ślimakowaty | : (przym.) spiralny | : (przym.) śrubowaty | : (przym.) śrubowy
helicopter : helicopter : (rzecz.) helikopter | : (rzecz.) śmigłowiec
heliocentric : heliocentric : (przym.) heliocentryczny
heliodor : heliodor : (rzecz.) heliodor
heliograph : heliograph : (rzecz.) heliograf
heliographs : heliographs : (rzecz.) heliografia
heliography : heliography : (rzecz.) heliograwiura
heliotherapy : heliotherapy : (rzecz.) helioterapia
heliotrope : heliotrope : (rzecz.) heliotrop
heliotropism : heliotropism : (rzecz.) heliotropizm
heliotype : heliotype : (rzecz.) odbitka
helium : helium : (rzecz.) hel
helix : helix : (rzecz.) helisa | : (rzecz.) ślimacznica | : (rzecz.) ślimak
hell : hell : (rzecz.) piekło
hell-cat : hell-cat : (rzecz.) piekielnica
hellebore : hellebore : (rzecz.) ciemiernik
hellish : hellish : (przym.) cholerny | : (przym.) diabelski | : (przym.) piekielny | : (przym.) potępieńczy
helm : helm : (rzecz.) kierowanie | : (rzecz.) rumpel | : (rzecz.) ster | : (rzecz.) sterownica
helmet : helmet : (rzecz.) hełm | : (rzecz.) kask | : (rzecz.) szyszak
helmsman : helmsman : (rzecz.) sternik
helot : helot : (rzecz.) helota | : (rzecz.) niewolnik
helotism : helotism : (rzecz.) helotyzm
help : help : (czas.) częstować | : (czas.) dopomagać | : (czas.) poczęstować | : (czas.) pomagać | : (czas.) poradzić | : (czas.) ułatwić | : (czas.) wspomagać | : (czas.) wstrzymać | : (czas.) zaradzać | : (czas.) zaradzić | : (rzecz.) podpowiadanie | : (rzecz.) pomaganie | : (rzecz.) pomoc | : (rzecz.) pomóc | : (rzecz.) poratowanie | : (rzecz.) rada | : (rzecz.) ratunek | : (rzecz.) sukurs | : (rzecz.) współpracownik | : (rzecz.) wspomożenie
helper : helper : (rzecz.) pomagier | : (rzecz.) pomocnica | : (rzecz.) pomocnik
helpful : helpful : (przym.) pomocny | : (przym.) pożyteczny | : (przym.) uczynny | : (przym.) użyteczny
helpfully : helpfully : (przysł.) pomocnie | : (przysł.) uczynnie | : (przysł.) użytecznie
helpfulness : helpfulness : (rzecz.) przydatność | : (rzecz.) uczynność | : (rzecz.) użyteczność
helping : helping : (rzecz.) pomaganie | : (rzecz.) porcja
helpless : helpless : (przym.) bezbronny | : (przym.) bezradny | : (przym.) bezsilny | : (przym.) niezaradny
helplessly : helplessly : (przysł.) bezradnie
helplessness : helplessness : (rzecz.) bezradność
helpmate : helpmate : (rzecz.) towarzysz
helpmeet : helpmeet : (rzecz.) towarzysz
helter-skelter : helter-skelter : (rzecz.) bezład | : (rzecz.) zamęt | : (rzecz.) zjeżdżalnia
helve : helve : (rzecz.) trzonek
hem : hem : (czas.) oblamować | : (czas.) obrabiać | : (czas.) obrąbiać | : (czas.) obramować | : (czas.) obrębiać | : (czas.) obszyć | : (czas.) obszywać | : (czas.) pochrząkiwać | : (rzecz.) brzeg | : (rzecz.) oblamowanie | : (rzecz.) obrąbek | : (rzecz.) obszycie | : (rzecz.) obszywka | : (rzecz.) obwódka | : (rzecz.) odchrząknięcie | : (rzecz.) odkaszlnięcie | : (rzecz.) rąbek
hematite : hematite : (rzecz.) hematyt
hemisphere : hemisphere : (rzecz.) hemisfera | : (rzecz.) półkula
hemispheric : hemispheric : (przym.) półkulisty
hemispherical : hemispherical : (przym.) półkulisty
hemistich : hemistich : (rzecz.) półwiersz
hemlock : hemlock : (rzecz.) cykuta | : (rzecz.) pietrasznik | : (rzecz.) szalej
hemorrhagic : hemorrhagic : (przym.) krwotoczny
hemp : hemp : (rzecz.) juta | : (rzecz.) stryczek
hempen : hempen : (przym.) konopny
hemps : hemps : (rzecz.) konopie
hemstitch : hemstitch : (rzecz.) ażurek | : (rzecz.) mereżka
hen : hen : (rzecz.) kura
hen's : hen's : (przym.) kurzy
hen-harrier : hen-harrier : (rzecz.) błotniak
hence : hence : (przysł.) odtąd | : (przysł.) stąd
henceforth : henceforth : (przysł.) odtąd
henceforward : henceforward : (przysł.) odtąd
henchman : henchman : (rzecz.) giermek | : (rzecz.) stronnik
henna : henna : (rzecz.) henna
hens : hens : (rzecz.) kur
heparin : heparin : (rzecz.) heparyna
hepatic : hepatic : (przym.) wątrobowy
hepatitis : hepatitis : (rzecz.) żółtaczka
hepcat : hepcat : (rzecz.) znawca
heptagon : heptagon : (rzecz.) siedmiokąt
heptameter : heptameter : (rzecz.) heptametr
heptavalent : heptavalent : (przym.) siedmiowartościowy
heptode : heptode : (rzecz.) heptoda
herald : herald : (czas.) ogłosić | : (czas.) zwiastować | : (rzecz.) herold | : (rzecz.) zapowiedź | : (rzecz.) zwiastun
heraldic : heraldic : (przym.) heraldyczny | : (przym.) herbowy
heraldries : heraldries : (rzecz.) heraldyk
heraldry : heraldry : (rzecz.) heraldyka
herb : herb : (rzecz.) trójząb | : (rzecz.) ziele | : (rzecz.) zioło
herb-cultivation : herb-cultivation : (rzecz.) zielarstwo
herbaceous : herbaceous : (przym.) zielny | : (przym.) ziołowy
herbage : herbage : (rzecz.) trawa | : (rzecz.) trawy
herbal : herbal : (przym.) zielarski | : (przym.) zielny | : (przym.) ziołowy
herbalist : herbalist : (rzecz.) zielarz
herbarium : herbarium : (rzecz.) zielnik
herbicidal : herbicidal : (przym.) chwastobójczy | : (przym.) herbicydowy
herbicide : herbicide : (rzecz.) herbicyd
herbivore : herbivore : (rzecz.) trawojad
herbivorous : herbivorous : (przym.) roślinożerny | : (przym.) trawożerny
herd : herd : (czas.) jednoczyć | : (czas.) tłoczyć | : (rzecz.) sfora | : (rzecz.) stado | : (rzecz.) tabun | : (rzecz.) tłum | : (rzecz.) trzoda
herder : herder : (rzecz.) pasterz | : (rzecz.) pastuch
herdsman : herdsman : (rzecz.) pasterz | : (rzecz.) pastuch | : (rzecz.) poganiacz
here : here : (przysł.) tędy | : (przysł.) tu | : (przysł.) tutaj
hereabouts : hereabouts : (przysł.) blisko | : (przysł.) gdzieś
hereditable : hereditable : (przym.) dziedziczny
hereditary : hereditary : (przym.) dziedziczny
heredity : heredity : (rzecz.) dziedziczność
herein : herein : (przysł.) tu
heresy : heresy : (rzecz.) herezja | : (rzecz.) innowierstwo | : (rzecz.) kacerstwo
heretic : heretic : (rzecz.) heretyk | : (rzecz.) kacerz
heretical : heretical : (przym.) heretycki
heretofore : heretofore : (przysł.) dotychczas | : (przysł.) poprzednio
heritable : heritable : (przym.) dziedziczny
heritage : heritage : (rzecz.) dziedzictwo | : (rzecz.) scheda | : (rzecz.) spadek | : (rzecz.) spuścizna | : (rzecz.) szlak
heritor : heritor : (rzecz.) dziedzic
hermaphrodite : hermaphrodite : (przym.) obojnaczy | : (przym.) obupłciowy | : (rzecz.) hermafrodyta | : (rzecz.) obojnak
hermaphroditic : hermaphroditic : (przym.) obojnaczy | : (przym.) obupłciowy
hermaphroditical : hermaphroditical : (przym.) obojnaczy | : (rzecz.) obojnak
hermeneutic : hermeneutic : (przym.) hermeneutyczny
hermeneutical : hermeneutical : (przym.) hermeneutyczny
hermeneutics : hermeneutics : (rzecz.) hermeneutyka
hermetic : hermetic : (przym.) hermetyczny | : (przym.) szczelny
hermetical : hermetical : (przym.) hermetyczny | : (przym.) szczelny
hermetically : hermetically : (przysł.) hermetycznie
hermit : hermit : (rzecz.) anachoreta | : (rzecz.) pustelnik
hermitage : hermitage : (rzecz.) ermitaż | : (rzecz.) odosobnienie | : (rzecz.) pustelnia
hermitic : hermitic : (przym.) pustelniczy
hernia : hernia : (rzecz.) przepuklina | : (rzecz.) ruptura
hero : hero : (rzecz.) bohater | : (rzecz.) heros | : (rzecz.) idol
heroic : heroic : (przym.) bohaterski | : (przym.) heroiczny
heroically : heroically : (przysł.) bohatersko | : (przysł.) heroicznie
heroin : heroin : (rzecz.) heroina
heroine : heroine : (rzecz.) bohaterka | : (rzecz.) heroina
heroism : heroism : (rzecz.) bohaterstwo | : (rzecz.) heroiczność | : (rzecz.) heroizm
heron : heron : (rzecz.) czapla
herpes : herpes : (rzecz.) liszaj | : (rzecz.) opryszczka
herpetic : herpetic : (przym.) opryszczkowy
herpetological : herpetological : (przym.) herpetologiczny
herring : herring : (rzecz.) śledź
herring-bone : herring-bone : (rzecz.) jodełka
herringbone : herringbone : (rzecz.) jodełka
hertz : hertz : (rzecz.) herc
hesitance : hesitance : (rzecz.) niepewność | : (rzecz.) niezdecydowanie | : (rzecz.) wahanie
hesitancy : hesitancy : (rzecz.) niezdecydowanie | : (rzecz.) wahanie
hesitantly : hesitantly : (przysł.) niepewnie
hesitate : hesitate : (czas.) wahać | : (czas.) zawahać | : (czas.) zwlekać
hesitation : hesitation : (rzecz.) niepewność | : (rzecz.) niezdecydowanie | : (rzecz.) wahanie
heteroatom : heteroatom : (rzecz.) heteroatom
heterochromatin : heterochromatin : (rzecz.) heterochromatyna
heterochromosome : heterochromosome : (rzecz.) heterochromosom
heterocyclic : heterocyclic : (przym.) heterocykliczny
heterodox : heterodox : (przym.) heterodoksyjny | : (przym.) innowierczy
heterodoxy : heterodoxy : (rzecz.) heterodoksja | : (rzecz.) innowierstwo
heterodyne : heterodyne : (rzecz.) heterodyna
heterogeneity : heterogeneity : (rzecz.) niejednorodność | : (rzecz.) różnorodność
heterogeneous : heterogeneous : (przym.) heterogeniczny | : (przym.) niejednorodny | : (przym.) rozbieżny | : (przym.) różnogatunkowy | : (przym.) różnorodny
heterogeneously : heterogeneously : (przysł.) heterogenicznie
heterogenic : heterogenic : (przym.) heterogeniczny | : (przym.) niejednorodny
heteronymous : heteronymous : (przym.) różnoimienny
heterosexual : heterosexual : (przym.) heteroseksualny
heterotrophic : heterotrophic : (przym.) cudzożywny
heterotrophy : heterotrophy : (rzecz.) cudzożywność
heterozygote : heterozygote : (rzecz.) heterozygota
hetman : hetman : (przym.) hetmański | : (rzecz.) hetman
heuristic : heuristic : (przym.) heurystyczny
heuristically : heuristically : (przysł.) heurystycznie
heuristics : heuristics : (rzecz.) heurystyka
hew : hew : (czas.) ciosać | : (czas.) kuć | : (czas.) ociosać | : (czas.) porąbać | : (czas.) rąbać | : (czas.) wkuć | : (czas.) wrębiać
hex : hex : (rzecz.) czar | : (rzecz.) urok
hexadecane : hexadecane : (rzecz.) cetan
hexadecimal : hexadecimal : (przym.) heksadecymalny | : (przym.) szesnastkowy
hexadecimal-to-binary : hexadecimal-to-binary : (przym.) heksadecymalno-binarny | : (przym.) szesnastkowo-dwójkowy
hexadecimal-to-decimal : hexadecimal-to-decimal : (przym.) szesnastkowo-dziesiętny
hexagon : hexagon : (rzecz.) heksagon | : (rzecz.) sześciobok | : (rzecz.) sześciokąt
hexagonal : hexagonal : (przym.) heksagonalny | : (przym.) sześciokątny
hexagons : hexagons : (rzecz.) sześciokąt
hexahedron : hexahedron : (rzecz.) sześcian | : (rzecz.) sześciobok
hexameter : hexameter : (rzecz.) heksametr
hexamethylenetetramine : hexamethylenetetramine : (rzecz.) urotropina
hexametrical : hexametrical : (przym.) heksametryczny
hexane : hexane : (rzecz.) heksan
hexode : hexode : (rzecz.) heksoda
hexogen : hexogen : (rzecz.) heksogen
hey : hey : (wykrzyknik) hej
heyday : heyday : (rzecz.) szczyt | : (rzecz.) zenit
hi : hi : (wykrzyknik) hej | : (wykrzyknik) serwus
hiatus : hiatus : (rzecz.) luka | : (rzecz.) przerwa | : (rzecz.) rozziew
hibernate : hibernate : (czas.) przezimować | : (czas.) zimować
hibernation : hibernation : (rzecz.) hibernacja | : (rzecz.) uśpienie
hiccough : hiccough : (czas.) czkać | : (rzecz.) czkawka
hiccup : hiccup : (czas.) czkać | : (rzecz.) czkawka
hick : hick : (rzecz.) prostak | : (rzecz.) wieśniak
hickory : hickory : (rzecz.) hikora | : (rzecz.) orzesznik
hid : hid : (czas.) ukrywać
hidden : hidden : (czas.) ukrywać
hide : hide : (czas.) chować | : (czas.) kryć | : (czas.) schować | : (czas.) skryć | : (czas.) taić | : (czas.) ukryć | : (czas.) ukrywać | : (czas.) zaczaić | : (czas.) zamelinować | : (czas.) zasłaniać | : (czas.) zataić | : (rzecz.) skóra | : (rzecz.) ukrycie | : (rzecz.) ukrywanie
hide-out : hide-out : (rzecz.) kryjówka
hideaway : hideaway : (rzecz.) kryjówka
hideous : hideous : (przym.) ohydny | : (przym.) pokraczny | : (przym.) straszny | : (przym.) szkaradny | : (przym.) wstrętny
hideously : hideously : (przysł.) brzydko | : (przysł.) ohydnie
hideousness : hideousness : (rzecz.) brzydota | : (rzecz.) okropność | : (rzecz.) szkaradność
hideout : hideout : (rzecz.) kryjówka
hiding : hiding : (rzecz.) pochowanie | : (rzecz.) schowanie | : (rzecz.) ukrywanie
hiding-place : hiding-place : (rzecz.) kryjówka | : (rzecz.) schowek | : (rzecz.) ukrycie
hierarch : hierarch : (rzecz.) hierarcha
hierarchic : hierarchic : (przym.) hierarchiczny
hierarchical : hierarchical : (przym.) hierarchiczny
hierarchically : hierarchically : (przysł.) hierarchicznie
hierarchy : hierarchy : (rzecz.) hierarchia | : (rzecz.) władza
hieratic : hieratic : (przym.) hieratyczny | : (przym.) kapłański
hieratical : hieratical : (przym.) hieratyczny | : (przym.) kapłański
hieroglyph : hieroglyph : (rzecz.) hieroglif
hieroglyphic : hieroglyphic : (przym.) hieroglificzny | : (rzecz.) hieroglif
higgledy-piggledy : higgledy-piggledy : (przym.) bezładny | : (przysł.) bezładnie | : (przysł.) bezwładnie
high : high : (przym.) dumny | : (przym.) główny | : (przym.) silny | : (przym.) światowy | : (przym.) wielki | : (przym.) wybitny | : (przym.) wysoki | : (przym.) żywy | : (przysł.) mocno | : (przysł.) wysoko
high-availability : high-availability : (rzecz.) dyspozycyjność
high-boiling : high-boiling : (przym.) wysokowrzący
high-class : high-class : (przym.) ekskluzywny | : (przym.) pierwszorzędny
high-duty : high-duty : (przym.) wysokosprawny | : (przym.) wysokowydajny
high-efficiency : high-efficiency : (przym.) wysokowydajny
high-flown : high-flown : (przym.) górnolotny
high-grade : high-grade : (przym.) wysokogatunkowy | : (przym.) wysokojakościowy | : (przym.) wysokoprocentowy | : (przym.) wysokowartościowy
high-handed : high-handed : (przym.) arbitralny | : (przym.) despotyczny | : (przym.) władczy
high-level : high-level : (przym.) ogólny
high-melting : high-melting : (przym.) trudnotopliwy | : (przym.) wysokotopliwy
high-minded : high-minded : (przym.) szlachetny
high-octane : high-octane : (przym.) wysokooktanowy
high-performance : high-performance : (przym.) wysokosprawny
high-pitched : high-pitched : (przym.) wysoki
high-pressure : high-pressure : (przym.) wysokociśnieniowy
high-principled : high-principled : (przym.) honorowy
high-quality : high-quality : (przym.) wysokogatunkowy
high-rise : high-rise : (przym.) wielopoziomowy | : (przym.) wysokościowy | : (rzecz.) wieżowiec | : (rzecz.) wysokościowiec
high-sounding : high-sounding : (przym.) szumny
high-speed : high-speed : (przym.) szybkobieżny | : (przym.) szybkościowy | : (przym.) wysokoobrotowy
high-spirited : high-spirited : (przym.) żwawy | : (przym.) żywy
high-strung : high-strung : (przym.) wrażliwy
high-temperature : high-temperature : (przym.) wysokotemperaturowy
high-up : high-up : (rzecz.) osobistość
high-wrought : high-wrought : (przym.) ozdobny | : (przysł.) gwałtownie
highbrow : highbrow : (rzecz.) intelektualista | : (rzecz.) inteligent
higher : higher : (przym.) ponadpodstawowy
highest : highest : (przym.) główny
highfaluting : highfaluting : (przym.) górnolotny
highhanded : highhanded : (przym.) arbitralny | : (przym.) despotyczny | : (przym.) władczy
highjack : highjack : (rzecz.) porwanie
highland : highland : (rzecz.) podgórze | : (rzecz.) średniogórze | : (rzecz.) wyżyna | : (rzecz.) wzgórze
highlander : highlander : (rzecz.) góral
highlander's : highlander's : (przym.) góralski
highlands : highlands : (rzecz.) pogórze | : (rzecz.) wyżyna
highlight : highlight : (czas.) naświetlić | : (czas.) podkreślać | : (czas.) podkreślić | : (czas.) podświetlać | : (czas.) podświetlić | : (czas.) unaocznić | : (czas.) uwydatniać | : (czas.) uwydatnić | : (czas.) uwypuklać | : (czas.) uwypuklić | : (czas.) wyodrębniać | : (czas.) wyodrębnić | : (czas.) wyróżnić
highly : highly : (przysł.) dumnie | : (przysł.) wielce | : (przysł.) wysoce | : (przysł.) wysoko
highness : highness : (rzecz.) siła | : (rzecz.) szlachetność | : (rzecz.) wysokość | : (rzecz.) wzniosłość
highroad : highroad : (rzecz.) gościniec | : (rzecz.) szosa
highway : highway : (rzecz.) autostrada | : (rzecz.) droga | : (rzecz.) gościniec | : (rzecz.) magistrala | : (rzecz.) szosa
highwayman : highwayman : (rzecz.) rozbójnik
hijack : hijack : (czas.) porwać | : (czas.) porywać | : (rzecz.) porwanie
hijacked : hijacked : (czas.) porywać
hijacker : hijacker : (rzecz.) porywacz
hijacking : hijacking : (rzecz.) porwanie | : (rzecz.) porywanie | : (rzecz.) uprowadzenie
hike : hike : (czas.) chodzić | : (czas.) wędrować | : (czas.) windować | : (rzecz.) wędrówka
hiker : hiker : (rzecz.) piechur | : (rzecz.) turysta | : (rzecz.) wycieczkowicz
hilarious : hilarious : (przym.) komiczny | : (przym.) wesoły | : (przym.) zabawny
hilarity : hilarity : (rzecz.) wesołość
hill : hill : (rzecz.) górka | : (rzecz.) kopcenie | : (rzecz.) pagórek | : (rzecz.) wzgórze | : (rzecz.) wzniesienie
hill-side : hill-side : (rzecz.) stok
hilliness : hilliness : (rzecz.) pagórkowatość
hillock : hillock : (rzecz.) górka | : (rzecz.) kopczyk | : (rzecz.) pagórek | : (rzecz.) wzgórek
hillside : hillside : (rzecz.) stok | : (rzecz.) zbocze
hilltop : hilltop : (rzecz.) szczyt
hilly : hilly : (przym.) górzysty | : (przym.) pagórkowaty | : (przym.) stromy
hilt : hilt : (rzecz.) rękojeść
hind : hind : (przym.) tylni | : (przym.) tylny | : (rzecz.) łania | : (rzecz.) parobek | : (rzecz.) udziec
hinder : hinder : (czas.) powstrzymywać | : (czas.) przeszkadzać
hindmost : hindmost : (przym.) ostatni
hindquarters : hindquarters : (rzecz.) zad
hindrance : hindrance : (rzecz.) przeszkadzanie | : (rzecz.) przeszkoda | : (rzecz.) utrudnianie | : (rzecz.) utrudnienie | : (rzecz.) zawada
hinge : hinge : (czas.) obracać | : (czas.) zależeć | : (rzecz.) zawias | : (rzecz.) zawiasa
hint : hint : (czas.) insynuować | : (czas.) nadmieniać | : (czas.) napomykać | : (czas.) przebąkiwać | : (czas.) sugerować | : (rzecz.) aluzja | : (rzecz.) domyślnik | : (rzecz.) napomknięcie | : (rzecz.) napomknienie | : (rzecz.) niedomówienie | : (rzecz.) podpowiedź | : (rzecz.) półsłówko | : (rzecz.) pomoc | : (rzecz.) przycinek | : (rzecz.) przymówka | : (rzecz.) rada | : (rzecz.) ślad | : (rzecz.) sugestia | : (rzecz.) wskazówka
hinterland : hinterland : (rzecz.) zaplecze
hints : hints : (rzecz.) prowadnica
hip : hip : (przym.) biodrowy | : (rzecz.) biodro
hip-bath : hip-bath : (rzecz.) nasiadówka
hip-flask : hip-flask : (rzecz.) piersiówka
hipbath : hipbath : (rzecz.) nasiadówka
hippie : hippie : (rzecz.) hipis | : (rzecz.) hippis
hippo : hippo : (rzecz.) hipopotam
hippodrome : hippodrome : (rzecz.) hipodrom
hippopotamus : hippopotamus : (rzecz.) hipopotam
hippy : hippy : (rzecz.) hipis | : (rzecz.) hippis
hircine : hircine : (przym.) kozi
hire : hire : (czas.) angażować | : (czas.) godzić | : (czas.) najmować | : (czas.) wynajmować | : (czas.) zatrudniać | : (czas.) zatrudnić | : (rzecz.) dzierżawa | : (rzecz.) najem | : (rzecz.) wynajęcie | : (rzecz.) wynajem
hireling : hireling : (rzecz.) najemnik | : (rzecz.) najmita
hirer : hirer : (rzecz.) najemca
hirsute : hirsute : (przym.) kosmaty | : (przym.) kudłaty | : (przym.) włochaty
hispid : hispid : (przym.) kolczasty | : (przym.) kosmaty | : (przym.) szczeciniasty
hiss : hiss : (czas.) bzykać | : (czas.) syczeć | : (rzecz.) poszum | : (rzecz.) syczenie | : (rzecz.) syk
hisses : hisses : (rzecz.) wygwizdanie
histamine : histamine : (rzecz.) histamina
histogram : histogram : (rzecz.) histogram | : (rzecz.) wykres
histological : histological : (przym.) histologiczny
histologist : histologist : (rzecz.) histolog
histology : histology : (rzecz.) histologia
histopathology : histopathology : (rzecz.) histopatologia
historian : historian : (rzecz.) dziejopis | : (rzecz.) dziejopisarz | : (rzecz.) historyk
historic : historic : (przym.) dziejowy | : (przym.) historyczny | : (przym.) zabytkowy
historical : historical : (przym.) dziejowy | : (przym.) historyczny
historically : historically : (przysł.) historycznie
historicism : historicism : (rzecz.) historyzm
historicity : historicity : (rzecz.) historyczność
historiographer : historiographer : (rzecz.) dziejopis | : (rzecz.) historiograf
historiography : historiography : (rzecz.) dziejopisarstwo | : (rzecz.) historiografia
history : history : (rzecz.) dzieje | : (rzecz.) historia
histrionic : histrionic : (przym.) dramatyczny | : (przym.) sceniczny | : (przym.) teatralny
histrionics : histrionics : (rzecz.) aktorstwo
hit : hit : (czas.) trafiać | : (czas.) trafić | : (czas.) trzaskać | : (czas.) uderzać | : (czas.) uderzyć | : (rzecz.) cios | : (rzecz.) nagranie | : (rzecz.) piosenka | : (rzecz.) przebój | : (rzecz.) szlagier | : (rzecz.) trafienie | : (rzecz.) uderzenie
hitch : hitch : (czas.) kuśtykać | : (czas.) odciągać | : (czas.) pociągnąć | : (czas.) podnosić | : (czas.) popychać | : (czas.) posuwać | : (czas.) przyczepiać | : (czas.) przyczepić | : (czas.) szarpnąć | : (czas.) uczepić | : (czas.) umocować | : (czas.) umocowywać | : (czas.) zaczepiać | : (rzecz.) szarpnięcie | : (rzecz.) szkopuł | : (rzecz.) uczep | : (rzecz.) zatrzymanie
hitch-hiker : hitch-hiker : (rzecz.) autostopowicz
hitch-hiking : hitch-hiking : (rzecz.) autostop
hitchhiker : hitchhiker : (rzecz.) autostopowicz
hither : hither : (przysł.) tu
hitherto : hitherto : (przysł.) dotąd | : (przysł.) dotychczas
hitter : hitter : (rzecz.) zastępca | : (rzecz.) zastępstwo
hive : hive : (czas.) gromadzić | : (czas.) roić | : (rzecz.) ul
hl : hl : (rzecz.) hektolitr
hoar : hoar : (przym.) siwy
hoar-frost : hoar-frost : (rzecz.) szron
hoard : hoard : (czas.) chować | : (czas.) ciułać | : (czas.) gromadzić | : (czas.) zbierać | : (rzecz.) skarb | : (rzecz.) zapas | : (rzecz.) zasób
hoarding : hoarding : (rzecz.) ciułanie | : (rzecz.) oszalowanie | : (rzecz.) parkan
hoarfrost : hoarfrost : (rzecz.) szron
hoarse : hoarse : (przym.) chrapliwy | : (przym.) chrypliwy | : (przym.) ochrypły | : (przym.) zachrypły
hoarsely : hoarsely : (przysł.) chrapliwie
hoarsen : hoarsen : (czas.) zachrypieć
hoarseness : hoarseness : (rzecz.) chrypa | : (rzecz.) chrypka | : (rzecz.) szorstkość
hoary : hoary : (przym.) siwy
hoax : hoax : (czas.) nabierać | : (rzecz.) kaczka | : (rzecz.) mistyfikacja | : (rzecz.) żart
hob : hob : (rzecz.) ćwiek | : (rzecz.) figiel | : (rzecz.) kołek
hobble : hobble : (czas.) chromać | : (czas.) kulawieć | : (czas.) kuleć | : (czas.) pętać | : (czas.) utykać | : (rzecz.) chromanie | : (rzecz.) kulawka | : (rzecz.) utykanie
hobbledehoy : hobbledehoy : (rzecz.) chłystek | : (rzecz.) ciamajda | : (rzecz.) młokos
hobby : hobby : (rzecz.) hobby | : (rzecz.) konik | : (rzecz.) pasja | : (rzecz.) zainteresowanie
hobbyhorse : hobbyhorse : (rzecz.) konik
hobbyist : hobbyist : (rzecz.) hobbista
hobgoblin : hobgoblin : (rzecz.) skrzat | : (rzecz.) straszak
hobnail : hobnail : (rzecz.) ćwiek | : (rzecz.) gwóźdź | : (rzecz.) podkowiak
hobnob : hobnob : (czas.) poufalić | : (czas.) zadać | : (czas.) zadawać
hobo : hobo : (rzecz.) menel | : (rzecz.) włóczęga
hock : hock : (czas.) zastawiać | : (rzecz.) golonka | : (rzecz.) pęcina | : (rzecz.) zastaw
hockey : hockey : (rzecz.) hokej
hockshop : hockshop : (rzecz.) lombard
hocus-pocus : hocus-pocus : (rzecz.) matactwo
hodgepodge : hodgepodge : (rzecz.) mieszanina
hodograph : hodograph : (rzecz.) hodograf
hoe : hoe : (czas.) gracować | : (czas.) radlić | : (czas.) spulchniać | : (czas.) spulchnić | : (rzecz.) graca | : (rzecz.) kilof | : (rzecz.) motyka
hog : hog : (czas.) przegiąć | : (czas.) spaczyć | : (rzecz.) knur | : (rzecz.) świnia | : (rzecz.) tucznik | : (rzecz.) wieprz
hogs : hogs : (rzecz.) nierogacizna
hoist : hoist : (czas.) dźwigać | : (czas.) podnieść | : (czas.) podnosić | : (czas.) unosić | : (czas.) wciągać | : (czas.) windować | : (czas.) wyciągać | : (czas.) wywiesić | : (rzecz.) dźwig | : (rzecz.) lewar | : (rzecz.) linociąg | : (rzecz.) skrót | : (rzecz.) winda | : (rzecz.) wyciąg | : (rzecz.) wyciągarka
hoister : hoister : (rzecz.) elewator | : (rzecz.) sztaplarka
hokum : hokum : (rzecz.) banał
hold : hold : (rzecz.) uchwyt | : (czas.) chwytać | : (czas.) czekać | : (czas.) dzierżyć | : (czas.) mieścić | : (czas.) nadstawiać | : (czas.) obchodzić | : (czas.) odbywać | : (czas.) piastować | : (czas.) pomieścić | : (czas.) posiadać | : (czas.) postanawiać | : (czas.) przetrzymywać | : (czas.) przytrzymać | : (czas.) ściskać | : (czas.) trzymać | : (czas.) zaczekać | : (czas.) zawierać | : (czas.) zgotować | : (rzecz.) chwyt | : (rzecz.) ładownia | : (rzecz.) przytrzymanie | : (rzecz.) trzymanie
hold-up : hold-up : (rzecz.) napad | : (rzecz.) zdzierstwo
holdall : holdall : (rzecz.) torba
holder : holder : (rzecz.) klaser | : (rzecz.) okaziciel | : (rzecz.) oprawka | : (rzecz.) posiadacz | : (rzecz.) trzymacz | : (rzecz.) uchwyt | : (rzecz.) właściciel
holdfast : holdfast : (rzecz.) docisk
holding : holding : (rzecz.) dzierżawa | : (rzecz.) posiadanie | : (rzecz.) sprawowanie | : (rzecz.) trzymanie | : (rzecz.) władanie | : (rzecz.) wytrzymywanie | : (rzecz.) zapas
holdover : holdover : (rzecz.) przeżytek
hole : hole : (czas.) przekopać | : (czas.) uszczuplać | : (rzecz.) dołek | : (rzecz.) dziura | : (rzecz.) dziurka | : (rzecz.) jama | : (rzecz.) nora | : (rzecz.) otwór | : (rzecz.) włom
hole-and-corner : hole-and-corner : (przym.) potajemny
hole-saw : hole-saw : (rzecz.) sękarka
hole-through : hole-through : (rzecz.) przebicie | : (rzecz.) przecinka | : (rzecz.) wrębienie
holey : holey : (przym.) dziurawy
holiday : holiday : (rzecz.) ferie | : (rzecz.) święto | : (rzecz.) wakacje | : (rzecz.) wczasy
holiday-maker : holiday-maker : (rzecz.) letnik | : (rzecz.) urlopowicz | : (rzecz.) wczasowicz
holidaymaker : holidaymaker : (rzecz.) letnik | : (rzecz.) turysta | : (rzecz.) urlopowicz | : (rzecz.) wczasowicz
holidaymakers : holidaymakers : (rzecz.) wczasowicz
holidays : holidays : (rzecz.) urlop | : (rzecz.) wakacje | : (rzecz.) wczasy
holiness : holiness : (rzecz.) świątobliwość | : (rzecz.) świętość
holism : holism : (rzecz.) holizm
holistic : holistic : (przym.) holistyczny | : (przym.) odświętny
holler : holler : (czas.) ryczeć | : (czas.) wrzeszczeć | : (czas.) wykrzykiwać
hollering : hollering : (rzecz.) wrzask
hollow : hollow : (czas.) wydrążyć | : (przym.) dziurawy | : (przym.) próżny | : (przym.) pusty | : (rzecz.) dół | : (rzecz.) dziupla | : (rzecz.) dziura | : (rzecz.) dźwięk | : (rzecz.) jama | : (rzecz.) kotlina | : (rzecz.) próżnia | : (rzecz.) wgłębienie | : (rzecz.) wydrążenie | : (rzecz.) zagłębienie | : (rzecz.) zapadlisko
holly : holly : (rzecz.) ostrokrzew
hollyhock : hollyhock : (rzecz.) malwa
holmium : holmium : (rzecz.) holm
holocaust : holocaust : (rzecz.) całopalenie | : (rzecz.) holokaust | : (rzecz.) zagłada
hologram : hologram : (rzecz.) hologram
holograms : holograms : (rzecz.) hologram
holograph : holograph : (rzecz.) holograf
holographic : holographic : (przym.) holograficzny
holography : holography : (rzecz.) holografia
holster : holster : (rzecz.) futerał | : (rzecz.) kabura | : (rzecz.) olstro
holt : holt : (rzecz.) gaj
holy : holy : (przym.) religijny | : (przym.) świątobliwy | : (przym.) święty
homage : homage : (rzecz.) hołd
home : home : (przym.) domatorski | : (przym.) domowy | : (przym.) krajowy | : (przym.) ojczyźniany | : (przym.) rodzimy | : (przysł.) domowo | : (rzecz.) dom | : (rzecz.) domatorstwo | : (rzecz.) kolebka | : (rzecz.) mieszkanie | : (rzecz.) ojczyzna | : (rzecz.) sadyba
home-brew : home-brew : (rzecz.) podpiwek
home-made : home-made : (przym.) domowy
homeland : homeland : (rzecz.) macierz | : (rzecz.) ojczyzna
homeless : homeless : (przym.) bezdomny | : (przym.) tułaczy
homelessness : homelessness : (rzecz.) bezdomność
homelike : homelike : (przym.) domowy | : (przym.) miły | : (przym.) przytulny
homely : homely : (przym.) brzydki | : (przym.) domowy | : (przym.) prosty | : (przym.) przytulny | : (przym.) swojski
homemade : homemade : (przym.) domowy | : (przym.) krajowy | : (przym.) swojski
homeomorphism : homeomorphism : (rzecz.) homeomorfizm
homeopath : homeopath : (rzecz.) homeopata
homeopathic : homeopathic : (przym.) homeopatyczny
homeopathy : homeopathy : (rzecz.) homeopatia
homeowner : homeowner : (rzecz.) właściciel
homepage : homepage : (rzecz.) witryna
homesick : homesick : (przym.) nostalgiczny
homesickness : homesickness : (rzecz.) tęsknota
homespun : homespun : (przym.) bezpośredni | : (przym.) prosty | : (przym.) samodziałowy | : (rzecz.) samodział
homestead : homestead : (rzecz.) domostwo | : (rzecz.) farma | : (rzecz.) gospodarstwo
homesteader : homesteader : (rzecz.) osadnik
homeward : homeward : (przym.) powrotny
homework : homework : (rzecz.) chałupnictwo | : (rzecz.) zadanie
homey : homey : (przym.) domowy
homicidal : homicidal : (przym.) morderczy
homicide : homicide : (rzecz.) morderca | : (rzecz.) morderczyni | : (rzecz.) zabójca | : (rzecz.) zabójstwo
homiletic : homiletic : (przym.) homiletyczny | : (przym.) kaznodziejski
homily : homily : (rzecz.) homilia | : (rzecz.) kazanie
hominid : hominid : (rzecz.) małpolud
hominy : hominy : (rzecz.) mamałyga
homocentric : homocentric : (przym.) współśrodkowy
homoeopath : homoeopath : (rzecz.) homeopata
homoeopathic : homoeopathic : (przym.) homeopatyczny
homoeopathy : homoeopathy : (rzecz.) homeopatia
homogeneity : homogeneity : (rzecz.) homogeniczność | : (rzecz.) jednorodność
homogeneous : homogeneous : (przym.) homogeniczny | : (przym.) jednolity
homogeneously : homogeneously : (przysł.) homogenicznie | : (przysł.) jednorodnie
homogenisation : homogenisation : (rzecz.) homogenizacja | : (rzecz.) ujednorodnienie
homogeniser : homogeniser : (rzecz.) homogenizator
homogenization : homogenization : (rzecz.) homogenizacja
homogenize : homogenize : (czas.) homogenizować
homogenizer : homogenizer : (rzecz.) homogenizator
homogenizing : homogenizing : (rzecz.) homogenizacja | : (rzecz.) ujednorodnianie
homogenous : homogenous : (przym.) homogeniczny | : (przym.) jednolity
homographic : homographic : (przym.) homograficzny
homologation : homologation : (rzecz.) homologacja
homologous : homologous : (przym.) homologiczny | : (przym.) odpowiedni | : (przym.) pokrewny
homologue : homologue : (rzecz.) homolog
homologues : homologues : (rzecz.) homologia
homology : homology : (rzecz.) homologia
homomorphism : homomorphism : (rzecz.) homomorfizm
homonym : homonym : (rzecz.) homonim
homonymic : homonymic : (przym.) homonimiczny
homonymous : homonymous : (przym.) homonimiczny
homonymy : homonymy : (rzecz.) homonimia
homophobia : homophobia : (rzecz.) homofonia
homophone : homophone : (rzecz.) homofon
homophonous : homophonous : (przym.) homofoniczny
homophony : homophony : (rzecz.) homofonia
homosexual : homosexual : (przym.) homoseksualny | : (rzecz.) homoseksualista | : (rzecz.) lesbijka | : (rzecz.) pederasta
homosexuality : homosexuality : (rzecz.) homoseksualizm
homozygote : homozygote : (rzecz.) homozygota
homozygous : homozygous : (przym.) homozygotyczny
homunculus : homunculus : (rzecz.) plemnik
hone : hone : (czas.) ostrzyć | : (rzecz.) brus | : (rzecz.) osełka
honest : honest : (przym.) poczciwy | : (przym.) prawy | : (przym.) rzetelny | : (przym.) szczery | : (przym.) uczciwy
honestly : honestly : (przysł.) szczerze | : (przysł.) uczciwie
honesty : honesty : (rzecz.) miesiącznica | : (rzecz.) porządność | : (rzecz.) prawość | : (rzecz.) szczerość | : (rzecz.) uczciwość
honey : honey : (rzecz.) kochanie | : (rzecz.) miód | : (rzecz.) miodek | : (rzecz.) złotko
honey-buzzard : honey-buzzard : (rzecz.) pszczołojad
honey-tongued : honey-tongued : (przym.) miodousty
honeybee : honeybee : (rzecz.) pszczoła
honeycomb : honeycomb : (rzecz.) bąbel
honeydew : honeydew : (rzecz.) spadź
honeyed : honeyed : (przym.) miodopłynny | : (przym.) słodki
honeysuckle : honeysuckle : (rzecz.) wiciokrzew
honk : honk : (czas.) krzyczeć | : (czas.) trąbić | : (rzecz.) klakson | : (rzecz.) krzyk
honky-tonk : honky-tonk : (rzecz.) mordownia
honorary : honorary : (przym.) bezpłatny | : (przym.) honorowy
honorific : honorific : (przym.) zaszczytny
honour : honour : (czas.) honorować | : (czas.) poważać | : (czas.) zaszczycać | : (rzecz.) cześć | : (rzecz.) honor | : (rzecz.) zaszczyt
honourable : honourable : (przym.) czcigodny | : (przym.) honorowy | : (przym.) prawy | : (przym.) szanowny | : (przym.) uczciwy | : (przym.) zaszczytny
hooch : hooch : (rzecz.) bimber | : (rzecz.) gorzała | : (rzecz.) samogon
hood : hood : (czas.) okapturzyć | : (rzecz.) kapiszon | : (rzecz.) kaptur | : (rzecz.) kapturek | : (rzecz.) kapuza | : (rzecz.) maska | : (rzecz.) okap
hoodlum : hoodlum : (rzecz.) bandzior | : (rzecz.) chuligan
hoodwink : hoodwink : (czas.) oszukać | : (czas.) ukrywać | : (czas.) zmylać | : (czas.) zmylić
hooey : hooey : (rzecz.) bzdura
hoof : hoof : (rzecz.) kopytko | : (rzecz.) kopyto | : (rzecz.) racica
hook : hook : (czas.) krzywić | : (czas.) podpiąć | : (czas.) przyczepiać | : (czas.) skrzywić | : (czas.) zaczepiać | : (czas.) zaczepić | : (czas.) zagiąć | : (czas.) zahaczać | : (czas.) zahaczyć | : (rzecz.) haczyk | : (rzecz.) hak | : (rzecz.) ogonek | : (rzecz.) zagięcie
hookah : hookah : (rzecz.) nargile
hooked : hooked : (przym.) garbaty | : (przym.) haczykowaty | : (przym.) hakowaty | : (przym.) zahaczony
hooker : hooker : (rzecz.) dziwka | : (rzecz.) prostytutka
hookworm : hookworm : (rzecz.) tęgoryjec
hooligan : hooligan : (rzecz.) chuligan | : (rzecz.) łobuz
hooliganism : hooliganism : (rzecz.) chuligaństwo | : (rzecz.) rozrabiactwo
hoop : hoop : (czas.) obrębiać | : (czas.) obrębić
hoop-la : hoop-la : (rzecz.) rozgardiasz
hoopla : hoopla : (rzecz.) rozgardiasz
hoopoe : hoopoe : (rzecz.) dudek | : (rzecz.) dudka
hoopoes : hoopoes : (rzecz.) dudki
hooray : hooray : (wykrzyknik) hura | : (wykrzyknik) hurra
hoot : hoot : (czas.) gwizdać | : (czas.) huczeć | : (czas.) hukać | : (czas.) krzyczeć | : (czas.) szydzić | : (czas.) wyć | : (czas.) zawyć | : (rzecz.) gwizd | : (rzecz.) hukanie
hooves : hooves : (rzecz.) kopyta
hop : hop : (czas.) podskakiwać | : (czas.) skakać | : (rzecz.) chmiel | : (rzecz.) podskok | : (rzecz.) przeskok | : (rzecz.) skok | : (rzecz.) taniec
hope : hope : (czas.) spodziewać | : (rzecz.) nadzieja
hopeful : hopeful : (przym.) optymistyczny
hopefulness : hopefulness : (rzecz.) nadzieja | : (rzecz.) optymizm
hopeless : hopeless : (przym.) beznadziejny | : (przym.) rozpaczliwy
hopelessly : hopelessly : (przysł.) beznadziejnie
hopelessness : hopelessness : (rzecz.) beznadziejność | : (rzecz.) desperacja | : (rzecz.) rozpaczliwość
hophead : hophead : (rzecz.) narkoman
hopper : hopper : (rzecz.) leja | : (rzecz.) pchła | : (rzecz.) skoczek | : (rzecz.) zbiornik | : (rzecz.) zsyp
horde : horde : (rzecz.) chmara | : (rzecz.) gromada | : (rzecz.) horda | : (rzecz.) orda | : (rzecz.) tabun
horizon : horizon : (rzecz.) horyzont | : (rzecz.) nieboskłon | : (rzecz.) poziom | : (rzecz.) widnokrąg
horizontal : horizontal : (przym.) horyzontalny | : (przym.) międzybranżowy | : (przym.) poziomy | : (przym.) ułamkowy
horizontally : horizontally : (przysł.) horyzontalnie | : (przysł.) poziomo
hormonal : hormonal : (przym.) hormonalny
hormone : hormone : (rzecz.) hormon
horn : horn : (rzecz.) czułek | : (rzecz.) klakson | : (rzecz.) róg | : (rzecz.) rożek | : (rzecz.) syrena | : (rzecz.) trąba | : (rzecz.) tuba
horn-rimmed : horn-rimmed : (przym.) rogowy
hornbeam : hornbeam : (rzecz.) grab | : (rzecz.) grabie
hornblende : hornblende : (rzecz.) amfibol | : (rzecz.) hornblenda
horned : horned : (przym.) rogaty
hornet : hornet : (rzecz.) szerszeń
horniness : horniness : (rzecz.) zrogowacenie
hornless : hornless : (przym.) bezrogi
hornstone : hornstone : (rzecz.) rogowiec
horny : horny : (przym.) ostry | : (przym.) rogowaty | : (przym.) rogowy | : (przym.) zrogowaciały
horologe : horologe : (rzecz.) czasomierz | : (rzecz.) zegar
horologer : horologer : (rzecz.) zegarmistrz
horology : horology : (rzecz.) zegarmistrzostwo
horoscope : horoscope : (rzecz.) horoskop
horrendous : horrendous : (przym.) horrendalny | : (przym.) niezmierny | : (przym.) straszliwy
horrendously : horrendously : (przysł.) horrendalnie
horrible : horrible : (przym.) horrendalny | : (przym.) okropny | : (przym.) potworny | : (przym.) straszny | : (przym.) zły
horribly : horribly : (przysł.) haniebnie | : (przysł.) potwornie | : (przysł.) strasznie
horrid : horrid : (przym.) nieznośny | : (przym.) odrażający | : (przym.) okropny | : (przym.) paskudny | : (przym.) straszny
horridly : horridly : (przysł.) nieznośnie | : (przysł.) strasznie
horrific : horrific : (przym.) okropny | : (przym.) przerażający | : (przym.) straszliwy
horrify : horrify : (czas.) przerażać | : (czas.) przerazić | : (czas.) szokować
horror : horror : (rzecz.) makabra | : (rzecz.) okropność | : (rzecz.) przerażenie | : (rzecz.) zgroza
hors : hors : (rzecz.) przekąska | : (rzecz.) zakąska
horse : horse : (rzecz.) jazda | : (rzecz.) kawaleria | : (rzecz.) koń | : (rzecz.) konik | : (rzecz.) konina | : (rzecz.) trzepak
horse-breaker : horse-breaker : (rzecz.) ujeżdżacz
horse-chestnut : horse-chestnut : (rzecz.) kasztanowiec
horse-collar : horse-collar : (rzecz.) chomąto
horse-comb : horse-comb : (rzecz.) zgrzebło
horse-race : horse-race : (rzecz.) gonitwa
horse-radish : horse-radish : (rzecz.) chrzan
horse-riding : horse-riding : (rzecz.) jeździectwo
horseback : horseback : (przysł.) konno | : (przysł.) wierzchem
horsefly : horsefly : (rzecz.) giez | : (rzecz.) mucha
horsehair : horsehair : (rzecz.) włosie
horseless : horseless : (przym.) mechaniczny
horseman : horseman : (rzecz.) jeździec | : (rzecz.) kawalerzysta
horsemanship : horsemanship : (rzecz.) hipika | : (rzecz.) hippika | : (rzecz.) jeździectwo
horsemeat : horsemeat : (rzecz.) konina
horsepower : horsepower : (rzecz.) kierat
horsepower-hour : horsepower-hour : (rzecz.) Koniogodzina
horserace : horserace : (rzecz.) gonitwa
horseradish : horseradish : (rzecz.) chrzan
horseshoe : horseshoe : (rzecz.) podkowa
horsetail : horsetail : (rzecz.) skrzyp
horsewhip : horsewhip : (rzecz.) pejcz | : (rzecz.) szpicruta
horsewoman : horsewoman : (rzecz.) amazonka
horsing : horsing : (rzecz.) dosiadanie
horst : horst : (rzecz.) horst | : (rzecz.) uskok | : (rzecz.) zrąb
horsy : horsy : (przym.) koński | : (przym.) wyścigowy
horticultural : horticultural : (przym.) ogrodniczy
horticulture : horticulture : (rzecz.) ogrodnictwo
horticulturist : horticulturist : (rzecz.) ogrodnik
hose : hose : (rzecz.) pończocha | : (rzecz.) szlauch | : (rzecz.) wąż
hosiery : hosiery : (rzecz.) bielizna | : (rzecz.) galanteria | : (rzecz.) trykotaż | : (rzecz.) trykotaże
hospice : hospice : (rzecz.) hospicjum
hospitable : hospitable : (przym.) dostępny | : (przym.) gościnny
hospital : hospital : (rzecz.) lazaret | : (rzecz.) szpital
hospitality : hospitality : (rzecz.) gościna | : (rzecz.) gościnność | : (rzecz.) serdeczność
hospitalization : hospitalization : (rzecz.) hospitalizacja
hospitalize : hospitalize : (czas.) hospitalizować
hospitalized : hospitalized : (czas.) hospitalizować
host : host : (czas.) gościć | : (rzecz.) bezlik | : (rzecz.) chmara | : (rzecz.) czereda | : (rzecz.) falanga | : (rzecz.) gospodarz | : (rzecz.) goszczenie | : (rzecz.) hostia | : (rzecz.) konferansjer | : (rzecz.) orszak | : (rzecz.) szynkarz | : (rzecz.) tłum | : (rzecz.) zastęp | : (rzecz.) żywiciel
hostage : hostage : (rzecz.) zakładnik
hostel : hostel : (rzecz.) akademik | : (rzecz.) hospicjum | : (rzecz.) internat | : (rzecz.) noclegownia | : (rzecz.) schronisko
hostelry : hostelry : (rzecz.) oberża | : (rzecz.) zajazd
hostess : hostess : (rzecz.) hostessa
hostile : hostile : (przym.) napastniczy | : (przym.) nieprzyjazny | : (przym.) wrogi
hostility : hostility : (rzecz.) wrogość
hot : hot : (czas.) nagrzać | : (czas.) rozgrzać | : (czas.) zagrzać | : (czas.) zgrzać | : (przym.) ciepły | : (przym.) gorący | : (przym.) ostry | : (przym.) pikantny | : (przym.) pokupny | : (przym.) upalny
hot-blooded : hot-blooded : (przym.) gorącokrwisty | : (przym.) krewki
hot-cathode : hot-cathode : (rzecz.) termokatoda
hot-headed : hot-headed : (przym.) popędliwy
hot-house : hot-house : (rzecz.) cieplarnia
hot-setting : hot-setting : (przym.) termoutwardzalny
hot-tempered : hot-tempered : (przym.) porywczy | : (przym.) wybuchowy
hotbed : hotbed : (rzecz.) chłodnia | : (rzecz.) inspekt | : (rzecz.) przyśpiesznik | : (rzecz.) wylęgarnia
hotcake : hotcake : (rzecz.) naleśnik
hotchpotch : hotchpotch : (rzecz.) galimatias | : (rzecz.) mieszanina | : (rzecz.) miszmasz
hotel : hotel : (rzecz.) hotel
hotel-keeper : hotel-keeper : (rzecz.) hotelarz
hotelier : hotelier : (rzecz.) hotelarz
hotfoot : hotfoot : (przysł.) ochoczo
hothead : hothead : (rzecz.) narwaniec | : (rzecz.) pasjonat
hothouse : hothouse : (rzecz.) cieplarnia | : (rzecz.) konserwatorium | : (rzecz.) oranżeria | : (rzecz.) pomarańczarnia | : (rzecz.) szklarnia
hotlink : hotlink : (rzecz.) odnośnik
hotpot : hotpot : (rzecz.) bigos
hotshot : hotshot : (rzecz.) mądrala
hound : hound : (czas.) podjudzać | : (czas.) ścigać | : (czas.) tropić | : (rzecz.) miłośnik | : (rzecz.) ogar
hour : hour : (rzecz.) godzina | : (rzecz.) godzinka
hour-glass : hour-glass : (rzecz.) klepsydra
hourglass : hourglass : (rzecz.) klepsydra
hourly : hourly : (przym.) ciągły | : (przym.) cogodzinny | : (przym.) godzinowy
hours : hours : (rzecz.) doba | : (rzecz.) godzina
house : house : (czas.) magazynować | : (czas.) mieścić | : (czas.) ulokować | : (czas.) umieścić | : (rzecz.) budynek | : (rzecz.) dom | : (rzecz.) domek | : (rzecz.) domostwo | : (rzecz.) firma | : (rzecz.) izba | : (rzecz.) kamienica | : (rzecz.) pensjonat | : (rzecz.) ród | : (rzecz.) widownia
house-breaker : house-breaker : (rzecz.) włamywacz
house-to-house : house-to-house : (przym.) domokrążny
houseboat : houseboat : (rzecz.) barka | : (rzecz.) koszarka | : (rzecz.) łódź
housebreaker : housebreaker : (rzecz.) włamywacz
housebreaking : housebreaking : (rzecz.) włamanie
housecoat : housecoat : (rzecz.) podomka | : (rzecz.) szlafrok
housefly : housefly : (rzecz.) mucha
household : household : (przym.) domownicy | : (przym.) domowy | : (rzecz.) dom | : (rzecz.) domostwo | : (rzecz.) gospodarstwo
householder : householder : (rzecz.) domownik | : (rzecz.) właściciel
housekeeper : housekeeper : (rzecz.) dozorczyni | : (rzecz.) gospodyni | : (rzecz.) gosposia | : (rzecz.) zarządca
housekeeping : housekeeping : (rzecz.) gospodarowanie
houseless : houseless : (przym.) bezdomny
houseline : houseline : (rzecz.) juzing | : (rzecz.) trójnitka
housemaid : housemaid : (rzecz.) gosposia | : (rzecz.) pokojówka | : (rzecz.) służąca
houseman : houseman : (rzecz.) asystent | : (rzecz.) stażysta
houseplant : houseplant : (przym.) doniczkowy
housewarming : housewarming : (rzecz.) parapetówka
housewife : housewife : (rzecz.) gospodyni | : (rzecz.) gosposia
housework : housework : (rzecz.) sprzątanie
housing : housing : (rzecz.) akomodacja | : (rzecz.) budownictwo | : (rzecz.) czaprak | : (rzecz.) obudowa | : (rzecz.) osłona | : (rzecz.) pomieszczenie | : (rzecz.) zamieszkiwanie
hovel : hovel : (rzecz.) buda | : (rzecz.) chałupa | : (rzecz.) ciupa | : (rzecz.) nora | : (rzecz.) puszka | : (rzecz.) rudera | : (rzecz.) szałas | : (rzecz.) szopa
hover : hover : (czas.) ociągać | : (czas.) unosić | : (czas.) wahać
hovercraft : hovercraft : (rzecz.) poduszkowiec
how : how : (przysł.) jak | : (przysł.) jakże
however : however : (przysł.) jakkolwiek | : (przysł.) jakże | : (spójnik) jednak | : (spójnik) jednakże | : (spójnik) natomiast
howitzer : howitzer : (rzecz.) granatnik | : (rzecz.) haubica
howl : howl : (czas.) ryczeć | : (czas.) wyć | : (czas.) zawyć | : (rzecz.) jęk | : (rzecz.) płacz | : (rzecz.) ryk | : (rzecz.) wycie
howler : howler : (rzecz.) buczek | : (rzecz.) byk | : (rzecz.) wsypa | : (rzecz.) wyjec
howsoever : howsoever : (przysł.) jakkolwiek
hoyden : hoyden : (rzecz.) chłopczyca
hr : hr : (rzecz.) kadr
hub : hub : (rzecz.) centrum | : (rzecz.) huba | : (rzecz.) koncentrator | : (rzecz.) piasta | : (rzecz.) środek
hubble-bubble : hubble-bubble : (rzecz.) gwar | : (rzecz.) wrzawa
hubbub : hubbub : (rzecz.) gwar | : (rzecz.) hałas | : (rzecz.) harmider | : (rzecz.) zgiełk
hubby : hubby : (rzecz.) mężulek
hubcap : hubcap : (rzecz.) dekiel | : (rzecz.) kołpak
huckleberry : huckleberry : (rzecz.) borówka | : (rzecz.) jagoda
huckster : huckster : (rzecz.) kramarz | : (rzecz.) paskarz
huddle : huddle : (rzecz.) kupa
hue : hue : (rzecz.) barwa | : (rzecz.) objęcie | : (rzecz.) odcień | : (rzecz.) zabarwienie
huff : huff : (czas.) obrażać | : (rzecz.) irytacja | : (rzecz.) rozdrażnienie
huffish : huffish : (przym.) drażliwy | : (przym.) obraźliwy
huffy : huffy : (przym.) drażliwy | : (przym.) obraźliwy
hug : hug : (czas.) przytulać | : (czas.) przytulić | : (czas.) ściskać | : (czas.) tulić | : (czas.) uściskać | : (rzecz.) przytulenie | : (rzecz.) uścisk
huge : huge : (przym.) ogromny | : (przym.) olbrzymi
hugely : hugely : (przysł.) ogromnie | : (przysł.) potwornie
hugeness : hugeness : (rzecz.) ogrom
hugger-mugger : hugger-mugger : (rzecz.) bałagan
huggermugger : huggermugger : (rzecz.) bałagan
hulk : hulk : (rzecz.) kolos | : (rzecz.) pudło
hulking : hulking : (przym.) ciężki | : (przym.) kulfoniasty | : (przym.) niezdarny
hull : hull : (czas.) łuskać | : (rzecz.) kadłub | : (rzecz.) łupa | : (rzecz.) łupina | : (rzecz.) łuska | : (rzecz.) otoczka | : (rzecz.) skorupa | : (rzecz.) strączek | : (rzecz.) strąk
hullabaloo : hullabaloo : (rzecz.) harmider
huller : huller : (rzecz.) łuszczarka | : (rzecz.) obłuskiwacz
hum : hum : (czas.) brzęczeć | : (czas.) buczeć | : (czas.) bzyczeć | : (czas.) bzykać | : (czas.) mruczeć | : (czas.) nucić | : (czas.) podśpiewywać | : (czas.) szumieć | : (czas.) warkotać | : (czas.) zanucić | : (rzecz.) brzęczenie | : (rzecz.) buczenie | : (rzecz.) gwar | : (rzecz.) jazgot | : (rzecz.) pomrukiwanie | : (rzecz.) przydźwięk | : (rzecz.) rozgwar | : (rzecz.) szum
human : human : (przym.) człowieczy | : (przym.) ludzki | : (rzecz.) człowiek | : (rzecz.) łudzenie
humane : humane : (przym.) humanistyczny | : (przym.) humanitarny | : (przym.) ludzki
humanely : humanely : (przysł.) humanitarnie
humaneness : humaneness : (rzecz.) człowieczeństwo | : (rzecz.) humanitarność
humanism : humanism : (rzecz.) humanizm
humanist : humanist : (rzecz.) humanista
humanistic : humanistic : (przym.) humanistyczny
humanitarian : humanitarian : (przym.) humanitarny
humanitarianism : humanitarianism : (rzecz.) humanitaryzm
humanities : humanities : (rzecz.) humanistyka
humanity : humanity : (rzecz.) człowieczeństwo | : (rzecz.) humanitarność | : (rzecz.) ludzkość
humanize : humanize : (czas.) humanizować | : (czas.) uczłowieczać | : (czas.) zhumanizować
humankind : humankind : (rzecz.) ludzkość
humanly : humanly : (przysł.) ludzko
humanoid : humanoid : (przym.) humanoidalny
humble : humble : (czas.) upokarzać | : (czas.) upokorzyć | : (przym.) korny | : (przym.) pokorny | : (przym.) potulny | : (przym.) skromny
humble-bee : humble-bee : (rzecz.) bąk | : (rzecz.) trzmiel
humblebee : humblebee : (rzecz.) trzmiel
humbleness : humbleness : (rzecz.) pokora | : (rzecz.) uniżoność
humbler : humbler : (przym.) pokorny | : (przym.) skromny
humbly : humbly : (przysł.) pokornie
humbug : humbug : (rzecz.) blaga | : (rzecz.) blagier | : (rzecz.) lipa | : (rzecz.) nonsens | : (rzecz.) oszust | : (rzecz.) oszustwo | : (rzecz.) szachraj | : (rzecz.) zakłamanie
humdrum : humdrum : (przym.) monotonny | : (przym.) nudny | : (rzecz.) banalność | : (rzecz.) nuda | : (rzecz.) prozaiczność
humeral : humeral : (przym.) barkowy | : (przym.) ramienny
humid : humid : (przym.) parny | : (przym.) wilgotny
humidification : humidification : (rzecz.) nawilżanie | : (rzecz.) zwilżanie
humidifier : humidifier : (rzecz.) nawilżacz
humidifiers : humidifiers : (rzecz.) nawilżacz
humidify : humidify : (czas.) nawilżać | : (czas.) zwilżać
humidity : humidity : (rzecz.) wilgoć | : (rzecz.) wilgotność
humiliate : humiliate : (czas.) korzyć | : (czas.) poniżać | : (czas.) poniżyć | : (czas.) upokarzać | : (czas.) upokorzyć
humiliation : humiliation : (rzecz.) poniżenie | : (rzecz.) upokorzenie
humility : humility : (rzecz.) pokora | : (rzecz.) potulność | : (rzecz.) skromność | : (rzecz.) uniżoność
hummer : hummer : (rzecz.) brzęczyk
humming-bird : humming-bird : (rzecz.) koliber
hummingbird : hummingbird : (rzecz.) koliber
hummock : hummock : (rzecz.) pagórek | : (rzecz.) wzgórek | : (rzecz.) wzniesienie
hummocky : hummocky : (przym.) pagórkowaty
humoresque : humoresque : (rzecz.) humoreska
humorist : humorist : (rzecz.) humorysta
humoristic : humoristic : (przym.) humorystyczny
humorous : humorous : (przym.) dowcipny | : (przym.) humorystyczny | : (przym.) zabawny | : (przym.) żartobliwy
humour : humour : (rzecz.) humor | : (rzecz.) nastrój | : (rzecz.) płyn
hump : hump : (czas.) garbić | : (czas.) zginać | : (rzecz.) garb | : (rzecz.) przesilenie
humpback : humpback : (rzecz.) garb | : (rzecz.) garbus
humpbacked : humpbacked : (przym.) garbaty | : (przym.) łukowaty
humus : humus : (rzecz.) czarnoziem | : (rzecz.) próchnica
hunch : hunch : (czas.) kulić | : (rzecz.) wrażenie
hunchback : hunchback : (rzecz.) garbus
hunchbacked : hunchbacked : (przym.) garbaty
hunched : hunched : (przym.) garbaty
hundred : hundred : (przym.) setny | : (rzecz.) setka | : (rzecz.) stówa
hundred-year : hundred-year : (przym.) stuletni
hundredfold : hundredfold : (przym.) stokrotny | : (przym.) stukrotny | : (przysł.) stokrotnie
hundredth : hundredth : (przym.) setny | : (rzecz.) setna
hundredweight : hundredweight : (rzecz.) cetnar
hunger : hunger : (rzecz.) głód | : (rzecz.) łaknienie | : (rzecz.) pożądanie | : (rzecz.) żądza
hunger-strike : hunger-strike : (rzecz.) głodówka
hungrily : hungrily : (przysł.) chciwie | : (przysł.) łapczywie | : (przysł.) pożądliwie
hungry : hungry : (przym.) głodny | : (przym.) jałowy | : (przym.) ubogi
hunk : hunk : (rzecz.) bryła | : (rzecz.) kawałek | : (rzecz.) kęs | : (rzecz.) przystojniak
hunker : hunker : (czas.) kucać
hunks : hunks : (rzecz.) kutwa | : (rzecz.) sknera
hunky-dory : hunky-dory : (przym.) dobry | : (przym.) świetny
hunt : hunt : (czas.) dopaść | : (czas.) gonić | : (czas.) polować | : (czas.) poszukiwać | : (czas.) ścigać | : (czas.) tropić | : (rzecz.) obława | : (rzecz.) polowanie
hunted : hunted : (czas.) polować
hunter : hunter : (rzecz.) łowca | : (rzecz.) szukacz
hunters : hunters : (rzecz.) łowca
hunting : hunting : (rzecz.) łowiectwo | : (rzecz.) myślistwo | : (rzecz.) polowanie | : (rzecz.) szukanie
hurdle : hurdle : (rzecz.) opłotek | : (rzecz.) płot | : (rzecz.) płotek | : (rzecz.) przeszkoda
hurdler : hurdler : (rzecz.) płotkarz
hurdy-gurdy : hurdy-gurdy : (rzecz.) katarynka
hurl : hurl : (czas.) ciskać | : (czas.) miotać | : (czas.) rzucać | : (czas.) rzucić | : (rzecz.) miotanie | : (rzecz.) rzut
hurling : hurling : (rzecz.) miotanie
hurly-burly : hurly-burly : (rzecz.) rozgardiasz | : (rzecz.) wrzawa | : (rzecz.) zgiełk
hurrah : hurrah : (wykrzyknik) hurra
hurray : hurray : (czas.) wiwatować | : (wykrzyknik) hura | : (wykrzyknik) hurra
hurricane : hurricane : (rzecz.) huragan | : (rzecz.) orkan
hurried : hurried : (przym.) pośpieszny | : (przym.) śpieszny
hurriedly : hurriedly : (przysł.) pospiesznie | : (przysł.) pośpiesznie
hurry : hurry : (czas.) pędzić | : (czas.) podgonić | : (czas.) ponaglać | : (czas.) pospieszać | : (czas.) pośpieszać | : (czas.) pospieszyć | : (czas.) pośpieszyć | : (czas.) przyspieszać | : (czas.) spieszyć | : (czas.) śpieszyć | : (rzecz.) pośpiech
hurry-scurry : hurry-scurry : (przysł.) bezładnie | : (rzecz.) zamieszanie
hurt : hurt : (czas.) boleć | : (czas.) kaleczyć | : (czas.) ranić
hurtful : hurtful : (przym.) bolesny
hurtle : hurtle : (czas.) miotać | : (czas.) uderzać | : (czas.) uderzyć
husband : husband : (czas.) gospodarować | : (czas.) zarządzać | : (rzecz.) małżonek | : (rzecz.) mąż
husbandman : husbandman : (rzecz.) gospodarz | : (rzecz.) rolnik
husbandry : husbandry : (rzecz.) cisza | : (rzecz.) spokój
hush : hush : (czas.) ucichnąć | : (czas.) uciszać | : (czas.) uciszyć | : (rzecz.) cisza | : (rzecz.) spokój
husk : husk : (czas.) łupać | : (czas.) łuskać | : (czas.) łuszczyć | : (czas.) obłuskiwać | : (czas.) wyłuskiwać | : (rzecz.) łupina | : (rzecz.) łupinka | : (rzecz.) łuska | : (rzecz.) plewa
huskily : huskily : (przysł.) krzepko
huskiness : huskiness : (rzecz.) łuskowatość | : (rzecz.) ochrypnięcie
husky : husky : (przym.) chrapliwy | : (przym.) czerstwy | : (przym.) gardłowy | : (przym.) krzepki | : (przym.) zdrowy
hussar : hussar : (rzecz.) husarz | : (rzecz.) huzar
hussars : hussars : (rzecz.) husaria
hussy : hussy : (rzecz.) latawica
hustle : hustle : (czas.) krzątać | : (czas.) pchać | : (czas.) popychać | : (czas.) przepychać | : (czas.) śpieszyć | : (czas.) tłoczyć | : (rzecz.) bieganina | : (rzecz.) krzątanina | : (rzecz.) ścisk | : (rzecz.) szwindel | : (rzecz.) tłok
hustler : hustler : (rzecz.) hochsztapler | : (rzecz.) prostytutka
hut : hut : (rzecz.) buda | : (rzecz.) budka | : (rzecz.) chałupa | : (rzecz.) chata | : (rzecz.) chatka | : (rzecz.) szałas
hutch : hutch : (rzecz.) chatka | : (rzecz.) klatka | : (rzecz.) klecenie | : (rzecz.) klitka | : (rzecz.) płuczka | : (rzecz.) skrzynia | : (rzecz.) skrzynka
hyacinth : hyacinth : (rzecz.) hiacynt
hyaline : hyaline : (przym.) szklisty
hybrid : hybrid : (przym.) hybrydowy | : (przym.) mieszańcowy | : (rzecz.) hybryd | : (rzecz.) hybryda | : (rzecz.) mieszaniec
hybridism : hybridism : (rzecz.) hybrydyzm
hybridization : hybridization : (rzecz.) hybrydyzacja | : (rzecz.) hybrydyzm | : (rzecz.) krzyżowanie | : (rzecz.) krzyżówka
hybridize : hybridize : (czas.) krzyżować | : (czas.) skrzyżować
hydra : hydra : (rzecz.) hydra | : (rzecz.) stułbia
hydrant : hydrant : (rzecz.) hydrant
hydrastine : hydrastine : (rzecz.) hydrastyna
hydrate : hydrate : (czas.) uwadniać | : (rzecz.) hydrat | : (rzecz.) wodzian
hydrated : hydrated : (przym.) hydratyzowany | : (przym.) uwodniony
hydration : hydration : (rzecz.) hydratacja | : (rzecz.) uwodnienie
hydraulic : hydraulic : (przym.) hydrauliczny
hydraulically : hydraulically : (przysł.) hydraulicznie
hydraulics : hydraulics : (rzecz.) hydraulika
hydrazine : hydrazine : (rzecz.) hydrazyna
hydride : hydride : (rzecz.) wodorek
hydro : hydro : (rzecz.) hydroelektrownia
hydro-engineering : hydro-engineering : (rzecz.) hydrotechnika
hydro-generator : hydro-generator : (rzecz.) hydrogenerator
hydrobiology : hydrobiology : (rzecz.) hydrobiologia
hydrocarbon : hydrocarbon : (rzecz.) węglowodór
hydrocephalus : hydrocephalus : (rzecz.) wodogłowie
hydrochloric : hydrochloric : (przym.) chlorowodorowy
hydrochloride : hydrochloride : (rzecz.) chlorowodorek
hydrodynamic : hydrodynamic : (przym.) hydrodynamiczny
hydrodynamics : hydrodynamics : (rzecz.) hydrodynamika
hydroelectric : hydroelectric : (przym.) hydroelektryczny
hydrofluoric : hydrofluoric : (przym.) fluorowodorowy
hydrofoil : hydrofoil : (rzecz.) hydropłat | : (rzecz.) wodolot
hydrogen : hydrogen : (rzecz.) wodór
hydrogenate : hydrogenate : (czas.) uwodorniać
hydrogenation : hydrogenation : (rzecz.) uwodornianie
hydrogenize : hydrogenize : (rzecz.) uwodornianie | : (rzecz.) uwodornienie
hydrogenous : hydrogenous : (przym.) wodorowy
hydrogeology : hydrogeology : (rzecz.) hydrogeologia
hydrograph : hydrograph : (rzecz.) hydrograf
hydrokinetic : hydrokinetic : (przym.) hydrodynamiczny
hydrokinetics : hydrokinetics : (rzecz.) hydrokinetyka
hydrological : hydrological : (przym.) hydrologiczny
hydrologist : hydrologist : (rzecz.) hydrolog
hydrology : hydrology : (rzecz.) hydrologia
hydrolysis : hydrolysis : (rzecz.) hydroliza
hydrolytic : hydrolytic : (przym.) hydrolityczny
hydrolyze : hydrolyze : (czas.) hydrolizować
hydromechanics : hydromechanics : (rzecz.) hydraulika | : (rzecz.) hydromechanika
hydrometallurgy : hydrometallurgy : (rzecz.) hydrometalurgia
hydrometeorology : hydrometeorology : (rzecz.) hydrometeorologia
hydrometeors : hydrometeors : (przym.) hydrometeory
hydrometer : hydrometer : (rzecz.) areometr | : (rzecz.) gęstościomierz | : (rzecz.) hydrometr
hydrometric : hydrometric : (przym.) hydrometryczny
hydrophilic : hydrophilic : (przym.) hydrofilowy
hydrophobia : hydrophobia : (rzecz.) hydrofobia | : (rzecz.) wodowstręt
hydrophobic : hydrophobic : (przym.) hydrofobowy
hydrophone : hydrophone : (rzecz.) hydrofon
hydroplane : hydroplane : (rzecz.) hydroplan | : (rzecz.) ślizgacz | : (rzecz.) wodnopłat | : (rzecz.) wodnopłatowiec
hydroponics : hydroponics : (rzecz.) hydroponika | : (rzecz.) hydrostatyka
hydroquinone : hydroquinone : (rzecz.) hydrochinon
hydrosol : hydrosol : (rzecz.) hydrozol
hydrosphere : hydrosphere : (rzecz.) hydrosfera
hydrostat : hydrostat : (rzecz.) higrostat | : (rzecz.) humidostat
hydrostatic : hydrostatic : (przym.) hydrostatyczny
hydrostatical : hydrostatical : (przym.) hydrostatyczny
hydrostatics : hydrostatics : (rzecz.) hydrostatyka
hydrotherapeutic : hydrotherapeutic : (przym.) wodoleczniczy
hydrotherapy : hydrotherapy : (rzecz.) hydroterapia | : (rzecz.) wodolecznictwo
hydrothermal : hydrothermal : (przym.) hydrotermalny
hydrous : hydrous : (przym.) wodny
hydroxide : hydroxide : (rzecz.) wodorotlenek
hydroxyl : hydroxyl : (rzecz.) hydroksyl
hydroxylamine : hydroxylamine : (rzecz.) hydroksyloamina
hydroxylation : hydroxylation : (rzecz.) hydroksylowanie
hyena : hyena : (rzecz.) hiena
hygiene : hygiene : (rzecz.) higiena
hygienic : hygienic : (przym.) higieniczny
hygienically : hygienically : (przysł.) higienicznie
hygienist : hygienist : (rzecz.) higienista
hygrometer : hygrometer : (rzecz.) aerometr | : (rzecz.) higrometr | : (rzecz.) wilgotnościomierz
hygrometry : hygrometry : (rzecz.) higrometria
hygroscope : hygroscope : (rzecz.) higroskop
hygroscopic : hygroscopic : (przym.) higroskopijny
hygrostat : hygrostat : (rzecz.) higrostat | : (rzecz.) humidostat
hymn : hymn : (rzecz.) hymn
hype : hype : (rzecz.) popularność | : (rzecz.) szum
hyperacidity : hyperacidity : (rzecz.) nadkwaśność | : (rzecz.) nadkwasota
hyperactivity : hyperactivity : (rzecz.) nadczynność
hyperbola : hyperbola : (rzecz.) hiperbola
hyperbole : hyperbole : (rzecz.) hiperbola | : (rzecz.) przesada | : (rzecz.) przesadnia
hyperbolic : hyperbolic : (przym.) hiperboliczny | : (przym.) przesadny
hyperbolical : hyperbolical : (przym.) hiperboliczny
hyperboloid : hyperboloid : (rzecz.) hiperboloida
hyperinflation : hyperinflation : (rzecz.) hiperinflacja
hyperlink : hyperlink : (rzecz.) hiperłącze | : (rzecz.) odsyłacz
hyperplasia : hyperplasia : (rzecz.) hiperplazja
hypersensitive : hypersensitive : (przym.) nadwrażliwy | : (przym.) superczuły
hypersensitivity : hypersensitivity : (rzecz.) nadwrażliwość
hypersonic : hypersonic : (przym.) hipersoniczny
hypertension : hypertension : (rzecz.) nadciśnienie
hypertensive : hypertensive : (przym.) nadciśnieniowy
hypertext : hypertext : (rzecz.) hipertekst
hyperthermia : hyperthermia : (rzecz.) hipertermia
hypertrophy : hypertrophy : (rzecz.) hipertrofia
hyphen : hyphen : (rzecz.) kreska | : (rzecz.) łącznik | : (rzecz.) myślnik | : (rzecz.) pauza | : (rzecz.) rozłącznik
hypnology : hypnology : (rzecz.) hipnologia
hypnosis : hypnosis : (rzecz.) hipnoza
hypnotic : hypnotic : (przym.) hipnotyczny
hypnotically : hypnotically : (przysł.) hipnotycznie
hypnotism : hypnotism : (rzecz.) hipnotyzm
hypnotist : hypnotist : (rzecz.) hipnotyzer
hypnotization : hypnotization : (rzecz.) hipnotyzowanie
hypnotize : hypnotize : (czas.) hipnotyzować | : (czas.) zahipnotyzować
hypo : hypo : (rzecz.) strzykawka | : (rzecz.) zastrzyk
hypochlorite : hypochlorite : (rzecz.) podchloryn
hypochondria : hypochondria : (rzecz.) hipochondria
hypochondriac : hypochondriac : (przym.) hipochondryczny | : (rzecz.) hipochondryk
hypocoristic : hypocoristic : (przym.) pieszczotliwy
hypocrisy : hypocrisy : (rzecz.) faryzeizm | : (rzecz.) faryzeuszostwo | : (rzecz.) hipokryzja | : (rzecz.) obłuda | : (rzecz.) zakłamanie
hypocrite : hypocrite : (rzecz.) hipokryta | : (rzecz.) obłudnica | : (rzecz.) obłudnik
hypocritical : hypocritical : (przym.) obłudny
hypocycloid : hypocycloid : (rzecz.) hipocykloida
hypodermic : hypodermic : (przym.) podskórny
hyposulfite : hyposulfite : (rzecz.) podsiarczyn | : (rzecz.) tiosiarczan
hypotension : hypotension : (rzecz.) hipotonia | : (rzecz.) niedociśnienie
hypotenuse : hypotenuse : (rzecz.) przeciwprostokątna
hypothermia : hypothermia : (rzecz.) hipotermia
hypothesis : hypothesis : (rzecz.) hipoteza
hypothetic : hypothetic : (przym.) hipotetyczny | : (przym.) przykładowy
hypothetical : hypothetical : (przym.) hipotetyczny | : (przym.) przykładowy
hypothetically : hypothetically : (przysł.) hipotetycznie | : (przysł.) przypuszczalnie
hypoxia : hypoxia : (rzecz.) niedotlenienie
hypsometer : hypsometer : (rzecz.) hipsotermometr
hypsometry : hypsometry : (rzecz.) hipsometria
hyssop : hyssop : (rzecz.) hizop
hysteria : hysteria : (rzecz.) histeria
hysteric : hysteric : (rzecz.) histeryk
hysterical : hysterical : (przym.) histeryczny
hysterically : hysterically : (przysł.) histerycznie
hysterics : hysterics : (rzecz.) histeria
