laura : Laura : (rzecz.) Laura
leon : Leon : (rzecz.) Leo
liliana : Liliana : (rzecz.) Lilly
labiedzic : labiedzić : (czas.) gripe
labilny : labilny : (przym.) labile
labirynt : labirynt : (rzecz.) labyrinth | : (rzecz.) maze
labiryntowy : labiryntowy : (przym.) labyrinthine
laborant : laborant : (rzecz.) laboratory
laboratorium : laboratorium : (rzecz.) lab | : (rzecz.) laboratory
laboratoryjny : laboratoryjny : (przym.) laboratory
laburzysta : laburzysta : (rzecz.) labourite
lada : lada : (rzecz.) counter
ladacznica : ladacznica : (rzecz.) harlot | : (rzecz.) strumpet | : (rzecz.) whore
lafirynda : lafirynda : (rzecz.) floozy | : (rzecz.) tart
laguna : laguna : (rzecz.) lagoon
laicki : laicki : (przym.) lay | : (przym.) secular
laicyzacja : laicyzacja : (rzecz.) secularization
laicyzowac : laicyzować : (czas.) laicize
laik : laik : (rzecz.) layman | : (rzecz.) outsider
lak : lak : (rzecz.) sealing-wax | : (rzecz.) wax
laka : laka : (rzecz.) lacquer | : (rzecz.) mead
lakier : lakier : (rzecz.) lacquer | : (rzecz.) paint | : (rzecz.) varnish
lakiernik : lakiernik : (rzecz.) painter
lakierowanie : lakierowanie : (rzecz.) painting
lakierowac : lakierować : (czas.) lacquer | : (czas.) paint | : (czas.) varnish
lakmus : lakmus : (rzecz.) litmus
lakonicznie : lakonicznie : (przysł.) briefly | : (przysł.) curtly | : (przysł.) laconically
lakonicznosc : lakoniczność : (rzecz.) briefness
lakoniczny : lakoniczny : (przym.) curt | : (przym.) laconic | : (przym.) short | : (przym.) terse
lakowac : lakować : (czas.) seal
lakrymator : lakrymator : (rzecz.) lachrymator
laktacja : laktacja : (rzecz.) lactation
laktaza : laktaza : (rzecz.) lactase
laktodensymetr : laktodensymetr : (rzecz.) lactometer
laktoflawina : laktoflawina : (rzecz.) riboflavin
laktometr : laktometr : (rzecz.) lactometer
laktoza : laktoza : (rzecz.) lactose
lala : lala : (rzecz.) doll
lalka : lalka : (rzecz.) doll | : (rzecz.) dolly
lalkarz : lalkarz : (rzecz.) puppeteer
lalkowaty : lalkowaty : (przym.) dollish
lalus : laluś : (rzecz.) fop
lama : lama : (rzecz.) llama
lambrekin : lambrekin : (rzecz.) lambrequin | : (rzecz.) pelmet
lamela : lamela : (rzecz.) lamella
lamelka : lamelka : (rzecz.) fuse
lament : lament : (rzecz.) lament | : (rzecz.) lamentation
lamentacja : lamentacja : (rzecz.) coronach | : (rzecz.) lamentation
lamentowanie : lamentowanie : (rzecz.) mourning | : (rzecz.) ululation
lamentowac : lamentować : (czas.) bemoan | : (czas.) lament | : (czas.) moan | : (czas.) mourn | : (czas.) whine
lameta : lameta : (rzecz.) tinsel
laminarny : laminarny : (przym.) laminar
laminat : laminat : (rzecz.) fibreboard
laminowanie : laminowanie : (rzecz.) lamination
laminowac : laminować : (czas.) laminate
lamowac : lamować : (czas.) trim
lampa : lampa : (rzecz.) lamp
lampart : lampart : (rzecz.) leopard
lampas : lampas : (rzecz.) stripe
lamperia : lamperia : (rzecz.) dado
lampion : lampion : (rzecz.) lampion
lampka : lampka : (rzecz.) glass | : (rzecz.) lamp
lamus : lamus : (rzecz.) lumber-room
lamowka : lamówka : (rzecz.) border | : (rzecz.) edging | : (rzecz.) fringe | : (rzecz.) trimming | : (rzecz.) welt
lanca : lanca : (rzecz.) lance
lancetnik : lancetnik : (rzecz.) lancelet
lancknecht : lancknecht : (rzecz.) lansquenet
landara : landara : (rzecz.) crate | : (rzecz.) landau | : (rzecz.) rumble-tumble
lando : lando : (rzecz.) landau
landrynkowy : landrynkowy : (przym.) sweet
langusta : langusta : (rzecz.) crayfish
lanie : lanie : (rzecz.) beating | : (rzecz.) leathering | : (rzecz.) pc | : (rzecz.) pouring | : (rzecz.) spanking | : (rzecz.) thrashing | : (rzecz.) towelling
lanolina : lanolina : (rzecz.) lanolin | : (rzecz.) lanoline
lansjer : lansjer : (rzecz.) lancer
lansowac : lansować : (czas.) promote
lantan : lantan : (rzecz.) lanthanum
lantanowiec : lantanowiec : (rzecz.) lanthanide
laparoskopia : laparoskopia : (rzecz.) laparoscopy
lapidarnosc : lapidarność : (rzecz.) conciseness
lapidarny : lapidarny : (przym.) curt | : (przym.) lapidary | : (przym.) pithy | : (przym.) terse
lapsus : lapsus : (rzecz.) lapse | : (rzecz.) slip
laptop : laptop : (rzecz.) laptop
larum : larum : (rzecz.) arum | : (rzecz.) cry
larwa : larwa : (rzecz.) grub | : (rzecz.) larva | : (rzecz.) maggot
larwalny : larwalny : (przym.) larval
laryngolog : laryngolog : (rzecz.) laryngologist | : (rzecz.) laryngologists
laryngoskop : laryngoskop : (rzecz.) laryngoscope
las : las : (rzecz.) forest | : (rzecz.) greenwood | : (rzecz.) timber | : (rzecz.) wood
lasecznik : lasecznik : (rzecz.) bacillus
lasek : lasek : (rzecz.) grove | : (rzecz.) spinney | : (rzecz.) wood
laser : laser : (rzecz.) laser
laserowanie : laserowanie : (rzecz.) lasing
laserowac : laserować : (czas.) glaze
laska : laska : (rzecz.) bounty | : (rzecz.) cane | : (rzecz.) crutch | : (rzecz.) minim | : (rzecz.) rod | : (rzecz.) stick | : (rzecz.) walking-stick
lasowac : lasować : (czas.) crumble | : (czas.) slake
lastryko : lastryko : (rzecz.) terrazzo
lasy : lasy : (rzecz.) woodland
latacz : latacz : (rzecz.) cobbler
latajacy : latający : (przym.) floating
latania : latania : (rzecz.) fly
latanie : latanie : (rzecz.) flying
latanina : latanina : (rzecz.) bustle | : (rzecz.) stir
latarka : latarka : (rzecz.) flashlight | : (rzecz.) torch
latarnia : latarnia : (rzecz.) beacon | : (rzecz.) lamp | : (rzecz.) lantern | : (rzecz.) streetlamp
latarniany : latarniany : (przym.) streetlamp
latarniowiec : latarniowiec : (rzecz.) lightship
latarniowy : latarniowy : (przym.) streetlamp
latawica : latawica : (rzecz.) gadabout | : (rzecz.) hussy | : (rzecz.) loafer
latawiec : latawiec : (rzecz.) flier | : (rzecz.) flyer | : (rzecz.) kite
latac : latać : (czas.) flit | : (czas.) flitter | : (czas.) fly | : (czas.) navigate | : (czas.) swim
lateks : lateks : (rzecz.) latex
lato : lato : (rzecz.) summer | : (rzecz.) summertime
latorosl : latorośl : (rzecz.) branch | : (rzecz.) grapevine | : (rzecz.) offspring | : (rzecz.) outgrowth | : (rzecz.) scion | : (rzecz.) sprig | : (rzecz.) sprout | : (rzecz.) vine
latryna : latryna : (rzecz.) latrine
laubzega : laubzega : (rzecz.) fretsaw | : (rzecz.) fret-saw | : (rzecz.) jigsaw
laudanum : laudanum : (rzecz.) laudanum
laufer : laufer : (rzecz.) bishop
laureat : laureat : (rzecz.) laureate | : (rzecz.) prize-winner | : (rzecz.) winner
laurka : laurka : (rzecz.) card
laury : laury : (rzecz.) laurels
lawa : lawa : (rzecz.) lava
lawenda : lawenda : (rzecz.) lavender
laweta : laweta : (rzecz.) gun-carriage
lawina : lawina : (rzecz.) avalanche
lawirant : lawirant : (rzecz.) trimmer
lawirowac : lawirować : (czas.) beat | : (czas.) prevaricate | : (czas.) tack
lawowanie : lawowanie : (rzecz.) lava
lazaret : lazaret : (rzecz.) hospital
lazur : lazur : (rzecz.) azure | : (rzecz.) blue
lazurowy : lazurowy : (przym.) azure
lac : lać : (czas.) beat | : (czas.) gush | : (czas.) pour | : (czas.) thrash | : (czas.) whop
leasingowy : leasingowy : (przym.) leasing
lebioda : lebioda : (rzecz.) pigweed
lebiodka : lebiodka : (rzecz.) oregano
leciec : lecieć : (czas.) dart | : (czas.) dash | : (czas.) flee | : (czas.) fly | : (czas.) skitter
leciwy : leciwy : (przym.) elderly
lecytyna : lecytyna : (rzecz.) lecithin
lecz : lecz : (spójnik) but
leczenie : leczenie : (rzecz.) cure | : (rzecz.) curing | : (rzecz.) healing | : (rzecz.) medication | : (rzecz.) therapy | : (rzecz.) treatment
lecznica : lecznica : (rzecz.) clinic | : (rzecz.) infirmary
lecznictwo : lecznictwo : (rzecz.) therapeutics
leczniczy : leczniczy : (przym.) curative | : (przym.) healing | : (przym.) medical | : (przym.) medicinal | : (przym.) prophylactic | : (przym.) therapeutic
leczyc : leczyć : (czas.) cure | : (czas.) heal | : (czas.) medicate | : (czas.) remedy | : (czas.) treat
ledwie : ledwie : (przysł.) barely | : (przysł.) hardly | : (przysł.) scarcely
ledwo : ledwo : (przysł.) almost | : (przysł.) barely | : (przysł.) hardly | : (przysł.) narrowly | : (przysł.) scarcely
legacja : legacja : (rzecz.) legation
legalista : legalista : (rzecz.) legalist
legalizacja : legalizacja : (rzecz.) authentication | : (rzecz.) legalization | : (rzecz.) validation | : (rzecz.) verification
legalizm : legalizm : (rzecz.) legitimacy
legalizowac : legalizować : (czas.) attest | : (czas.) legalize | : (czas.) legitimize | : (czas.) validate
legalnie : legalnie : (przysł.) lawfully | : (przysł.) legally
legalnosc : legalność : (rzecz.) lawfulness | : (rzecz.) legality | : (rzecz.) legitimacy
legalny : legalny : (przym.) aboveboard | : (przym.) lawful | : (przym.) legal | : (przym.) legitimate | : (przym.) licit | : (przym.) rightful
legar : legar : (rzecz.) beam | : (rzecz.) joist | : (rzecz.) sleeper
legat : legat : (rzecz.) bequest | : (rzecz.) legacy | : (rzecz.) legate
legawiec : legawiec : (rzecz.) pointer | : (rzecz.) setter
legenda : legenda : (rzecz.) key | : (rzecz.) legend
legendarnie : legendarnie : (przysł.) legendarily
legendarny : legendarny : (przym.) fabulous | : (przym.) legendary
legia : legia : (rzecz.) legion
legion : legion : (rzecz.) legion
legionista : legionista : (rzecz.) legionary | : (rzecz.) legionnaire
legionowy : legionowy : (przym.) legionary
legislacja : legislacja : (rzecz.) law | : (rzecz.) legislation
legislacyjny : legislacyjny : (przym.) legislative
legislatura : legislatura : (rzecz.) legislature
legitymacja : legitymacja : (rzecz.) pass
legitymowac : legitymować : (czas.) authorise | : (czas.) identify | : (czas.) justify
legnac : legnąć : (czas.) hatch
legowisko : legowisko : (rzecz.) bed | : (rzecz.) couch | : (rzecz.) den | : (rzecz.) lair | : (rzecz.) lie | : (rzecz.) shakedown
legumina : legumina : (rzecz.) dessert | : (rzecz.) flummery | : (rzecz.) game | : (rzecz.) junket | : (rzecz.) mincemeat | : (rzecz.) pudding | : (rzecz.) roly-poly | : (rzecz.) sweet
legwan : legwan : (rzecz.) iguana
lej : lej : (rzecz.) crater | : (rzecz.) funnel
leja : leja : (rzecz.) funnel | : (rzecz.) hopper
lejce : lejce : (rzecz.) rein | : (rzecz.) reins
lejek : lejek : (rzecz.) funnel | : (rzecz.) spiracle | : (rzecz.) tunnel
lejkowaty : lejkowaty : (przym.) bell-mouthed | : (przym.) funnel-shaped
lejtnant : lejtnant : (rzecz.) lieutenant
lek : lek : (rzecz.) drug | : (rzecz.) medicament | : (rzecz.) medication | : (rzecz.) medicine
lekarski : lekarski : (przym.) medical | : (przym.) medicinal | : (przym.) officinal
lekarstwo : lekarstwo : (rzecz.) cure | : (rzecz.) drug | : (rzecz.) medication | : (rzecz.) medicine | : (rzecz.) physic | : (rzecz.) remedy
lekarz : lekarz : (rzecz.) doctor | : (rzecz.) medic | : (rzecz.) physician | : (rzecz.) specialist
lekcewazenie : lekceważenie : (rzecz.) disdain | : (rzecz.) disregard | : (rzecz.) disrespect | : (rzecz.) flippancy | : (rzecz.) irreverence | : (rzecz.) neglect | : (rzecz.) negligence | : (rzecz.) scorn | : (rzecz.) slight | : (rzecz.) slightness
lekcewazyc : lekceważyć : (czas.) devalue | : (czas.) disregard | : (czas.) ignore | : (czas.) overbear | : (czas.) override | : (czas.) scorn | : (czas.) scout | : (czas.) slight | : (czas.) underestimate
lekcewazaco : lekceważąco : (przysł.) disrespectfully | : (przysł.) ignorantly | : (przysł.) lightly
lekcewazacy : lekceważący : (przym.) disdainful | : (przym.) irreverent
lekcja : lekcja : (rzecz.) class | : (rzecz.) lesson
leki : leki : (rzecz.) chemicals
lekki : lekki : (przym.) airy | : (przym.) clammy | : (przym.) effortless | : (przym.) faint | : (przym.) light | : (przym.) lightsome | : (przym.) lightweight | : (przym.) nimble | : (przym.) slight | : (przym.) venial
lekko : lekko : (przysł.) airily | : (przysł.) easily | : (przysł.) gently | : (przysł.) lightly | : (przysł.) slightly
lekkoatleta : lekkoatleta : (rzecz.) athlete
lekkoatletyczny : lekkoatletyczny : (przym.) athletic
lekkoatletyka : lekkoatletyka : (rzecz.) athletics | : (rzecz.) sport
lekkoduch : lekkoduch : (rzecz.) playboy | : (rzecz.) spark | : (rzecz.) trifler
lekkomyslnie : lekkomyślnie : (przysł.) hastily | : (przysł.) recklessly | : (przysł.) thoughtlessly
lekkomyslnosc : lekkomyślność : (rzecz.) frivolity | : (rzecz.) giddiness | : (rzecz.) irresponsibility | : (rzecz.) levity | : (rzecz.) recklessness
lekkomyslny : lekkomyślny : (przym.) airy | : (przym.) extravagant | : (przym.) flighty | : (przym.) frivolous | : (przym.) giddy | : (przym.) heedless | : (przym.) improvident | : (przym.) inane | : (przym.) inconsiderate | : (przym.) insouciant | : (przym.) light | : (przym.) light-minded | : (przym.) reckless | : (przym.) thoughtless
lekkostrawny : lekkostrawny : (przym.) light
lekkosc : lekkość : (rzecz.) ease | : (rzecz.) levity | : (rzecz.) lightness | : (rzecz.) viscosity
lekospis : lekospis : (rzecz.) pharmacopoeia
lekoznawstwo : lekoznawstwo : (rzecz.) pharmaceutics
leksem : leksem : (rzecz.) lexeme | : (rzecz.) token
leksyka : leksyka : (rzecz.) lexicon
leksykalnie : leksykalnie : (przysł.) lexically
leksykalny : leksykalny : (przym.) lexical
leksykograf : leksykograf : (rzecz.) lexicographer
leksykografia : leksykografia : (rzecz.) lexicography
leksykograficznie : leksykograficznie : (przysł.) lexicographically
leksykograficzny : leksykograficzny : (przym.) lexicographical
leksykolog : leksykolog : (rzecz.) lexicologist
leksykologia : leksykologia : (rzecz.) lexicology
leksykon : leksykon : (rzecz.) glossary | : (rzecz.) lexicon
lektor : lektor : (rzecz.) instructor | : (rzecz.) lector | : (rzecz.) reader
lektorat : lektorat : (rzecz.) course
lektura : lektura : (rzecz.) reading
lektyka : lektyka : (rzecz.) litter | : (rzecz.) sedan
lelek : lelek : (rzecz.) nightjar
lemat : lemat : (rzecz.) lemma
lemiesz : lemiesz : (rzecz.) ploughshare | : (rzecz.) share
leming : leming : (rzecz.) lemming
lemoniada : lemoniada : (rzecz.) lemonade | : (rzecz.) squash
lemur : lemur : (rzecz.) lemur
len : len : (rzecz.) flax | : (rzecz.) linen
leniec : lenieć : (czas.) moult | : (czas.) slough
leninizm : leninizm : (rzecz.) Leninism
lenistwo : lenistwo : (rzecz.) idleness | : (rzecz.) indolence | : (rzecz.) laziness | : (rzecz.) sloth | : (rzecz.) sluggishness
leniuch : leniuch : (rzecz.) lazybones | : (rzecz.) slug | : (rzecz.) sluggard
leniuchowac : leniuchować : (czas.) slack
leniwie : leniwie : (przysł.) idly | : (przysł.) indolently
leniwiec : leniwiec : (rzecz.) sloth
leniwy : leniwy : (przym.) idle | : (przym.) indolent | : (przym.) languid | : (przym.) lazy | : (przym.) slothful | : (przym.) slow | : (przym.) sluggish
lenic : lenić : (czas.) dally | : (czas.) idle
lennictwo : lennictwo : (rzecz.) vassalage
lenniczy : lenniczy : (przym.) liege
lennik : lennik : (rzecz.) feudatory | : (rzecz.) liege | : (rzecz.) vassal
lenno : lenno : (rzecz.) feoff | : (rzecz.) feud | : (rzecz.) feudalism | : (rzecz.) fief
lenny : lenny : (przym.) feudal | : (przym.) liege | : (przym.) seigniorial
lep : lep : (rzecz.) flypaper | : (rzecz.) glue
lepik : lepik : (rzecz.) glue | : (rzecz.) tar
lepiszcze : lepiszcze : (rzecz.) adhesive
lepic : lepić : (czas.) glue
lepki : lepki : (przym.) adhesive | : (przym.) clammy | : (przym.) gluey | : (przym.) glutinous | : (przym.) gooey | : (przym.) gummy | : (przym.) limy | : (przym.) moist | : (przym.) ropy | : (przym.) sticky | : (przym.) tacky | : (przym.) viscid | : (przym.) viscous
lepkosciomierz : lepkościomierz : (rzecz.) viscometer
lepkosc : lepkość : (rzecz.) adhesiveness | : (rzecz.) stickiness | : (rzecz.) viscidity | : (rzecz.) viscosity
leprozorium : leprozorium : (rzecz.) leprosarium
lepszy : lepszy : (przym.) better | : (przym.) preferable
lesbijka : lesbijka : (rzecz.) homosexual | : (rzecz.) lesbian
lesbijski : lesbijski : (przym.) lesbian
leser : leser : (rzecz.) layabout
lesisty : lesisty : (przym.) wooded | : (przym.) woody
less : less : (rzecz.) loess
leszcz : leszcz : (rzecz.) bream
leszczyna : leszczyna : (rzecz.) filbert | : (rzecz.) filbert-tree | : (rzecz.) hazel | : (rzecz.) pecan
letalnosc : letalność : (rzecz.) lethality
letarg : letarg : (rzecz.) lethargy
letargiczny : letargiczny : (przym.) lethargic
letni : letni : (rzecz.) summer | : (rzecz.) summery | : (rzecz.) years
letnik : letnik : (rzecz.) holidaymaker | : (rzecz.) holiday-maker | : (rzecz.) vacationer
letniosc : letniość : (rzecz.) tepidity
letnisko : letnisko : (rzecz.) summer
letniskowy : letniskowy : (przym.) summer
leukemia : leukemia : (rzecz.) leukaemia
leukocyt : leukocyt : (rzecz.) leukocyte
leukoplast : leukoplast : (rzecz.) leucoplast | : (rzecz.) sticking-plaster
lew : lew : (rzecz.) Leo | : (rzecz.) lion
lewacki : lewacki : (przym.) leftist
lewak : lewak : (rzecz.) leftist
lewar : lewar : (rzecz.) hoist | : (rzecz.) jack | : (rzecz.) lever | : (rzecz.) siphon
lewarek : lewarek : (rzecz.) jack
lewatywa : lewatywa : (rzecz.) enema
lewiatan : lewiatan : (rzecz.) leviathan
lewica : lewica : (rzecz.) left-wing
lewicowiec : lewicowiec : (rzecz.) leftist | : (rzecz.) left-winger | : (rzecz.) lefty
lewicowy : lewicowy : (przym.) left | : (przym.) leftist | : (przym.) left-wing
lewitacja : lewitacja : (rzecz.) levitation
lewitowac : lewitować : (czas.) levitate
lewkonia : lewkonia : (rzecz.) gillyflower | : (rzecz.) stock
lewobrzezny : lewobrzeżny : (przym.) left-bank
leworecznosc : leworęczność : (rzecz.) left-handedness
leworeczny : leworęczny : (przym.) left-hand | : (przym.) left-handed | : (przym.) lefthander
leworeki : leworęki : (przym.) left-handed
lewoskretnosc : lewoskrętność : (rzecz.) laevorotation
lewoskretny : lewoskrętny : (przym.) laevorotatory | : (przym.) left-handed | : (przym.) levorotatory
lewostronny : lewostronny : (przym.) left | : (przym.) left-sided
lewuloza : lewuloza : (rzecz.) laevulose
lewy : lewy : (przym.) left | : (przym.) left-hand
len : leń : (rzecz.) dawdler | : (rzecz.) idler | : (rzecz.) layabout | : (rzecz.) lazybones | : (rzecz.) saunter
lesnictwo : leśnictwo : (rzecz.) forester | : (rzecz.) forestry
lesniczy : leśniczy : (rzecz.) forester | : (rzecz.) ranger
lesniczowka : leśniczówka : (rzecz.) forest
lesnik : leśnik : (rzecz.) forester | : (rzecz.) gamekeeper | : (rzecz.) game-keeper | : (rzecz.) woodman | : (rzecz.) woodsman
lesny : leśny : (przym.) sylvan | : (przym.) woodsy | : (przym.) woody
lezc : leźć : (czas.) climb | : (czas.) creep | : (czas.) scramble | : (czas.) shamble
leza : leża : (rzecz.) are
lezak : leżak : (rzecz.) deckchair
lezakowanie : leżakowanie : (rzecz.) seasoning | : (rzecz.) spice
lezakowac : leżakować : (czas.) matured
lezanka : leżanka : (rzecz.) couch | : (rzecz.) recliner
lezec : leżeć : (czas.) lie | : (czas.) lounge | : (czas.) repose | : (czas.) sprawl | : (czas.) underlie
leznia : leżnia : (rzecz.) putlog
lezacy : leżący : (przym.) fitting | : (przym.) recumbent
lgniecie : lgnięcie : (rzecz.) adherence
lgnac : lgnąć : (czas.) adhere | : (czas.) clung | : (czas.) sink
liana : liana : (rzecz.) liana
libacja : libacja : (rzecz.) libation
libella : libella : (rzecz.) level
liberalizacja : liberalizacja : (rzecz.) liberalization
liberalizm : liberalizm : (rzecz.) liberalism
liberalizowac : liberalizować : (czas.) liberalize
liberalnie : liberalnie : (przysł.) liberally
liberalnosc : liberalność : (rzecz.) liberality
liberalny : liberalny : (przym.) broadminded | : (przym.) broad-minded | : (przym.) liberal | : (przym.) liberally-minded
liberal : liberał : (rzecz.) liberal
liberia : liberia : (rzecz.) livery
libertyn : libertyn : (rzecz.) libertine
libertynski : libertyński : (przym.) libertine
libra : libra : (rzecz.) quire
librecista : librecista : (rzecz.) librettist
licealny : licealny : (przym.) secondary-school
licencja : licencja : (rzecz.) franchise | : (rzecz.) licence | : (rzecz.) license
licencjat : licencjat : (rzecz.) bachelor | : (rzecz.) licentiate
licencjobiorca : licencjobiorca : (rzecz.) licensee
licencjodawca : licencjodawca : (rzecz.) licensor
licencjonowac : licencjonować : (czas.) license
liceum : liceum : (rzecz.) lyceum | : (rzecz.) school
lichenina : lichenina : (rzecz.) lichenin
licho : licho : (rzecz.) bogeyman | : (rzecz.) deuce | : (rzecz.) devil | : (rzecz.) evil
lichota : lichota : (rzecz.) muck | : (rzecz.) rubbish
lichosc : lichość : (rzecz.) badness
lichtarz : lichtarz : (rzecz.) candlestick
lichtarzyk : lichtarzyk : (rzecz.) sconce
lichwa : lichwa : (rzecz.) usury
lichwiarstwo : lichwiarstwo : (rzecz.) usury
lichwiarz : lichwiarz : (rzecz.) moneylender | : (rzecz.) money-lender | : (rzecz.) usurer
lichy : lichy : (przym.) bad | : (przym.) lame | : (przym.) poor | : (przym.) potty | : (przym.) ropy | : (przym.) scanty | : (przym.) shabby | : (przym.) shoddy | : (przym.) trumpery | : (przym.) wretched
lico : lico : (rzecz.) face | : (rzecz.) grain
licytacja : licytacja : (rzecz.) auction | : (rzecz.) bid | : (rzecz.) bidding | : (rzecz.) chicane | : (rzecz.) outcry
licytant : licytant : (rzecz.) bidder
licytator : licytator : (rzecz.) auctioneer
licytowanie : licytowanie : (rzecz.) bid | : (rzecz.) bidder
licytowac : licytować : (czas.) auction | : (czas.) bid | : (czas.) declare
liczba : liczba : (rzecz.) amount | : (rzecz.) count | : (rzecz.) figure | : (rzecz.) number
liczbowy : liczbowy : (przym.) numeric | : (przym.) numerical
liczebnik : liczebnik : (rzecz.) number | : (rzecz.) numeral
liczebnosc : liczebność : (rzecz.) number
liczebny : liczebny : (przym.) numeric | : (przym.) numerical
liczenie : liczenie : (rzecz.) calculation | : (rzecz.) count | : (rzecz.) numeration
liczko : liczko : (rzecz.) face
liczman : liczman : (rzecz.) tallyman
licznie : licznie : (przysł.) numerously
licznik : licznik : (rzecz.) clock | : (rzecz.) counter | : (rzecz.) enumerator | : (rzecz.) meter | : (rzecz.) numerator
licznosc : liczność : (rzecz.) cardinality | : (rzecz.) multiplicity | : (rzecz.) numerousness | : (rzecz.) size
liczny : liczny : (przym.) abundant | : (przym.) numerous | : (przym.) plural | : (przym.) several
liczydlo : liczydło : (rzecz.) abacus | : (rzecz.) counter
liczykrupa : liczykrupa : (rzecz.) skinflint
liczyc : liczyć : (czas.) calculate | : (czas.) compute | : (czas.) count | : (czas.) depend | : (czas.) matter | : (czas.) number | : (czas.) reckon | : (czas.) rely | : (czas.) score | : (czas.) tally
lider : lider : (rzecz.) leader
liga : liga : (rzecz.) division | : (rzecz.) league
ligatura : ligatura : (rzecz.) ligature | : (rzecz.) tie
lignina : lignina : (rzecz.) lignin
lignit : lignit : (rzecz.) lignite
ligowiec : ligowiec : (rzecz.) leaguer
ligroina : ligroina : (rzecz.) ligroin
ligustr : ligustr : (rzecz.) privet
likier : likier : (rzecz.) liqueur | : (rzecz.) liquor
liklina : liklina : (rzecz.) bolt-rope
likwidacja : likwidacja : (rzecz.) decommissioning | : (rzecz.) disposal | : (rzecz.) elimination | : (rzecz.) knockout | : (rzecz.) liquidation | : (rzecz.) realisation | : (rzecz.) shutdown
likwidacyjny : likwidacyjny : (przym.) decommissioning
likwidator : likwidator : (rzecz.) liquidator
likwidowac : likwidować : (czas.) abolish | : (czas.) eliminate | : (czas.) liquidate | : (czas.) remove
lila : lila : (przym.) lilac
lilia : lilia : (rzecz.) lily
liliowaty : liliowaty : (przym.) liliaceous
liliowy : liliowy : (przym.) lilac
liliput : liliput : (rzecz.) Lilliputian
limeryk : limeryk : (rzecz.) limerick
limfa : limfa : (rzecz.) lymph
limfatyczny : limfatyczny : (przym.) lymphatic
limfocyt : limfocyt : (rzecz.) lymphocyte
limit : limit : (rzecz.) quota
limitacja : limitacja : (rzecz.) limitation
limnologia : limnologia : (rzecz.) limnology
limonen : limonen : (rzecz.) limonene
limonit : limonit : (rzecz.) limonite
limuzyna : limuzyna : (rzecz.) limo | : (rzecz.) limousine | : (rzecz.) saloon
lina : lina : (rzecz.) cord | : (rzecz.) cordage | : (rzecz.) hawser | : (rzecz.) lariat | : (rzecz.) line | : (rzecz.) rope | : (rzecz.) tether | : (rzecz.) tightrope | : (rzecz.) tight-rope
linczowac : linczować : (czas.) lynch
linearnie : linearnie : (przysł.) linearly
linearnosc : linearność : (rzecz.) linearity
linearny : linearny : (przym.) lineal | : (przym.) linear
linearyzacja : linearyzacja : (rzecz.) linearization
lineal : lineał : (rzecz.) line
lingwista : lingwista : (rzecz.) linguist
lingwistyczny : lingwistyczny : (przym.) linguistic
lingwistyka : lingwistyka : (rzecz.) linguistics
linia : linia : (rzecz.) cable | : (rzecz.) coseismal | : (rzecz.) line | : (rzecz.) rule | : (rzecz.) stroke
liniatura : liniatura : (rzecz.) ruling
linial : liniał : (rzecz.) ruler
linienie : linienie : (rzecz.) moulting
liniec : linieć : (czas.) moult
linijka : linijka : (rzecz.) line | : (rzecz.) master | : (rzecz.) ruler | : (rzecz.) straightedge
linijny : linijny : (przym.) lineal | : (przym.) linear
liniowanie : liniowanie : (rzecz.) lineation | : (rzecz.) lining | : (rzecz.) ruling
liniowac : liniować : (czas.) line
liniowiec : liniowiec : (rzecz.) liner | : (rzecz.) ships
liniowosc : liniowość : (rzecz.) linearity
liniowy : liniowy : (przym.) lineal | : (przym.) linear
linka : linka : (rzecz.) cable | : (rzecz.) lima | : (rzecz.) string
linker : linker : (rzecz.) linker
linociag : linociąg : (rzecz.) hoist
linoleum : linoleum : (rzecz.) linoleum
linoskoczek : linoskoczek : (rzecz.) acrobat | : (rzecz.) equilibrist | : (rzecz.) funambulist | : (rzecz.) ropedancer | : (rzecz.) rope-dancer
linotyp : linotyp : (rzecz.) linotype
linowy : linowy : (przym.) funicular | : (przym.) sheave
lipa : lipa : (rzecz.) humbug | : (rzecz.) lime | : (rzecz.) lime-tree | : (rzecz.) linden
lipaza : lipaza : (rzecz.) lipase
lipid : lipid : (rzecz.) lipoid
lipiec : lipiec : (rzecz.) July
lipien : lipień : (rzecz.) grayling
lipny : lipny : (przym.) faked-up | : (przym.) sham | : (przym.) trashy
lipoid : lipoid : (rzecz.) lipoid
lipoproteidy : lipoproteidy : (przym.) lipoproteins
liposukcja : liposukcja : (rzecz.) liposuction
lir : lir : (rzecz.) lira
lira : lira : (rzecz.) lyre
lirnik : lirnik : (rzecz.) lyrist
lirycznie : lirycznie : (przysł.) lyrically
liryczny : liryczny : (przym.) lyric | : (przym.) lyrical
liryk : liryk : (rzecz.) lyric | : (rzecz.) lyricist | : (rzecz.) lyrist
liryka : liryka : (rzecz.) lyricism
liryzm : liryzm : (rzecz.) lyricism
lis : lis : (rzecz.) fox
lisi : lisi : (przym.) poor | : (przym.) vulpine
lisica : lisica : (rzecz.) vixen
list : list : (rzecz.) letter
lista : lista : (rzecz.) leaf | : (rzecz.) list | : (rzecz.) panel | : (rzecz.) register | : (rzecz.) roll | : (rzecz.) roster | : (rzecz.) schedule | : (rzecz.) scrip
listek : listek : (rzecz.) frond | : (rzecz.) leaf | : (rzecz.) leaflet | : (rzecz.) lobe
listewka : listewka : (rzecz.) slat | : (rzecz.) slip | : (rzecz.) strip
listing : listing : (rzecz.) listing
listonosz : listonosz : (rzecz.) mailman | : (rzecz.) postman
listopad : listopad : (rzecz.) November
listowie : listowie : (rzecz.) foliage | : (rzecz.) frondescence | : (rzecz.) leafage | : (rzecz.) leaves
listowy : listowy : (przym.) epistolary
listwa : listwa : (rzecz.) batten | : (rzecz.) bezel | : (rzecz.) lath | : (rzecz.) ledge | : (rzecz.) skirting-board | : (rzecz.) slat
liszaj : liszaj : (rzecz.) herpes | : (rzecz.) lichen | : (rzecz.) ringworm
liszajec : liszajec : (rzecz.) impetigo
liszka : liszka : (rzecz.) caterpillar | : (rzecz.) vixen
lit : lit : (rzecz.) lithium | : (rzecz.) point
litania : litania : (rzecz.) litany | : (rzecz.) rogation
litera : litera : (rzecz.) char | : (rzecz.) character | : (rzecz.) letter | : (rzecz.) point
literacki : literacki : (przym.) literary
literalnie : literalnie : (przysł.) literally
literalny : literalny : (przym.) literal
literat : literat : (rzecz.) literal | : (rzecz.) penman | : (rzecz.) writer
literatura : literatura : (rzecz.) letter | : (rzecz.) literature | : (rzecz.) reading
literaturoznawstwo : literaturoznawstwo : (rzecz.) literature
literal : literał : (rzecz.) literal | : (rzecz.) literals
liternictwo : liternictwo : (rzecz.) lettering
literowanie : literowanie : (rzecz.) spelling
literowac : literować : (czas.) spell
literowo-cyfrowy : literowo-cyfrowy : (przym.) alphabetic-numeric | : (przym.) alphanumeric | : (przym.) alphanumerical
literowy : literowy : (przym.) alphabetic | : (przym.) alphabetical | : (przym.) literal
literowka : literówka : (rzecz.) misprint | : (rzecz.) typo
litograf : litograf : (rzecz.) lithographer
litografia : litografia : (rzecz.) lithograph | : (rzecz.) lithography
litograficzny : litograficzny : (przym.) lithographic | : (przym.) lithographical
litografowac : litografować : (czas.) lithograph
litopon : litopon : (rzecz.) lithopone
litoralny : litoralny : (przym.) littoral
litosfera : litosfera : (rzecz.) lithosphere
litowanie : litowanie : (rzecz.) lithium
litowac : litować : (czas.) pity
litosciwie : litościwie : (przysł.) pitifully | : (przysł.) pityingly
litosciwy : litościwy : (przym.) charitable | : (przym.) compassionate | : (przym.) merciful | : (przym.) pitiful | : (przym.) pitying
litosc : litość : (rzecz.) compassion | : (rzecz.) mercy | : (rzecz.) pity
litr : litr : (rzecz.) litre
litroatmosfera : litroatmosfera : (rzecz.) litre-atmosphere
liturgia : liturgia : (rzecz.) liturgy
liturgicznie : liturgicznie : (przysł.) liturgically
liturgiczny : liturgiczny : (przym.) liturgical
lity : lity : (przym.) molten
lizak : lizak : (rzecz.) lollipop | : (rzecz.) lollypop
lizanie : lizanie : (rzecz.) licking
lizawka : lizawka : (rzecz.) deer-lick
lizac : lizać : (czas.) lick
lizol : lizol : (rzecz.) Lysol
lizus : lizus : (rzecz.) bootlicker | : (rzecz.) lickspittle | : (rzecz.) spaniel | : (rzecz.) toady
lizyna : lizyna : (rzecz.) lysine
lisciasty : liściasty : (przym.) deciduous | : (przym.) leafiest | : (przym.) leafy | : (przym.) leaved
liscien : liścień : (rzecz.) cotyledon
lisc : liść : (rzecz.) blade | : (rzecz.) leaf
lizniecie : liźnięcie : (rzecz.) lick
lniany : lniany : (przym.) flaxen | : (przym.) linen
lobby : lobby : (rzecz.) lobby
lobotomia : lobotomia : (rzecz.) lobotomy
locha : locha : (rzecz.) sow
lodowaciec : lodowacieć : (czas.) freeze
lodowatosc : lodowatość : (rzecz.) frigidity | : (rzecz.) frigidness | : (rzecz.) frostiness | : (rzecz.) iciness
lodowaty : lodowaty : (przym.) chilling | : (przym.) freezing | : (przym.) frosty | : (przym.) gelid | : (przym.) glacial | : (przym.) ice-cold | : (przym.) icy | : (przym.) wintry
lodowcowy : lodowcowy : (przym.) glacial
lodowiec : lodowiec : (rzecz.) glacier
lodowisko : lodowisko : (rzecz.) ice | : (rzecz.) ice-rink | : (rzecz.) rink | : (rzecz.) skating-rink
lodowy : lodowy : (przym.) freezing | : (przym.) glacial | : (przym.) icy
lodolam : lodołam : (rzecz.) cutwater
lodolamacz : lodołamacz : (rzecz.) icebreaker
lodziarz : lodziarz : (rzecz.) iceman
lodowka : lodówka : (rzecz.) fridge | : (rzecz.) icebox | : (rzecz.) ice-box | : (rzecz.) meat-safe | : (rzecz.) reefer | : (rzecz.) refrigerator
lodzia : lodżia : (rzecz.) boat | : (rzecz.) loggia
logarytm : logarytm : (rzecz.) logarithm
logarytmicznie : logarytmicznie : (przysł.) logarithmically
logarytmiczny : logarytmiczny : (przym.) logarithmic
loggia : loggia : (rzecz.) loggia
logicznie : logicznie : (przysł.) logically
logicznosc : logiczność : (rzecz.) consistency | : (rzecz.) logicality
logiczny : logiczny : (przym.) Boolean | : (przym.) consequent | : (przym.) consequential | : (przym.) logic | : (przym.) logical
logik : logik : (rzecz.) logician
logika : logika : (rzecz.) logic | : (rzecz.) logician
login : login : (rzecz.) login | : (rzecz.) logon
logistycznie : logistycznie : (przysł.) logistically
logistyczny : logistyczny : (przym.) logistic | : (przym.) logistical
logistyka : logistyka : (rzecz.) logistic | : (rzecz.) logistics
loglina : loglina : (rzecz.) log-line
logopeda : logopeda : (rzecz.) speech
logotyp : logotyp : (rzecz.) logotype
logowanie : logowanie : (rzecz.) logging | : (rzecz.) login
lojalista : lojalista : (rzecz.) loyalist
lojalnie : lojalnie : (przysł.) loyally | : (przysł.) truly
lojalnosc : lojalność : (rzecz.) allegiance | : (rzecz.) constancy | : (rzecz.) fealty | : (rzecz.) loyalty
lojalny : lojalny : (przym.) clannish | : (przym.) faithful | : (przym.) liege | : (przym.) loyal | : (przym.) stalwart | : (przym.) stanch | : (przym.) true-blue
lok : lok : (rzecz.) curl | : (rzecz.) lock
lokacja : lokacja : (rzecz.) location
lokaj : lokaj : (rzecz.) butler | : (rzecz.) flunkey | : (rzecz.) footman | : (rzecz.) lackey | : (rzecz.) valet
lokajski : lokajski : (przym.) fulsome | : (przym.) lackey's
lokal : lokal : (rzecz.) place | : (rzecz.) premise | : (rzecz.) premises
lokalizacja : lokalizacja : (rzecz.) localization | : (rzecz.) location
lokalizator : lokalizator : (rzecz.) localizer | : (rzecz.) locator
lokalizowac : lokalizować : (czas.) localize | : (czas.) locate | : (czas.) pinpoint
lokalnie : lokalnie : (przysł.) indigenously | : (przysł.) locally
lokalnosc : lokalność : (rzecz.) location
lokalny : lokalny : (przym.) local
lokata : lokata : (rzecz.) deposit | : (rzecz.) investment | : (rzecz.) pizza | : (rzecz.) place
lokator : lokator : (rzecz.) inmate | : (rzecz.) lodger | : (rzecz.) occupant | : (rzecz.) occupier | : (rzecz.) tenant
lokaut : lokaut : (rzecz.) lock | : (rzecz.) locknut | : (rzecz.) lockout | : (rzecz.) lock-out | : (rzecz.) turnout
lokomocja : lokomocja : (rzecz.) locomotion
lokomotywa : lokomotywa : (rzecz.) engine | : (rzecz.) locomotion | : (rzecz.) locomotive
lokowac : lokować : (czas.) place
lokum : lokum : (rzecz.) lodgings | : (rzecz.) venue
lokowka : lokówka : (rzecz.) curler | : (rzecz.) curling-pin
lombard : lombard : (rzecz.) hockshop | : (rzecz.) pawnshop | : (rzecz.) pledge
lont : lont : (rzecz.) fuse | : (rzecz.) match
lonza : lonża : (rzecz.) lunge
lora : lora : (rzecz.) lorry | : (rzecz.) truck
lord : lord : (rzecz.) lord
lorens : lorens : (rzecz.) lawrencium
lorgnon : lorgnon : (rzecz.) lorgnette
lorneta : lorneta : (rzecz.) binocular | : (rzecz.) binoculars
lornetka : lornetka : (rzecz.) binocular | : (rzecz.) binoculars | : (rzecz.) lorgnette
los : los : (rzecz.) destiny | : (rzecz.) doom | : (rzecz.) fate | : (rzecz.) fortune | : (rzecz.) karma | : (rzecz.) lot
losowanie : losowanie : (rzecz.) drawing | : (rzecz.) sampling
losowac : losować : (czas.) randomize
losowo : losowo : (przysł.) randomly
losowosc : losowość : (rzecz.) randomization | : (rzecz.) randomized | : (rzecz.) randomness
losowy : losowy : (przym.) fateful | : (przym.) random | : (przym.) randomized
loszka : loszka : (rzecz.) gilt
lot : lot : (rzecz.) flight
loteria : loteria : (rzecz.) lottery | : (rzecz.) raffle | : (rzecz.) sweepstake | : (rzecz.) sweepstakes
loteryjka : loteryjka : (rzecz.) bingo | : (rzecz.) lotto
lotka : lotka : (rzecz.) aileron | : (rzecz.) flag | : (rzecz.) flight | : (rzecz.) flight-feather | : (rzecz.) pinion | : (rzecz.) quill | : (rzecz.) shuttlecock
lotnia : lotnia : (rzecz.) glider | : (rzecz.) hang-glider
lotniarstwo : lotniarstwo : (rzecz.) hang-gliding
lotniarz : lotniarz : (rzecz.) glider | : (rzecz.) hang-glider
lotnictwo : lotnictwo : (rzecz.) aeronautics | : (rzecz.) aerospace | : (rzecz.) aviation
lotniczy : lotniczy : (przym.) aerial | : (przym.) aeronautical | : (przym.) airborne | : (przym.) airtime
lotnik : lotnik : (rzecz.) airman | : (rzecz.) airwoman | : (rzecz.) aviator | : (rzecz.) flier | : (rzecz.) flyer | : (rzecz.) pilot
lotnisko : lotnisko : (rzecz.) aerodrome | : (rzecz.) airdrome | : (rzecz.) airfield | : (rzecz.) airport
lotnosc : lotność : (rzecz.) airworthiness | : (rzecz.) fugacity | : (rzecz.) vivacity | : (rzecz.) volatility
lotny : lotny : (przym.) ethereal | : (przym.) gaseous | : (przym.) volatile
lotos : lotos : (rzecz.) lotus
lotus : lotus : (rzecz.) lotus
loza : loża : (rzecz.) box | : (rzecz.) general | : (rzecz.) lodge
lub : lub : (spójnik) or
luba : luba : (rzecz.) love
lubieznie : lubieżnie : (przysł.) lewdly
lubieznik : lubieżnik : (rzecz.) lecher | : (rzecz.) voluptuary
lubieznosc : lubieżność : (rzecz.) lechery | : (rzecz.) lust | : (rzecz.) prurience
lubiezny : lubieżny : (przym.) lascivious | : (przym.) lecherous | : (przym.) lewd | : (przym.) libidinous | : (przym.) lickerish | : (przym.) lustful | : (przym.) prurient | : (przym.) raunchy | : (przym.) salacious | : (przym.) sensual | : (przym.) voluptuous
lubic : lubić : (czas.) cherish | : (czas.) enjoy | : (czas.) like | : (czas.) love | : (czas.) relish
lubowac : lubować : (czas.) delight
lubosc : lubość : (rzecz.) delight
lubrykator : lubrykator : (rzecz.) lubricator
luby : luby : (przym.) beloved
lucerna : lucerna : (rzecz.) alfalfa | : (rzecz.) nonesuch
lud : lud : (rzecz.) commons | : (rzecz.) folk | : (rzecz.) nation | : (rzecz.) people | : (rzecz.) populace
ludnosc : ludność : (rzecz.) population
ludny : ludny : (przym.) overcrowded | : (przym.) populous
ludobojca : ludobójca : (rzecz.) genocide
ludobojstwo : ludobójstwo : (rzecz.) genocide
ludojad : ludojad : (rzecz.) eater | : (rzecz.) man-eater | : (rzecz.) ogre
ludowosc : ludowość : (rzecz.) folksiness
ludowy : ludowy : (przym.) folk | : (przym.) folksy | : (przym.) people's | : (przym.) popular
ludowladztwo : ludowładztwo : (rzecz.) democracy
ludoznawstwo : ludoznawstwo : (rzecz.) ethnography | : (rzecz.) ethnology
ludozerca : ludożerca : (rzecz.) cannibal | : (rzecz.) eater | : (rzecz.) man-eater | : (rzecz.) ogle | : (rzecz.) ogre
ludozerczy : ludożerczy : (przym.) anthropophagous | : (przym.) cannibalistic
ludozerstwo : ludożerstwo : (rzecz.) cannibalism
ludwisarnia : ludwisarnia : (rzecz.) bell-foundry
ludwisarz : ludwisarz : (rzecz.) bell-founder
ludzie : ludzie : (rzecz.) people
ludzik : ludzik : (rzecz.) man
ludzki : ludzki : (przym.) human | : (przym.) humane | : (przym.) manlike
ludzko : ludzko : (przysł.) humanly
ludzkosc : ludzkość : (rzecz.) humanity | : (rzecz.) humankind | : (rzecz.) mankind
lufa : lufa : (rzecz.) barrel
lufka : lufka : (rzecz.) cigarette-holder
lugier : lugier : (rzecz.) drifter | : (rzecz.) gluier
luizyt : luizyt : (rzecz.) lewisite
luk : luk : (rzecz.) hatch | : (rzecz.) hatchway | : (rzecz.) skylight
luka : luka : (rzecz.) blackout | : (rzecz.) blank | : (rzecz.) breach | : (rzecz.) gap | : (rzecz.) hiatus | : (rzecz.) void
lukier : lukier : (rzecz.) frosting | : (rzecz.) icing
lukratywnie : lukratywnie : (przysł.) lucratively | : (przysł.) profitably
lukratywny : lukratywny : (przym.) lucrative
lukrecja : lukrecja : (rzecz.) liquorice
lukrowac : lukrować : (czas.) ice | : (czas.) sugar-coat
luks : luks : (rzecz.) metre-candle
luksomierz : luksomierz : (rzecz.) illuminometer
luksus : luksus : (rzecz.) luxury
luksusowo : luksusowo : (przysł.) extravagantly | : (przysł.) luxuriously
luksusowy : luksusowy : (przym.) deluxe | : (przym.) extra | : (przym.) luxurious | : (przym.) plush | : (przym.) ritzy
lulka : lulka : (rzecz.) bowl | : (rzecz.) pipe
lumen : lumen : (rzecz.) lumen
lumenogodzina : lumenogodzina : (rzecz.) lumen-hour
lumenosekunda : lumenosekunda : (rzecz.) lumen-second
luminancja : luminancja : (rzecz.) brilliance | : (rzecz.) luminance | : (rzecz.) radiance
luminarz : luminarz : (rzecz.) luminary
luminescencja : luminescencja : (rzecz.) luminescence
luminescencyjny : luminescencyjny : (przym.) luminescent
luminofor : luminofor : (rzecz.) phosphor
lumityp : lumityp : (rzecz.) photon
lump : lump : (rzecz.) reveller
lumpowac : lumpować : (czas.) revel
lunacja : lunacja : (rzecz.) lunation
lunatyczka : lunatyczka : (rzecz.) sleepwalker
lunatyczny : lunatyczny : (przym.) loony | : (przym.) somnambulistic
lunatyk : lunatyk : (rzecz.) lunatic | : (rzecz.) nightwalker | : (rzecz.) night-walker | : (rzecz.) sleepwalker | : (rzecz.) sleep-walker | : (rzecz.) somnambulist
lunatyzm : lunatyzm : (rzecz.) sleep-walking | : (rzecz.) somnambulism
lunch : lunch : (rzecz.) lunch | : (rzecz.) luncheon
luneta : luneta : (rzecz.) field-glass | : (rzecz.) lunette | : (rzecz.) telescope
lupa : lupa : (rzecz.) magnifier
lura : lura : (rzecz.) dishwater | : (rzecz.) slops | : (rzecz.) swill | : (rzecz.) wish-wash
lusterko : lusterko : (rzecz.) looking-glass | : (rzecz.) mirror | : (rzecz.) speculum
lustracja : lustracja : (rzecz.) inspection | : (rzecz.) survey
lustrator : lustrator : (rzecz.) inspector
lustro : lustro : (rzecz.) looking-glass | : (rzecz.) mirror | : (rzecz.) speculum
lustrowac : lustrować : (czas.) inspect | : (czas.) vet
lut : lut : (rzecz.) solder
luteranizm : luteranizm : (rzecz.) Lutheranism
lutet : lutet : (rzecz.) lutetium
lutnia : lutnia : (rzecz.) lute
lutowanie : lutowanie : (rzecz.) solder
lutowac : lutować : (czas.) braze | : (czas.) solder
lutowie : lutowie : (rzecz.) solder
lutownica : lutownica : (rzecz.) soldering-iron
luty : luty : (rzecz.) February
luz : luz : (rzecz.) backlash | : (rzecz.) clearance | : (rzecz.) letup | : (rzecz.) let-up | : (rzecz.) looseness | : (rzecz.) play | : (rzecz.) relaxation
luzem : luzem : (przysł.) freely | : (przysł.) separately
luzowac : luzować : (czas.) loosen | : (czas.) relay | : (czas.) relieve | : (czas.) slacken | : (czas.) veer
luzno : luźno : (przysł.) loosely | : (przysł.) loosely-coupled
luznosc : luźność : (rzecz.) looseness
luzny : luźny : (przym.) baggy | : (przym.) casual | : (przym.) lax | : (przym.) loose | : (przym.) loosest | : (przym.) occasional | : (przym.) relaxed | : (przym.) slack
lwi : lwi : (przym.) leonine | : (przym.) lion's
lwica : lwica : (rzecz.) lioness
lod : lód : (rzecz.) ice | : (rzecz.) ice-cream
lad : ląd : (rzecz.) continent | : (rzecz.) land | : (rzecz.) landmass
ladem : lądem : (przysł.) overland
ladowanie : lądowanie : (rzecz.) debarkation | : (rzecz.) descent | : (rzecz.) landing
ladowac : lądować : (czas.) alight | : (czas.) disembark | : (czas.) land | : (czas.) load
ladowe : lądowe : (rzecz.) land
ladowisko : lądowisko : (rzecz.) airfield | : (rzecz.) airstrip | : (rzecz.) landfall
ladowy : lądowy : (przym.) land-based | : (przym.) overland | : (przym.) terrestrial
lag : ląg : (rzecz.) brood
ledzwie : lędźwie : (rzecz.) loin | : (rzecz.) loins | : (rzecz.) rein | : (rzecz.) reins
ledzwiowy : lędźwiowy : (przym.) lumbar
leg : lęg : (rzecz.) leg
legnia : lęgnia : (rzecz.) pillar
legniecie : lęgnięcie : (rzecz.) pillar
legnac : lęgnąć : (czas.) arise | : (czas.) bud | : (czas.) hatch
legowisko : lęgowisko : (rzecz.) lie
lek : lęk : (rzecz.) anguish | : (rzecz.) anxiety | : (rzecz.) apprehension | : (rzecz.) dread | : (rzecz.) fear | : (rzecz.) phobia | : (rzecz.) trepidation
lekac : lękać : (czas.) fear | : (czas.) quail
lekliwosc : lękliwość : (rzecz.) bashfulness
lekliwy : lękliwy : (przym.) apprehensive | : (przym.) bashful | : (przym.) fearful | : (przym.) pusillanimous | : (przym.) timid | : (przym.) timorous
lsnienie : lśnienie : (rzecz.) gleam | : (rzecz.) glitter | : (rzecz.) shimmer
lsniacy : lśniący : (przym.) glossy | : (przym.) lucent | : (przym.) lucid | : (przym.) luminous | : (przym.) resplendent | : (przym.) shiny | : (przym.) sleek
lsnic : lśnić : (czas.) glisten | : (czas.) glitter | : (czas.) shimmer | : (czas.) shine | : (czas.) star
lzenie : lżenie : (rzecz.) abusing | : (rzecz.) abusiveness | : (rzecz.) vituperation
lzyc : lżyć : (czas.) insult | : (czas.) inveigh | : (czas.) revile | : (czas.) vituperate
labedzi : łabędzi : (przym.) swanlike
labedz : łabędź : (rzecz.) cob | : (rzecz.) swan
lach : łach : (rzecz.) gear | : (rzecz.) rag
lachman : łachman : (rzecz.) rag | : (rzecz.) raggedness | : (rzecz.) tatter
lachmaniarz : łachmaniarz : (rzecz.) ragamuffin
lachudra : łachudra : (rzecz.) dastard
laciaty : łaciaty : (przym.) piebald | : (przym.) pinto
lad : ład : (rzecz.) order | : (rzecz.) peace
ladnie : ładnie : (przysł.) handsomely | : (przysł.) nicely | : (przysł.) prettily
ladny : ładny : (przym.) beautiful | : (przym.) cute | : (przym.) fine | : (przym.) handsome | : (przym.) nice | : (przym.) pretty | : (przym.) snug | : (przym.) tidy
ladowacz : ładowacz : (rzecz.) filler | : (rzecz.) loader
ladowalny : ładowalny : (przym.) chargeable | : (przym.) loadable | : (przym.) rechargeable
ladowanie : ładowanie : (rzecz.) bootstrap | : (rzecz.) embarkation | : (rzecz.) load | : (rzecz.) loading
ladowarka : ładowarka : (rzecz.) charger | : (rzecz.) loader
ladowac : ładować : (czas.) alight | : (czas.) boot | : (czas.) charge | : (czas.) embark | : (czas.) emplane | : (czas.) entrain | : (czas.) freight | : (czas.) lade | : (czas.) load | : (czas.) stow
ladownia : ładownia : (rzecz.) hold
ladownica : ładownica : (rzecz.) belt
ladownik : ładownik : (rzecz.) charger | : (rzecz.) loader
ladownosc : ładowność : (rzecz.) capacity | : (rzecz.) carload | : (rzecz.) payload
ladowny : ładowny : (przym.) capacious | : (przym.) loaded
ladunek : ładunek : (rzecz.) bootstrap | : (rzecz.) cargo | : (rzecz.) charge | : (rzecz.) flotsam | : (rzecz.) freight | : (rzecz.) lading | : (rzecz.) load | : (rzecz.) payload | : (rzecz.) shipment
lagiewka : łagiewka : (rzecz.) utricle
lagodnie : łagodnie : (przysł.) gently | : (przysł.) leniently | : (przysł.) lusciously | : (przysł.) meekly | : (przysł.) mildly | : (przysł.) placidly | : (przysł.) softly
lagodniec : łagodnieć : (czas.) mellow | : (czas.) relent | : (czas.) soften | : (czas.) subside
lagodnosc : łagodność : (rzecz.) amenity | : (rzecz.) clemency | : (rzecz.) gentleness | : (rzecz.) lenience | : (rzecz.) leniency | : (rzecz.) meekness | : (rzecz.) mildness | : (rzecz.) placidity | : (rzecz.) pleasantness | : (rzecz.) softness
lagodny : łagodny : (przym.) benign | : (przym.) benignant | : (przym.) bland | : (przym.) clement | : (przym.) easeful | : (przym.) genial | : (przym.) gentle | : (przym.) gentlest | : (przym.) graceful | : (przym.) kind | : (przym.) lenient | : (przym.) light | : (przym.) meek | : (przym.) mellow | : (przym.) mild | : (przym.) placid | : (przym.) smooth | : (przym.) smooth-tempered | : (przym.) soft | : (przym.) suave | : (przym.) tame
lagodzenie : łagodzenie : (rzecz.) attenuation | : (rzecz.) mitigation | : (rzecz.) temper
lagodzic : łagodzić : (czas.) alleviate | : (czas.) appease | : (czas.) assuage | : (czas.) attenuate | : (czas.) commute | : (czas.) deaden | : (czas.) ease | : (czas.) extenuate | : (czas.) heal | : (czas.) mitigate | : (czas.) moderate | : (czas.) mollify | : (czas.) placate | : (czas.) qualify | : (czas.) salve | : (czas.) sleek | : (czas.) soften | : (czas.) soothe
lagodzaco : łagodząco : (przysł.) soothingly
lagodzacy : łagodzący : (przym.) palliative
lajac : łajać : (czas.) blame | : (czas.) rate | : (czas.) scold | : (czas.) upbraid
lajdacki : łajdacki : (przym.) blackguard | : (przym.) knavish | : (przym.) roguish
lajdacko : łajdacko : (przysł.) villainously
lajdactwo : łajdactwo : (rzecz.) knavery | : (rzecz.) rag-tag | : (rzecz.) skulduggery | : (rzecz.) villainy
lajdaczyc : łajdaczyć : (czas.) revel
lajdak : łajdak : (rzecz.) blackguard | : (rzecz.) knave | : (rzecz.) rake | : (rzecz.) rascal | : (rzecz.) rogue | : (rzecz.) scamp | : (rzecz.) scoundrel | : (rzecz.) villain | : (rzecz.) wretch
lajno : łajno : (rzecz.) droppings | : (rzecz.) dune | : (rzecz.) dung
laknienie : łaknienie : (rzecz.) appetite | : (rzecz.) craving | : (rzecz.) hunger
lakocie : łakocie : (rzecz.) candy | : (rzecz.) sweets | : (rzecz.) tuck
lakomczuch : łakomczuch : (rzecz.) glutton | : (rzecz.) gourmand
lakomic : łakomić : (czas.) covet
lakomstwo : łakomstwo : (rzecz.) gluttony | : (rzecz.) gourmandise | : (rzecz.) greed | : (rzecz.) greediness
lakomy : łakomy : (przym.) greedy | : (przym.) insatiate | : (przym.) lickerish
lam : łam : (rzecz.) column
lamacz : łamacz : (rzecz.) breaker | : (rzecz.) maker-up
lamaga : łamaga : (rzecz.) manta | : (rzecz.) muff
lamanie : łamanie : (rzecz.) breakage | : (rzecz.) breaking | : (rzecz.) formatting | : (rzecz.) infringement | : (rzecz.) violations
lamac : łamać : (czas.) break | : (czas.) falter | : (czas.) fracture | : (czas.) infringe | : (czas.) refract
lamiglowka : łamigłówka : (rzecz.) jigsaw | : (rzecz.) poser | : (rzecz.) puzzle
lamistrajk : łamistrajk : (rzecz.) blacking | : (rzecz.) blackleg | : (rzecz.) fink | : (rzecz.) scab | : (rzecz.) strike-breaker
lamliwosc : łamliwość : (rzecz.) brittleness | : (rzecz.) fragility | : (rzecz.) frangibility
lamliwy : łamliwy : (przym.) breakable | : (przym.) brittle | : (przym.) fragile | : (przym.) frangible
lan : łan : (rzecz.) corn | : (rzecz.) feoff | : (rzecz.) field
lania : łania : (rzecz.) action | : (rzecz.) deer | : (rzecz.) doe | : (rzecz.) hind | : (rzecz.) roe
lapa : łapa : (rzecz.) clamp | : (rzecz.) claw | : (rzecz.) leg | : (rzecz.) paw
lapacz : łapacz : (rzecz.) catcher
lapadlo : łapadło : (rzecz.) gripper
lapanka : łapanka : (rzecz.) raid | : (rzecz.) roundup | : (rzecz.) round-up
lapac : łapać : (czas.) catch | : (czas.) grasp | : (czas.) nab | : (czas.) snatch | : (czas.) trammel
lapczywie : łapczywie : (przysł.) greedily | : (przysł.) hungrily
lapczywosc : łapczywość : (rzecz.) avidity | : (rzecz.) greediness
lapczywy : łapczywy : (przym.) grasping | : (przym.) greedy
lapiduch : łapiduch : (rzecz.) sawbones
lapownictwo : łapownictwo : (rzecz.) bribery | : (rzecz.) bribing | : (rzecz.) corruptibility
lapownik : łapownik : (rzecz.) grafter
lapserdak : łapserdak : (rzecz.) tatterdemalion
lapy : łapy : (rzecz.) claws
lapowka : łapówka : (rzecz.) bribe | : (rzecz.) douceur | : (rzecz.) graft | : (rzecz.) kickback | : (rzecz.) payoff | : (rzecz.) payola | : (rzecz.) sop
lapowkarstwo : łapówkarstwo : (rzecz.) bribery
lapowkarz : łapówkarz : (rzecz.) briber | : (rzecz.) grafter
lasica : łasica : (rzecz.) weasel
lasic : łasić : (czas.) fawn
laska : łaska : (rzecz.) boon | : (rzecz.) clemency | : (rzecz.) favour | : (rzecz.) grace | : (rzecz.) indulgence | : (rzecz.) mercy | : (rzecz.) quarter
laskawie : łaskawie : (przysł.) condescendingly | : (przysł.) graciously | : (przysł.) kindly
laskawosc : łaskawość : (rzecz.) graciousness | : (rzecz.) kindness
laskawy : łaskawy : (przym.) benevolent | : (przym.) bland | : (przym.) clement | : (przym.) favourable | : (przym.) gracious | : (przym.) indulgent | : (przym.) kind | : (przym.) kindly | : (przym.) placid | : (przym.) propitious
laskotanie : łaskotanie : (rzecz.) tickle | : (rzecz.) tickling
laskotac : łaskotać : (czas.) tickle | : (czas.) titillate
laskotliwy : łaskotliwy : (przym.) ticklish
lasowac : łasować : (czas.) crumble
lasuch : łasuch : (rzecz.) gourmand
lasy : łasy : (przym.) broad | : (przym.) greedy
lata : łata : (rzecz.) lath | : (rzecz.) patch | : (rzecz.) scantling
latacz : łatacz : (rzecz.) cobbler
latanie : łatanie : (rzecz.) lathing
latanina : łatanina : (rzecz.) mending | : (rzecz.) patchwork
latac : łatać : (czas.) cobble | : (czas.) mend | : (czas.) patch | : (czas.) piece
latek : łatek : (rzecz.) patches
latka : łatka : (rzecz.) patch
latwizna : łatwizna : (rzecz.) breeze | : (rzecz.) cinch | : (rzecz.) pushover | : (rzecz.) quickie
latwo : łatwo : (przysł.) easily | : (przysł.) easy | : (przysł.) facilely | : (przysł.) handily | : (przysł.) limply | : (przysł.) readily | : (przysł.) simply | : (przysł.) swimmingly
latwopalnosc : łatwopalność : (rzecz.) flammability
latwopalny : łatwopalny : (przym.) combustible | : (przym.) flammable | : (przym.) fusible | : (przym.) incendiary | : (przym.) inflammable
latwowiernie : łatwowiernie : (przysł.) credulously
latwowiernosc : łatwowierność : (rzecz.) credulity | : (rzecz.) gullibility
latwowierny : łatwowierny : (przym.) credulous | : (przym.) gullible | : (przym.) simpleminded | : (przym.) simple-minded | : (przym.) wide-eyed
latwosc : łatwość : (rzecz.) ease | : (rzecz.) easiness | : (rzecz.) facility | : (rzecz.) simplicities | : (rzecz.) simplicity
latwy : łatwy : (przym.) amicable | : (przym.) cushy | : (przym.) easy | : (przym.) effortless | : (przym.) facile | : (przym.) simple | : (przym.) tractable
lawa : ława : (rzecz.) bench | : (rzecz.) dock
lawica : ławica : (rzecz.) bank | : (rzecz.) cay | : (rzecz.) school | : (rzecz.) shoal
lawka : ławka : (rzecz.) bench | : (rzecz.) desk | : (rzecz.) form | : (rzecz.) pew
lawkowy : ławkowy : (przym.) benched
lawnik : ławnik : (rzecz.) alderman | : (rzecz.) juror | : (rzecz.) magistrate
lazienka : łazienka : (rzecz.) bathroom
lazik : łazik : (rzecz.) jeep | : (rzecz.) loafer | : (rzecz.) loiterer | : (rzecz.) tramp
lazikowac : łazikować : (czas.) loiter
lazic : łazić : (czas.) mooch | : (czas.) saunter | : (czas.) stride | : (czas.) traipse
lazega : łazęga : (rzecz.) gadabout
lancuch : łańcuch : (rzecz.) chain | : (rzecz.) range | : (rzecz.) string | : (rzecz.) tether
lancuchowy : łańcuchowy : (przym.) aliphatic
lancuszek : łańcuszek : (rzecz.) chain | : (rzecz.) lancet
laznia : łaźnia : (rzecz.) bagnio | : (rzecz.) bath
leb : łeb : (rzecz.) frontlet | : (rzecz.) head | : (rzecz.) noggin
lebski : łebski : (przym.) clever
lechtaczka : łechtaczka : (rzecz.) clitoris
lechtanie : łechtanie : (rzecz.) titillation
lechtac : łechtać : (czas.) tickle | : (czas.) titillate
lechtliwy : łechtliwy : (przym.) ticklish
lepetyna : łepetyna : (rzecz.) head
lgarstwo : łgarstwo : (rzecz.) deceit
lgarz : łgarz : (rzecz.) fabricator | : (rzecz.) fibber | : (rzecz.) liar
lgac : łgać : (czas.) boast | : (czas.) brag | : (czas.) lie
lkac : łkać : (czas.) sob | : (czas.) whimper
lobuz : łobuz : (rzecz.) hooligan | : (rzecz.) pickle | : (rzecz.) rapscallion | : (rzecz.) rascal | : (rzecz.) rogue | : (rzecz.) roughneck | : (rzecz.) urchin
lobuzerka : łobuzerka : (rzecz.) mischief
lobuzerski : łobuzerski : (przym.) nocuous | : (przym.) rascally | : (przym.) roguish
lobuzersko : łobuzersko : (przysł.) archly | : (przysł.) roguishly
lobuzerstwo : łobuzerstwo : (rzecz.) devilment | : (rzecz.) rascality
lobuziak : łobuziak : (rzecz.) dickens | : (rzecz.) scapegrace
lodyga : łodyga : (rzecz.) haulm | : (rzecz.) shaft | : (rzecz.) stalk | : (rzecz.) stem
lojowy : łojowy : (przym.) sebaceous
lokiec : łokieć : (rzecz.) cubit | : (rzecz.) elbow | : (rzecz.) ell
lom : łom : (rzecz.) crowbar | : (rzecz.) crow-bar | : (rzecz.) fragment | : (rzecz.) jimmy
lomot : łomot : (rzecz.) clangour | : (rzecz.) crowbar | : (rzecz.) thud
lomotac : łomotać : (czas.) batter
lono : łono : (rzecz.) bosom | : (rzecz.) bosoms | : (rzecz.) lap | : (rzecz.) pubes | : (rzecz.) womb
lonowy : łonowy : (przym.) pubic
lopata : łopata : (rzecz.) battledore | : (rzecz.) shovel | : (rzecz.) spade
lopatka : łopatka : (rzecz.) blade | : (rzecz.) blade-bone | : (rzecz.) paddle | : (rzecz.) scapula | : (rzecz.) shoulder | : (rzecz.) spade | : (rzecz.) spatula | : (rzecz.) trowel | : (rzecz.) vane
lopatkowy : łopatkowy : (przym.) scapular
lopian : łopian : (rzecz.) burdock
lopot : łopot : (rzecz.) flap
lopotanie : łopotanie : (rzecz.) flapping
loskot : łoskot : (rzecz.) bluster | : (rzecz.) boom | : (rzecz.) clangour | : (rzecz.) clatter | : (rzecz.) din | : (rzecz.) racket | : (rzecz.) rattle | : (rzecz.) thud
losos : łosoś : (rzecz.) kipper | : (rzecz.) salmon
lotr : łotr : (rzecz.) knave | : (rzecz.) rascal | : (rzecz.) ruffian | : (rzecz.) scoundrel | : (rzecz.) thief | : (rzecz.) villain | : (rzecz.) wretch
lotrostwo : łotrostwo : (rzecz.) knavery | : (rzecz.) villainy
lotrowski : łotrowski : (przym.) roguish
lotrzyk : łotrzyk : (rzecz.) rogue
lotrzykowski : łotrzykowski : (przym.) picaresque
lowca : łowca : (rzecz.) chaser | : (rzecz.) hunter | : (rzecz.) hunters
lowiectwo : łowiectwo : (rzecz.) hunting
lowienie : łowienie : (rzecz.) fish | : (rzecz.) fishing
lowisko : łowisko : (rzecz.) fishery
lowic : łowić : (czas.) fish
lowny : łowny : (przym.) warrantable
loza : łoza : (rzecz.) osier | : (rzecz.) withy
lozina : łozina : (rzecz.) osier | : (rzecz.) withy
los : łoś : (rzecz.) elk | : (rzecz.) moose
loze : łoże : (rzecz.) bed
lozysko : łożysko : (rzecz.) bearing | : (rzecz.) bed | : (rzecz.) placenta | : (rzecz.) riverbed
lozyskowy : łożyskowy : (przym.) placental
lozyc : łożyć : (czas.) dab | : (czas.) impose | : (czas.) pay | : (czas.) push
lubek : łubek : (rzecz.) fish-bar | : (rzecz.) shin
lubin : łubin : (rzecz.) lupine
lubki : łubki : (rzecz.) splint
lucznictwo : łucznictwo : (rzecz.) archery
lucznik : łucznik : (rzecz.) archer | : (rzecz.) bower | : (rzecz.) bowman | : (rzecz.) bowyer
ludzenie : łudzenie : (rzecz.) delusion | : (rzecz.) human
ludzic : łudzić : (czas.) baffle | : (czas.) delude | : (czas.) entice
ludzacy : łudzący : (przym.) illusive
lug : ług : (rzecz.) liquor | : (rzecz.) lye
lugoodporny : ługoodporny : (przym.) alkali-resistant
lugowanie : ługowanie : (rzecz.) lixiviation
lugowac : ługować : (czas.) leach
luk : łuk : (rzecz.) arc | : (rzecz.) arch | : (rzecz.) bow | : (rzecz.) curve
lukowaty : łukowaty : (przym.) arcaded | : (przym.) arched | : (przym.) humpbacked
lukowy : łukowy : (przym.) arched
luna : łuna : (rzecz.) glow
lup : łup : (rzecz.) booty | : (rzecz.) capture | : (rzecz.) loot | : (rzecz.) plunder | : (rzecz.) prey | : (rzecz.) quarry | : (rzecz.) spoil | : (rzecz.) swag | : (rzecz.) trophy
lupa : łupa : (rzecz.) chunk | : (rzecz.) hull
lupacz : łupacz : (rzecz.) haddock
lupanie : łupanie : (rzecz.) lamination | : (rzecz.) splinter
lupac : łupać : (czas.) chip | : (czas.) cleave | : (czas.) crack | : (czas.) flaw | : (czas.) husk | : (czas.) rive | : (czas.) split
lupek : łupek : (rzecz.) schist | : (rzecz.) shale | : (rzecz.) slate
lupiestwo : łupiestwo : (rzecz.) pillage
lupiez : łupież : (rzecz.) dandruff | : (rzecz.) scurf
lupiezca : łupieżca : (rzecz.) hawk | : (rzecz.) looter | : (rzecz.) predator
lupiezczy : łupieżczy : (przym.) predatory | : (przym.) rapacious
lupina : łupina : (rzecz.) hull | : (rzecz.) husk | : (rzecz.) nutshell | : (rzecz.) peel | : (rzecz.) pod | : (rzecz.) rind | : (rzecz.) scale | : (rzecz.) shell | : (rzecz.) skin
lupinka : łupinka : (rzecz.) husk
lupic : łupić : (czas.) drub | : (czas.) loot | : (czas.) maraud | : (czas.) plunder | : (czas.) rob
lupkowaty : łupkowaty : (przym.) schistose
lupkowy : łupkowy : (przym.) schistose
lupliwosc : łupliwość : (rzecz.) cleavage
lupliwy : łupliwy : (przym.) cleavable | : (przym.) fissile | : (przym.) splintery
lupy : łupy : (rzecz.) loot
luska : łuska : (rzecz.) barb | : (rzecz.) cartridge-case | : (rzecz.) casing | : (rzecz.) flake | : (rzecz.) hull | : (rzecz.) husk | : (rzecz.) rind | : (rzecz.) scale | : (rzecz.) shell
luskac : łuskać : (czas.) hull | : (czas.) husk | : (czas.) peel | : (czas.) scale
luskowatosc : łuskowatość : (rzecz.) huskiness
luskowaty : łuskowaty : (przym.) flaky | : (przym.) scaly
luskowiec : łuskowiec : (rzecz.) pangolin
luskowy : łuskowy : (przym.) scaly
luszczarka : łuszczarka : (rzecz.) decorticator | : (rzecz.) huller | : (rzecz.) peeler
luszczenie : łuszczenie : (rzecz.) peeling | : (rzecz.) shelling
luszczyca : łuszczyca : (rzecz.) psoriasis
luszczyc : łuszczyć : (czas.) decorticate | : (czas.) flake | : (czas.) husk | : (czas.) peel | : (czas.) scale
lut : łut : (rzecz.) dram
lycha : łycha : (rzecz.) cootie
lydka : łydka : (rzecz.) calf
lyk : łyk : (rzecz.) draught | : (rzecz.) gulp | : (rzecz.) mouthful | : (rzecz.) nip | : (rzecz.) sip | : (rzecz.) sup | : (rzecz.) swallow
lykac : łykać : (czas.) gulp | : (czas.) swallow
lykniecie : łyknięcie : (rzecz.) gulp
lyko : łyko : (rzecz.) phloem | : (rzecz.) splint
lykowaty : łykowaty : (przym.) leathery | : (przym.) tough
lypac : łypać : (czas.) glance
lysiejacy : łysiejący : (przym.) balding
lysienie : łysienie : (rzecz.) alopecia | : (rzecz.) baldness
lysina : łysina : (rzecz.) baldness
lysy : łysy : (przym.) bald | : (przym.) baldhead | : (przym.) bald-headed
lyszczyk : łyszczyk : (rzecz.) mica
lyzeczka : łyżeczka : (rzecz.) teaspoon
lyzeczkowac : łyżeczkować : (czas.) curette | : (czas.) spoon
lyzka : łyżka : (rzecz.) scoop | : (rzecz.) spoon | : (rzecz.) spoonful | : (rzecz.) teaspoon
lyzkowanie : łyżkowanie : (rzecz.) bailing
lyzwa : łyżwa : (rzecz.) skate
lyzwiarka : łyżwiarka : (rzecz.) skater
lyzwiarstwo : łyżwiarstwo : (rzecz.) skating
lyzwiarz : łyżwiarz : (rzecz.) skater
lza : łza : (rzecz.) bead | : (rzecz.) tear | : (rzecz.) teardrop
lzawienie : łzawienie : (rzecz.) tear
lzawnik : łzawnik : (rzecz.) beak | : (rzecz.) gorge
lzawy : łzawy : (przym.) rueful | : (przym.) sentimental | : (przym.) teary
lzowy : łzowy : (przym.) lachrymal
lodka : łódka : (rzecz.) boat | : (rzecz.) dinghy | : (rzecz.) skiff
lodz : łódź : (rzecz.) boat | : (rzecz.) houseboat | : (rzecz.) launch
loj : łój : (rzecz.) suet | : (rzecz.) tallow
low : łów : (rzecz.) low
lozeczko : łóżeczko : (rzecz.) cot | : (rzecz.) crib
lozko : łóżko : (rzecz.) bed | : (rzecz.) bedstead | : (rzecz.) berth | : (rzecz.) bunk | : (rzecz.) cot
lacze : łącze : (rzecz.) connection | : (rzecz.) link
laczenie : łączenie : (rzecz.) bonding | : (rzecz.) coalescence | : (rzecz.) concatenation | : (rzecz.) linking | : (rzecz.) merger | : (rzecz.) seam
laczen : łączeń : (rzecz.) connections
laczka : łączka : (rzecz.) connector
laczniarka : łączniarka : (rzecz.) doubler
lacznica : łącznica : (rzecz.) concentrator | : (rzecz.) junction | : (rzecz.) switchboard | : (rzecz.) telephone
lacznie : łącznie : (przysł.) all-in | : (przysł.) coherently | : (przysł.) concomitantly | : (przysł.) cumulatively | : (przysł.) jointly | : (przysł.) together
lacznik : łącznik : (rzecz.) adapter | : (rzecz.) clamp | : (rzecz.) cleat | : (rzecz.) connecter | : (rzecz.) connecting-rod | : (rzecz.) connector | : (rzecz.) copula | : (rzecz.) coupler | : (rzecz.) dash | : (rzecz.) fastener | : (rzecz.) fitting | : (rzecz.) hyphen | : (rzecz.) junction | : (rzecz.) link | : (rzecz.) pitman
lacznosciowiec : łącznościowiec : (rzecz.) signalman
lacznosc : łączność : (rzecz.) coherence | : (rzecz.) coherency | : (rzecz.) communication | : (rzecz.) communications | : (rzecz.) connectivity | : (rzecz.) contact | : (rzecz.) liaison | : (rzecz.) link | : (rzecz.) telecommunication
laczny : łączny : (przym.) all-in | : (przym.) associative | : (przym.) cumulative | : (przym.) inclusive | : (przym.) joint | : (przym.) total
laczyc : łączyć : (czas.) amalgamate | : (czas.) annex | : (czas.) associate | : (czas.) blend | : (czas.) cohere | : (czas.) collate | : (czas.) combine | : (czas.) compound | : (czas.) concatenate | : (czas.) conjoin | : (czas.) connect | : (czas.) couple | : (czas.) dial | : (czas.) embody | : (czas.) incorporate | : (czas.) interconnect | : (czas.) interlink | : (czas.) interlock | : (czas.) join | : (czas.) link | : (czas.) merge | : (czas.) pair | : (czas.) relate | : (czas.) splice | : (czas.) tag | : (czas.) tie | : (czas.) unite | : (czas.) weld
laczowka : łączówka : (rzecz.) connector | : (rzecz.) junction
laczacy : łączący : (przym.) conjunctive
laka : łąka : (rzecz.) grassland | : (rzecz.) green | : (rzecz.) lea | : (rzecz.) mead | : (rzecz.) meadow
latka : łątka : (rzecz.) puppet
lek : łęk : (rzecz.) syncline
lekotka : łękotka : (rzecz.) meniscus
