ola : Ola : (rzecz.) Alex
oliwia : Oliwia : (rzecz.) Olivia
oskar : Oskar : (rzecz.) Oscar
o : o : (przyim.) about | : (przyim.) against | : (przyim.) at
oaza : oaza : (rzecz.) oasis
obalac : obalać : (czas.) abolish | : (czas.) abolisher | : (czas.) debunk | : (czas.) demolish | : (czas.) disprove | : (czas.) explode | : (czas.) overthrow | : (czas.) overturn | : (czas.) quail | : (czas.) rebut | : (czas.) refute | : (czas.) subvert
obalenie : obalenie : (rzecz.) abatement | : (rzecz.) abolishment | : (rzecz.) abolition | : (rzecz.) overthrow | : (rzecz.) refutation | : (rzecz.) subversion
obalic : obalić : (czas.) abolish | : (czas.) explode | : (czas.) overthrow | : (czas.) overturn | : (czas.) quail | : (czas.) refute
obandazowac : obandażować : (czas.) lag
obarczanie : obarczanie : (rzecz.) burdening
obarczac : obarczać : (czas.) bear
obarczenie : obarczenie : (rzecz.) loading
obarczyc : obarczyć : (czas.) afflict | : (czas.) burden | : (czas.) burthen | : (czas.) charge | : (czas.) load
obawa : obawa : (rzecz.) anxiety | : (rzecz.) apprehension | : (rzecz.) awe | : (rzecz.) concern | : (rzecz.) fear | : (rzecz.) hang-up | : (rzecz.) misgiving
obawiac : obawiać : (czas.) apprehend | : (czas.) fear
obcas : obcas : (rzecz.) heel
obcesowo : obcesowo : (przysł.) outright | : (przysł.) unceremoniously
obcesowosc : obcesowość : (rzecz.) abruptness | : (rzecz.) brusqueness | : (rzecz.) suddenness
obcesowy : obcesowy : (przym.) abrupt | : (przym.) brusque | : (przym.) unceremonious
obchody : obchody : (rzecz.) celebrations
obchodzenie : obchodzenie : (rzecz.) evasion | : (rzecz.) handling | : (rzecz.) round | : (rzecz.) treatment | : (rzecz.) usage
obchodzic : obchodzić : (czas.) bypass | : (czas.) by-pass | : (czas.) celebrate | : (czas.) circumvent | : (czas.) commemorate | : (czas.) evade | : (czas.) feast | : (czas.) handle | : (czas.) handled | : (czas.) hold | : (czas.) inspect | : (czas.) shirk | : (czas.) skirt | : (czas.) solemnize | : (czas.) tackle
obchod : obchód : (rzecz.) celebration | : (rzecz.) round
obcierac : obcierać : (czas.) wipe
obcinacz : obcinacz : (rzecz.) clipper
obcinanie : obcinanie : (rzecz.) clipping | : (rzecz.) curtailment | : (rzecz.) cutting | : (rzecz.) scissoring | : (rzecz.) truncation
obcinarka : obcinarka : (rzecz.) cutter
obcinac : obcinać : (czas.) axe | : (czas.) clip | : (czas.) crop | : (czas.) curtail | : (czas.) cut | : (czas.) dock | : (czas.) nip | : (czas.) pare | : (czas.) slash | : (czas.) stint | : (czas.) truncate
obcinek : obcinek : (rzecz.) clipping | : (rzecz.) cutting
obcinki : obcinki : (rzecz.) clippings
obciosac : obciosać : (czas.) square
obciskanie : obciskanie : (rzecz.) necking
obciskac : obciskać : (czas.) clasp
obcislosc : obcisłość : (rzecz.) tightness
obcisly : obcisły : (przym.) closefitting | : (przym.) close-fitting | : (przym.) skin-tight | : (przym.) tight | : (przym.) tight-fitting
obciaganie : obciąganie : (rzecz.) stretching
obciac : obciąć : (czas.) cut | : (czas.) retrench | : (czas.) truncate
obciazacz : obciążacz : (rzecz.) extender
obciazalnosc : obciążalność : (rzecz.) load
obciazanie : obciążanie : (rzecz.) load | : (rzecz.) loading
obciazac : obciążać : (czas.) aggravate | : (czas.) charge | : (czas.) debit | : (czas.) load
obciazenie : obciążenie : (rzecz.) aggravation | : (rzecz.) burden | : (rzecz.) burthen | : (rzecz.) charge | : (rzecz.) cumber | : (rzecz.) cumbrance | : (rzecz.) duty | : (rzecz.) encumbrance | : (rzecz.) handicap | : (rzecz.) liability | : (rzecz.) load | : (rzecz.) loading | : (rzecz.) strain | : (rzecz.) termination | : (rzecz.) workload
obciaznik : obciążnik : (rzecz.) bob | : (rzecz.) deadweight | : (rzecz.) leads | : (rzecz.) sinker
obciazony : obciążony : (przym.) loaded
obciazyc : obciążyć : (czas.) aggravate | : (czas.) burden | : (czas.) burthen | : (czas.) charge | : (czas.) encumber | : (czas.) weight
obciecie : obcięcie : (rzecz.) clip | : (rzecz.) dockage | : (rzecz.) truncation
obciety : obcięty : (przym.) truncated
obco : obco : (przysł.) strangely
obcojezyczny : obcojęzyczny : (przym.) foreign
obcokrajowiec : obcokrajowiec : (rzecz.) foreigner | : (rzecz.) gringo | : (rzecz.) stranger
obcokrajowy : obcokrajowy : (przym.) foreign
obcowanie : obcowanie : (rzecz.) companionship | : (rzecz.) intercourse
obcowac : obcować : (czas.) meddling
obcosc : obcość : (rzecz.) alienation | : (rzecz.) detachment | : (rzecz.) strangeness
obcy : obcy : (przym.) alien | : (przym.) extraneous | : (przym.) foreign | : (przym.) inorganic | : (przym.) mere | : (przym.) outlandish | : (przym.) remote | : (przym.) strange | : (przym.) stranger | : (przym.) unfamiliar
obczyzna : obczyzna : (rzecz.) exile
obcazki : obcążki : (rzecz.) pliers | : (rzecz.) tongs
obcegi : obcęgi : (rzecz.) clipper | : (rzecz.) pincers | : (rzecz.) pliers | : (rzecz.) tong | : (rzecz.) tongs
obdarowac : obdarować : (czas.) endow
obdarowywac : obdarowywać : (czas.) endow
obdartus : obdartus : (rzecz.) scruff | : (rzecz.) tatterdemalion
obdarty : obdarty : (przym.) tattered
obdarzac : obdarzać : (czas.) bestow | : (czas.) endow | : (czas.) lavish
obdarzyc : obdarzyć : (czas.) endue
obdrapac : obdrapać : (czas.) dilapidate
obdukcja : obdukcja : (rzecz.) autopsy
obdzielac : obdzielać : (czas.) deal | : (czas.) endow
obdzierac : obdzierać : (czas.) skin
obdziergac : obdziergać : (czas.) edge
obecnie : obecnie : (przysł.) currently | : (przysł.) now | : (przysł.) nowadays | : (przysł.) out | : (przysł.) presently
obecnosc : obecność : (rzecz.) assistance | : (rzecz.) attendance | : (rzecz.) inherence | : (rzecz.) presence
obecny : obecny : (przym.) attendant | : (przym.) current | : (przym.) present
obediencja : obediencja : (rzecz.) obedience
obejma : obejma : (rzecz.) bezel | : (rzecz.) clasp
obejmowany : obejmowany : (przym.) male
obejmowac : obejmować : (czas.) assume | : (czas.) clasp | : (czas.) comprehend | : (czas.) comprise | : (czas.) contain | : (czas.) cover | : (czas.) embody | : (czas.) embrace | : (czas.) encapsulate | : (czas.) enclose | : (czas.) encompass | : (czas.) include | : (czas.) incorporate | : (czas.) involve | : (czas.) lock
obejmujacy : obejmujący : (przym.) female
obejrzec : obejrzeć : (czas.) see | : (czas.) view
obejscie : obejście : (rzecz.) bypass | : (rzecz.) by-pass | : (rzecz.) farmyard | : (rzecz.) workaround | : (rzecz.) work-around
obejsc : obejść : (czas.) circumvent | : (czas.) workaround
obelga : obelga : (rzecz.) abusing | : (rzecz.) indignity | : (rzecz.) insult | : (rzecz.) invective | : (rzecz.) outrage
obelisk : obelisk : (rzecz.) obelisk
obelzywy : obelżywy : (przym.) abusive | : (przym.) contumelious | : (przym.) injurious | : (przym.) insulting | : (przym.) scurrilous | : (przym.) vituperative
oberwaniec : oberwaniec : (rzecz.) ragamuffin | : (rzecz.) tatterdemalion
oberwac : oberwać : (czas.) collapse | : (czas.) pluck
oberza : oberża : (rzecz.) hostelry | : (rzecz.) inn | : (rzecz.) kneading-trough | : (rzecz.) tavern
oberzyna : oberżyna : (rzecz.) eggplant | : (rzecz.) egg-plant
oberzysta : oberżysta : (rzecz.) innkeeper
obetonowanie : obetonowanie : (rzecz.) bracing
obetrzec : obetrzeć : (czas.) wipe
obeznany : obeznany : (przym.) versed
obezwladniac : obezwładniać : (czas.) benumb | : (czas.) disable | : (czas.) overpower | : (czas.) overwhelm | : (czas.) suppress
obezwladnienie : obezwładnienie : (rzecz.) exhaustion | : (rzecz.) suppression
obezwladnic : obezwładnić : (czas.) overwhelm | : (czas.) prostrate
obezrec : obeżreć : (czas.) gluttonize
obficie : obficie : (przysł.) abundantly | : (przysł.) copiously | : (przysł.) hard | : (przysł.) heavily | : (przysł.) luxuriantly | : (przysł.) profusely | : (przysł.) richly
obfitowanie : obfitowanie : (rzecz.) abounding
obfitowac : obfitować : (czas.) abound | : (czas.) flush | : (czas.) teem
obfitosc : obfitość : (rzecz.) abundance | : (rzecz.) affluence | : (rzecz.) ampleness | : (rzecz.) amplitude | : (rzecz.) copiousness | : (rzecz.) cornucopia | : (rzecz.) exuberance | : (rzecz.) foison | : (rzecz.) fullness | : (rzecz.) largeness | : (rzecz.) luxury | : (rzecz.) plenitude | : (rzecz.) plenty | : (rzecz.) plethora | : (rzecz.) profusion | : (rzecz.) wealth
obfity : obfity : (przym.) abundant | : (przym.) ample | : (przym.) bounteous | : (przym.) bountiful | : (przym.) copious | : (przym.) copiousness | : (przym.) exuberant | : (przym.) heartiest | : (przym.) hearty | : (przym.) heavy | : (przym.) large | : (przym.) lavish | : (przym.) luxuriant | : (przym.) luxurious | : (przym.) plenteous | : (przym.) plentiful | : (przym.) profuse | : (przym.) rich | : (przym.) rife | : (przym.) slap-up
obgadac : obgadać : (czas.) backbite
obgadywanie : obgadywanie : (rzecz.) backbiting
obgryzac : obgryzać : (czas.) dash | : (czas.) gnaw | : (czas.) nibble
obiad : obiad : (rzecz.) dinner | : (rzecz.) lunch
obiadowac : obiadować : (czas.) dine
obibok : obibok : (rzecz.) do-nothing | : (rzecz.) loafer
obicie : obicie : (rzecz.) bruise | : (rzecz.) drubbing | : (rzecz.) lining | : (rzecz.) padding | : (rzecz.) sheath | : (rzecz.) tapestry
obiecanka : obiecanka : (rzecz.) promise
obiecac : obiecać : (czas.) promise
obiecujacy : obiecujący : (przym.) promising
obiecywac : obiecywać : (czas.) promise
obieg : obieg : (rzecz.) circuit | : (rzecz.) circulation | : (rzecz.) currency | : (rzecz.) lap | : (rzecz.) orbiting | : (rzecz.) rotation | : (rzecz.) round
obiegac : obiegać : (czas.) circulate | : (czas.) resound | : (czas.) skirt
obiegowy : obiegowy : (przym.) current | : (przym.) rotary | : (przym.) stock
obiekcja : obiekcja : (rzecz.) demur | : (rzecz.) objection
obiekt : obiekt : (rzecz.) facility | : (rzecz.) object | : (rzecz.) structure | : (rzecz.) target
obiektowo-relacyjny : obiektowo-relacyjny : (przym.) object-relational
obiektowosc : obiektowość : (rzecz.) object-orientation
obiektowy : obiektowy : (przym.) object-oriented
obiektyw : obiektyw : (rzecz.) lens | : (rzecz.) object-glass | : (rzecz.) objective | : (rzecz.) object-lens
obiektywizm : obiektywizm : (rzecz.) objectivism | : (rzecz.) objectivity
obiektywnie : obiektywnie : (przysł.) objectively
obiektywnosc : obiektywność : (rzecz.) objectiveness | : (rzecz.) objectivity
obiektywny : obiektywny : (przym.) disinterested | : (przym.) objective
obiektywowy : obiektywowy : (przym.) objective
obielic : obielić : (czas.) whitewash
obieraczka : obieraczka : (rzecz.) peeler
obieralnosc : obieralność : (rzecz.) eligibility
obieralny : obieralny : (przym.) elective | : (przym.) eligible | : (przym.) optional
obieranie : obieranie : (rzecz.) paring | : (rzecz.) peeling
obierac : obierać : (czas.) appoint | : (czas.) choose | : (czas.) collect | : (czas.) nominate | : (czas.) peel | : (czas.) shell | : (czas.) skin
obierzyna : obierzyna : (rzecz.) peeling
obietnica : obietnica : (rzecz.) engagement | : (rzecz.) pledge | : (rzecz.) promise | : (rzecz.) troth
obiezyswiat : obieżyświat : (rzecz.) globetrotter | : (rzecz.) globe-trotter | : (rzecz.) ranger
obijak : obijak : (rzecz.) mallet
obijanie : obijanie : (rzecz.) beating
obijac : obijać : (czas.) bruise | : (czas.) chip | : (czas.) hang | : (czas.) upholster
obior : obiór : (rzecz.) choice
obic : obić : (czas.) pad
objadac : objadać : (czas.) gormandize
objaw : objaw : (rzecz.) diagnostic | : (rzecz.) display | : (rzecz.) sign | : (rzecz.) symptom
objawiac : objawiać : (czas.) open | : (czas.) show
objawienie : objawienie : (rzecz.) apparition | : (rzecz.) revelation
objawic : objawić : (czas.) reveal
objawowy : objawowy : (przym.) symptomatic
objazd : objazd : (rzecz.) bypass | : (rzecz.) by-pass | : (rzecz.) circuit | : (rzecz.) detour | : (rzecz.) diversion | : (rzecz.) tour | : (rzecz.) touring
objazdowy : objazdowy : (przym.) ambulatory | : (przym.) by-passing | : (przym.) itinerant | : (przym.) oblast | : (przym.) travelling
objasniajacy : objaśniający : (przym.) explanatory
objasnianie : objaśnianie : (rzecz.) clarification
objasniac : objaśniać : (czas.) account | : (czas.) annotate | : (czas.) construe | : (czas.) explain | : (czas.) expound | : (czas.) illustrate | : (czas.) interpret
objasnienie : objaśnienie : (rzecz.) callout | : (rzecz.) explanation
objasnic : objaśnić : (czas.) explain
objechac : objechać : (czas.) bypass
objesc : objeść : (czas.) gormandize
objezdzac : objeżdżać : (czas.) barnstorm | : (czas.) bypass | : (czas.) tour
objuczyc : objuczyć : (czas.) load
objac : objąć : (czas.) embrace | : (czas.) enfold | : (czas.) extend | : (czas.) grapple | : (czas.) grasp | : (czas.) lap
objecie : objęcie : (rzecz.) accession | : (rzecz.) assumption | : (rzecz.) coverage | : (rzecz.) embrace | : (rzecz.) hue
objetosciowy : objętościowy : (przym.) bulky | : (przym.) volumetric
objetosc : objętość : (rzecz.) bulk | : (rzecz.) capacity | : (rzecz.) compass | : (rzecz.) comprehension | : (rzecz.) content | : (rzecz.) size | : (rzecz.) volume
obkuwac : obkuwać : (czas.) trim
oblader : oblader : (rzecz.) slab
oblamowanie : oblamowanie : (rzecz.) border | : (rzecz.) hem
oblamowac : oblamować : (czas.) hem
oblac : oblać : (czas.) fail | : (czas.) plough | : (czas.) spill
obleczenie : obleczenie : (rzecz.) bed-clothes
obleganie : obleganie : (rzecz.) besieging
oblegac : oblegać : (czas.) beleaguer | : (czas.) beset | : (czas.) besiege
obleniec : obleniec : (rzecz.) roundworm
oblepiac : oblepiać : (czas.) stick
oblew : oblew : (rzecz.) coating
oblewanie : oblewanie : (rzecz.) celebration | : (rzecz.) pouring
oblewac : oblewać : (czas.) circumfuse | : (czas.) douse | : (czas.) lave | : (czas.) smother | : (czas.) sprinkle | : (czas.) surround | : (czas.) wash
oblesny : obleśny : (przym.) lecherous | : (przym.) lustful | : (przym.) oily | : (przym.) slimy
oblezc : obleźć : (czas.) fade
oblicz : oblicz : (rzecz.) count
obliczalnosc : obliczalność : (rzecz.) computability
obliczalny : obliczalny : (przym.) computable | : (przym.) computational
obliczanie : obliczanie : (rzecz.) calculation | : (rzecz.) computation | : (rzecz.) computing | : (rzecz.) count | : (rzecz.) numeration
obliczac : obliczać : (czas.) account | : (czas.) calculate | : (czas.) calculated | : (czas.) compute | : (czas.) count | : (czas.) countenance | : (czas.) estimate | : (czas.) evaluate | : (czas.) reckon | : (czas.) tally
oblicze : oblicze : (rzecz.) countenance | : (rzecz.) face | : (rzecz.) side | : (rzecz.) visage
obliczenie : obliczenie : (rzecz.) calculation | : (rzecz.) computation | : (rzecz.) sum
obliczeniowy : obliczeniowy : (przym.) computable | : (przym.) computational
obliczyc : obliczyć : (czas.) account | : (czas.) calculate | : (czas.) count | : (czas.) cube
oblicowka : oblicówka : (rzecz.) siding
obligacja : obligacja : (rzecz.) attachment | : (rzecz.) bond | : (rzecz.) debenture | : (rzecz.) obligation
obligatoryjny : obligatoryjny : (przym.) mandatory | : (przym.) obligatory
obligo : obligo : (rzecz.) liability
obligowac : obligować : (czas.) obliges
oblina : oblina : (rzecz.) wane
oblizac : oblizać : (czas.) lick
oblodzenie : oblodzenie : (rzecz.) icing
oblubienica : oblubienica : (rzecz.) bride
oblubieniec : oblubieniec : (rzecz.) bridegroom
obluzowac : obluzować : (czas.) loosen
oblezenie : oblężenie : (rzecz.) besetment | : (rzecz.) siege
obmacanie : obmacanie : (rzecz.) finger | : (rzecz.) palpating
obmacac : obmacać : (czas.) feel | : (czas.) finger
obmawianie : obmawianie : (rzecz.) backbiting | : (rzecz.) slander
obmawiac : obmawiać : (czas.) asperse | : (czas.) backbite | : (czas.) denigrate | : (czas.) scandalize | : (czas.) vilify
obmierzlosc : obmierzłość : (rzecz.) disgust
obmowa : obmowa : (rzecz.) aspersion | : (rzecz.) backbiting | : (rzecz.) obloquy | : (rzecz.) scandal | : (rzecz.) slander
obmurowanie : obmurowanie : (rzecz.) embankment | : (rzecz.) lining
obmycie : obmycie : (rzecz.) ablution | : (rzecz.) ablutions | : (rzecz.) wash | : (rzecz.) washing
obmywanie : obmywanie : (rzecz.) washing
obmywac : obmywać : (czas.) cleanse | : (czas.) swill | : (czas.) wash
obmyc : obmyć : (czas.) wash
obmyslac : obmyślać : (czas.) debate | : (czas.) devise | : (czas.) premeditate
obmyslic : obmyślić : (czas.) digest
obnazanie : obnażanie : (rzecz.) denudation
obnazac : obnażać : (czas.) bare | : (czas.) strip | : (czas.) unclothe | : (czas.) uncover
obnazenie : obnażenie : (rzecz.) exposure
obnazony : obnażony : (przym.) bare
obnazyc : obnażyć : (czas.) undress | : (czas.) unsheathe
obnizanie : obniżanie : (rzecz.) abating
obnizac : obniżać : (czas.) cheapen | : (czas.) debase | : (czas.) decline | : (czas.) decrease | : (czas.) depress | : (czas.) descend | : (czas.) dip | : (czas.) drop | : (czas.) lower | : (czas.) reduce | : (czas.) sink | : (czas.) slip
obnizenie : obniżenie : (rzecz.) abatement | : (rzecz.) decrease | : (rzecz.) degradation | : (rzecz.) descent | : (rzecz.) influence | : (rzecz.) reduction | : (rzecz.) subsidence
obnizka : obniżka : (rzecz.) abatement | : (rzecz.) deduction | : (rzecz.) discount | : (rzecz.) lowering | : (rzecz.) markdown | : (rzecz.) reduction | : (rzecz.) rollback
obnizyc : obniżyć : (czas.) abase | : (czas.) abate | : (czas.) decrease | : (czas.) depress | : (czas.) dip | : (czas.) lower
obnosic : obnosić : (czas.) sport
oboista : oboista : (rzecz.) oboist
obojczyk : obojczyk : (rzecz.) clavicle | : (rzecz.) collarbone | : (rzecz.) collar-bone
obojnaczy : obojnaczy : (przym.) bisexual | : (przym.) hermaphrodite | : (przym.) hermaphroditic | : (przym.) hermaphroditical
obojnak : obojnak : (rzecz.) hermaphrodite | : (rzecz.) hermaphroditical
obojetnie : obojętnie : (przysł.) indifferently | : (przysł.) unconcernedly
obojetnosc : obojętność : (rzecz.) abstractedness | : (rzecz.) apathy | : (rzecz.) detachment | : (rzecz.) impassivity | : (rzecz.) indifference | : (rzecz.) nonchalance | : (rzecz.) unconcern
obojetny : obojętny : (przym.) apathetic | : (przym.) chilly | : (przym.) cold | : (przym.) dispassionate | : (przym.) inactive | : (przym.) indifferent | : (przym.) inert | : (przym.) listless | : (przym.) lukewarm | : (przym.) neutral | : (przym.) resigned | : (przym.) stolid | : (przym.) unconcerned | : (przym.) unimpressed | : (przym.) uninterested | : (przym.) unmoved | : (przym.) unresponsive | : (przym.) unsympathetic
obok : obok : (rzecz.) past
obolalosc : obolałość : (rzecz.) pain
obolaly : obolały : (przym.) sore
obopolnie : obopólnie : (przysł.) mutually | : (przysł.) reciprocally
obopolnosc : obopólność : (rzecz.) mutuality
obopolny : obopólny : (przym.) mutual | : (przym.) reciprocal
obora : obora : (rzecz.) barn | : (rzecz.) byre | : (rzecz.) cowshed | : (rzecz.) stable
oboranie : oboranie : (rzecz.) byre
obornik : obornik : (rzecz.) dung | : (rzecz.) manure
obosieczny : obosieczny : (przym.) double-edged | : (przym.) two-edged
obostrzenie : obostrzenie : (rzecz.) restriction
obowiazek : obowiązek : (rzecz.) charge | : (rzecz.) chore | : (rzecz.) duty | : (rzecz.) obligation | : (rzecz.) office | : (rzecz.) onus | : (rzecz.) responsibility
obowiazkowo : obowiązkowo : (przysł.) dutifully | : (przysł.) obligatorily
obowiazkowy : obowiązkowy : (przym.) compulsory | : (przym.) duteous | : (przym.) dutiful | : (przym.) mandatory | : (przym.) obligatory
obowiazujacy : obowiązujący : (przym.) obligatory | : (przym.) standing
obowiazywanie : obowiązywanie : (rzecz.) duration
obowiazywac : obowiązywać : (czas.) force | : (czas.) oblige | : (czas.) operate | : (czas.) stand
obozowanie : obozowanie : (rzecz.) camp | : (rzecz.) camping | : (rzecz.) encampment
obozowac : obozować : (czas.) camp | : (czas.) encamp
obozowicz : obozowicz : (rzecz.) camper
obozowisko : obozowisko : (rzecz.) camp | : (rzecz.) campground | : (rzecz.) campsite | : (rzecz.) encampment
obrabialnosc : obrabialność : (rzecz.) workability
obrabialny : obrabialny : (przym.) determinable | : (przym.) workable
obrabiarka : obrabiarka : (rzecz.) lathe | : (rzecz.) machine | : (rzecz.) machine-tool
obrabiac : obrabiać : (czas.) hem | : (czas.) process | : (czas.) processing | : (czas.) work
obrabowac : obrabować : (czas.) despoil | : (czas.) rifle | : (czas.) rob
obrabowywac : obrabowywać : (czas.) mug | : (czas.) rob
obracanie : obracanie : (rzecz.) broaching | : (rzecz.) manipulation
obracac : obracać : (czas.) gyrate | : (czas.) handle | : (czas.) hinge | : (czas.) negotiate | : (czas.) pirouette | : (czas.) rebound | : (czas.) rev | : (czas.) revolve | : (czas.) roll | : (czas.) rotate | : (czas.) slue | : (czas.) spin | : (czas.) swirl | : (czas.) swivel | : (czas.) toss | : (czas.) turn
obrachowac : obrachować : (czas.) calculate | : (czas.) count
obrachunek : obrachunek : (rzecz.) account | : (rzecz.) count | : (rzecz.) settlement
obradowac : obradować : (czas.) deliberate | : (czas.) sit
obrady : obrady : (rzecz.) deliberation | : (rzecz.) deliberations | : (rzecz.) proceeding | : (rzecz.) proceedings | : (rzecz.) session
obramowanie : obramowanie : (rzecz.) border | : (rzecz.) casing | : (rzecz.) edging | : (rzecz.) frame | : (rzecz.) framing | : (rzecz.) fringe | : (rzecz.) mantel | : (rzecz.) setting | : (rzecz.) surround
obramowac : obramować : (czas.) edge | : (czas.) hem
obramowywac : obramowywać : (czas.) encase | : (czas.) encircle
obrastac : obrastać : (czas.) border | : (czas.) overgrow
obraz : obraz : (rzecz.) canvas | : (rzecz.) figure | : (rzecz.) image | : (rzecz.) painting | : (rzecz.) picture | : (rzecz.) scene | : (rzecz.) shape | : (rzecz.) vision
obraza : obraza : (rzecz.) abusing | : (rzecz.) affront | : (rzecz.) injury | : (rzecz.) insult | : (rzecz.) offence | : (rzecz.) outrage | : (rzecz.) pet | : (rzecz.) pique | : (rzecz.) resentment | : (rzecz.) scandal | : (rzecz.) umbrage
obrazek : obrazek : (rzecz.) image
obrazic : obrazić : (czas.) injure | : (czas.) insult | : (czas.) offend | : (czas.) outrage | : (czas.) pique
obrazoburca : obrazoburca : (rzecz.) iconoclast
obrazoburczy : obrazoburczy : (przym.) iconoclastic
obrazoburstwo : obrazoburstwo : (rzecz.) iconoclasm
obrazowanie : obrazowanie : (rzecz.) display | : (rzecz.) imagery
obrazowac : obrazować : (czas.) depict | : (czas.) epitomize | : (czas.) exemplify | : (czas.) picture
obrazowo : obrazowo : (przysł.) graphically | : (przysł.) vividly
obrazowosc : obrazowość : (rzecz.) imagery
obrazowy : obrazowy : (przym.) figurative | : (przym.) graphic | : (przym.) pictorial | : (przym.) vivid
obrazy : obrazy : (rzecz.) paintings
obrac : obrać : (czas.) adopt | : (czas.) views
obrazliwosc : obraźliwość : (rzecz.) sulkiness | : (rzecz.) touchiness
obrazliwy : obraźliwy : (przym.) abusive | : (przym.) aggressive | : (przym.) disrespectful | : (przym.) huffish | : (przym.) huffy | : (przym.) injurious | : (przym.) insulting | : (przym.) offensive | : (przym.) opprobrious | : (przym.) susceptible
obrazajacy : obrażający : (przym.) outrageous
obrazalski : obrażalski : (przym.) cocky
obrazanie : obrażanie : (rzecz.) image | : (rzecz.) offender
obrazac : obrażać : (czas.) abuse | : (czas.) affront | : (czas.) huff | : (czas.) injure | : (czas.) insult | : (czas.) offend | : (czas.) outrage | : (czas.) pique | : (czas.) resent
obrazenie : obrażenie : (rzecz.) image | : (rzecz.) injury | : (rzecz.) lesion | : (rzecz.) trauma
obredlanie : obredlanie : (rzecz.) ridging
obrobic : obrobić : (czas.) work
obrok : obrok : (rzecz.) fodder | : (rzecz.) provender
obrona : obrona : (rzecz.) advocacy | : (rzecz.) back | : (rzecz.) defence | : (rzecz.) justification | : (rzecz.) plea | : (rzecz.) vindication
obronic : obronić : (czas.) defend | : (czas.) fend | : (czas.) justify | : (czas.) save | : (czas.) vindicate
obronny : obronny : (przym.) defensible | : (przym.) defensive | : (przym.) fortified
obrotnica : obrotnica : (rzecz.) racer | : (rzecz.) turntable | : (rzecz.) turn-table
obrotnik : obrotnik : (rzecz.) swivel
obrotnosc : obrotność : (rzecz.) agility
obrotny : obrotny : (przym.) canny | : (przym.) dextrous | : (przym.) resourceful
obrotomierz : obrotomierz : (rzecz.) rev-counter | : (rzecz.) tachometer
obrotowy : obrotowy : (przym.) circulating | : (przym.) revolutionary | : (przym.) revolving | : (przym.) rotary | : (przym.) rotational
obroty : obroty : (rzecz.) revolutions
obronca : obrońca : (rzecz.) advocate | : (rzecz.) attorney | : (rzecz.) back | : (rzecz.) barrister | : (rzecz.) champion | : (rzecz.) counsel | : (rzecz.) defence | : (rzecz.) defender | : (rzecz.) guardian | : (rzecz.) halfback | : (rzecz.) half-back | : (rzecz.) libertarian | : (rzecz.) pleader | : (rzecz.) protector | : (rzecz.) vindicator
obroza : obroża : (rzecz.) collar | : (rzecz.) dog-collar
obrumienic : obrumienić : (czas.) brown
obrus : obrus : (rzecz.) cloth | : (rzecz.) tablecloth | : (rzecz.) table-cloth
obrys : obrys : (rzecz.) contour
obrysowac : obrysować : (czas.) border
obrywac : obrywać : (czas.) tear
obrywka : obrywka : (rzecz.) dressing
obryzgac : obryzgać : (czas.) asperse | : (czas.) dash | : (czas.) splash
obryzgiwac : obryzgiwać : (czas.) spatter | : (czas.) splash | : (czas.) splatter
obrzezanie : obrzezanie : (rzecz.) circumcision
obrzezac : obrzezać : (czas.) circumcise
obrzezywac : obrzezywać : (czas.) circumcise
obrzezac : obrzeżać : (czas.) border
obrzeze : obrzeże : (rzecz.) border | : (rzecz.) edge | : (rzecz.) periphery | : (rzecz.) rim | : (rzecz.) welt
obrzezny : obrzeżny : (przym.) peripheral
obrzmienie : obrzmienie : (rzecz.) fluxion | : (rzecz.) swelling | : (rzecz.) tumefaction
obrzucac : obrzucać : (czas.) bandy | : (czas.) pelt
obrzucic : obrzucić : (czas.) pelt
obrzutka : obrzutka : (rzecz.) rendering
obrzydlistwo : obrzydlistwo : (rzecz.) grunge
obrzydliwie : obrzydliwie : (przysł.) abominably | : (przysł.) disgustingly | : (przysł.) foully
obrzydliwosc : obrzydliwość : (rzecz.) abomination | : (rzecz.) disgust
obrzydliwy : obrzydliwy : (przym.) abominable | : (przym.) cloying | : (przym.) detestable | : (przym.) disgusting | : (przym.) distasteful | : (przym.) heinous | : (przym.) nauseous | : (przym.) noxious | : (przym.) poisonous | : (przym.) revolting | : (przym.) sickening | : (przym.) sickish | : (przym.) yucky
obrzydniecie : obrzydnięcie : (rzecz.) disgust
obrzydzac : obrzydzać : (czas.) sicken
obrzydzenie : obrzydzenie : (rzecz.) abomination | : (rzecz.) averseness | : (rzecz.) aversion | : (rzecz.) disgust | : (rzecz.) execration | : (rzecz.) loathing
obrzynac : obrzynać : (czas.) lop
obrzynek : obrzynek : (rzecz.) clipping
obrzynki : obrzynki : (rzecz.) trimmings
obrzadek : obrządek : (rzecz.) rite | : (rzecz.) ritual
obrzadzac : obrządzać : (czas.) groom
obrzed : obrzęd : (rzecz.) ceremony | : (rzecz.) custom | : (rzecz.) observance | : (rzecz.) rite | : (rzecz.) solemnity
obrzedowy : obrzędowy : (przym.) ceremonial | : (przym.) ritual
obrzek : obrzęk : (rzecz.) dropsy | : (rzecz.) oedema | : (rzecz.) swelling | : (rzecz.) tumefaction | : (rzecz.) weal | : (rzecz.) whelk
obrzekowy : obrzękowy : (przym.) tumid
obrobka : obróbka : (rzecz.) alteration | : (rzecz.) processing | : (rzecz.) treatment
obrocic : obrócić : (czas.) broach | : (czas.) rotate | : (czas.) turn
obrot : obrót : (rzecz.) cash | : (rzecz.) circulation | : (rzecz.) currency | : (rzecz.) cycle | : (rzecz.) rev | : (rzecz.) revolution | : (rzecz.) rotation | : (rzecz.) slue | : (rzecz.) spin | : (rzecz.) swivel | : (rzecz.) turn | : (rzecz.) turnaround | : (rzecz.) turnover | : (rzecz.) twirl | : (rzecz.) twist
obrownac : obrównać : (czas.) smooth
obrabek : obrąbek : (rzecz.) hem
obrabiac : obrąbiać : (czas.) hem
obraczka : obrączka : (rzecz.) rind | : (rzecz.) ring | : (rzecz.) wedding-ring
obraczkowac : obrączkować : (czas.) girdle
obraczkowy : obrączkowy : (przym.) annular | : (przym.) ringed
obreb : obręb : (rzecz.) compass | : (rzecz.) district | : (rzecz.) limit | : (rzecz.) precinct
obrebiac : obrębiać : (czas.) hem | : (czas.) hoop
obrebic : obrębić : (czas.) hoop
obrecz : obręcz : (rzecz.) rim | : (rzecz.) tire | : (rzecz.) tyre
obsada : obsada : (rzecz.) actors | : (rzecz.) appointment | : (rzecz.) cast | : (rzecz.) casting | : (rzecz.) crew | : (rzecz.) manning | : (rzecz.) mounting
obsadka : obsadka : (rzecz.) mount | : (rzecz.) penholder
obsadzac : obsadzać : (czas.) man | : (czas.) staff
obsadzenie : obsadzenie : (rzecz.) fill
obsadzic : obsadzić : (czas.) fill | : (czas.) typecast
obscenicznosc : obsceniczność : (rzecz.) lewdness | : (rzecz.) obscenity
obsceniczny : obsceniczny : (przym.) obscene
obserwacja : obserwacja : (rzecz.) introspection | : (rzecz.) observation | : (rzecz.) watch
obserwacyjny : obserwacyjny : (przym.) observational
obserwator : obserwator : (rzecz.) beholder | : (rzecz.) bystander | : (rzecz.) lookout | : (rzecz.) look-out | : (rzecz.) observer | : (rzecz.) onlooker | : (rzecz.) spectator | : (rzecz.) spotter | : (rzecz.) watcher
obserwatorium : obserwatorium : (rzecz.) observatory
obserwowanie : obserwowanie : (rzecz.) observation | : (rzecz.) watch
obserwowac : obserwować : (czas.) lurk | : (czas.) observe | : (czas.) survey | : (czas.) watch
obsesja : obsesja : (rzecz.) besetment | : (rzecz.) obsession
obsesyjny : obsesyjny : (przym.) obsessive
obsiadac : obsiadać : (czas.) fill
obsiac : obsiać : (czas.) sow
obsiew : obsiew : (rzecz.) sowing
obsiewac : obsiewać : (czas.) sow
obskakiwac : obskakiwać : (czas.) crowd | : (czas.) surround
obskurant : obskurant : (rzecz.) obscurant
obskurantyzm : obskurantyzm : (rzecz.) obscurantism | : (rzecz.) obscurity
obskurnosc : obskurność : (rzecz.) dinginess
obskurny : obskurny : (przym.) dingy | : (przym.) mean | : (przym.) sordid
obstawa : obstawa : (rzecz.) bodyguard | : (rzecz.) guard
obstawac : obstawać : (czas.) abide | : (czas.) adhere | : (czas.) insist | : (czas.) persist
obstawiac : obstawiać : (czas.) bet | : (czas.) surround
obstawic : obstawić : (czas.) bet
obstrukcja : obstrukcja : (rzecz.) block | : (rzecz.) constipation | : (rzecz.) obstruction
obstrukcjonista : obstrukcjonista : (rzecz.) filibuster | : (rzecz.) obstructionist
obstrukcyjny : obstrukcyjny : (przym.) obstructive
obstrzal : obstrzał : (rzecz.) gunfire
obstukiwac : obstukiwać : (czas.) chip
obsuniecie : obsunięcie : (rzecz.) landslide
obsuwanie : obsuwanie : (rzecz.) sinking
obsuwisko : obsuwisko : (rzecz.) landslip
obsydian : obsydian : (rzecz.) obsidian
obsypac : obsypać : (czas.) load | : (czas.) strew
obsypnik : obsypnik : (rzecz.) furrower
obsypywanie : obsypywanie : (rzecz.) ridging
obsypywac : obsypywać : (czas.) bespatter | : (czas.) powder | : (czas.) strew
obszar : obszar : (rzecz.) area | : (rzecz.) expanse | : (rzecz.) extent | : (rzecz.) premise | : (rzecz.) region | : (rzecz.) space | : (rzecz.) stretch | : (rzecz.) terrene | : (rzecz.) territory | : (rzecz.) tract
obszarniczy : obszarniczy : (przym.) landed
obszarnik : obszarnik : (rzecz.) landlord | : (rzecz.) landowner
obszarpaniec : obszarpaniec : (rzecz.) ragamuffin | : (rzecz.) tatterdemalion
obszarpany : obszarpany : (przym.) ragged | : (przym.) tattered
obszernie : obszernie : (przysł.) amply | : (przysł.) extensively
obszernosc : obszerność : (rzecz.) ampleness | : (rzecz.) length
obszerny : obszerny : (przym.) ample | : (przym.) baggy | : (przym.) big | : (przym.) broad | : (przym.) capacious | : (przym.) comprehensive | : (przym.) extensive | : (przym.) loose | : (przym.) roomy | : (przym.) spacious | : (przym.) vast | : (przym.) wide
obszukac : obszukać : (czas.) frisk | : (czas.) ransack
obszukiwac : obszukiwać : (czas.) frisk
obszycie : obszycie : (rzecz.) binding | : (rzecz.) edging | : (rzecz.) hem
obszywac : obszywać : (czas.) brag | : (czas.) hem
obszywka : obszywka : (rzecz.) galloon | : (rzecz.) hem | : (rzecz.) trimming
obszyc : obszyć : (czas.) edge | : (czas.) hem | : (czas.) lace
obsluga : obsługa : (rzecz.) administration | : (rzecz.) attendance | : (rzecz.) handling | : (rzecz.) operation | : (rzecz.) service
obslugiwanie : obsługiwanie : (rzecz.) action | : (rzecz.) handling
obslugiwac : obsługiwać : (czas.) attend | : (czas.) cater | : (czas.) handle | : (czas.) man | : (czas.) operate | : (czas.) serve | : (czas.) tend | : (czas.) work
obsluzyc : obsłużyć : (czas.) handle
obtaczanie : obtaczanie : (rzecz.) coating
obtaczac : obtaczać : (czas.) grind
obtarcie : obtarcie : (rzecz.) sore
obtluczenie : obtłuczenie : (rzecz.) bruise
obuch : obuch : (rzecz.) head
obudowa : obudowa : (rzecz.) casing | : (rzecz.) encapsulation | : (rzecz.) housing | : (rzecz.) lining | : (rzecz.) package
obudowanie : obudowanie : (rzecz.) encapsulated
obudowac : obudować : (czas.) build | : (czas.) encase
obudzenie : obudzenie : (rzecz.) awakening
obudzic : obudzić : (czas.) arouse | : (czas.) awake | : (czas.) awaken | : (czas.) rouse | : (czas.) wake
obumarcie : obumarcie : (rzecz.) decay | : (rzecz.) necrosis
obumieranie : obumieranie : (rzecz.) atrophy | : (rzecz.) languishment
obumierac : obumierać : (czas.) atrophy | : (czas.) languish
obuoczny : obuoczny : (przym.) binocular
obuplciowy : obupłciowy : (przym.) epicene | : (przym.) hermaphrodite | : (przym.) hermaphroditic
oburzajacy : oburzający : (przym.) shocking
oburzac : oburzać : (czas.) appal | : (czas.) displease | : (czas.) resent | : (czas.) revolt | : (czas.) sicken
oburzenie : oburzenie : (rzecz.) displeasure | : (rzecz.) indignation | : (rzecz.) outrage | : (rzecz.) resentment | : (rzecz.) wrath
obureczny : oburęczny : (przym.) ambidextrous | : (przym.) bimanual | : (przym.) two-handed
obustronnie : obustronnie : (przysł.) bilaterally
obustronny : obustronny : (przym.) bilateral | : (przym.) mutual | : (przym.) reciprocal | : (przym.) two-sided
obuwie : obuwie : (rzecz.) footwear | : (rzecz.) foot-wear
obuc : obuć : (czas.) shoe
obwarowanie : obwarowanie : (rzecz.) fortification | : (rzecz.) stockade
obwarowac : obwarować : (czas.) retrench
obwarzanek : obwarzanek : (rzecz.) bagel | : (rzecz.) pretzel
obwalowanie : obwałowanie : (rzecz.) bund | : (rzecz.) rampart
obwalowac : obwałować : (czas.) bank | : (czas.) embank
obwiednia : obwiednia : (rzecz.) envelope
obwieszczanie : obwieszczanie : (rzecz.) announcing | : (rzecz.) notice
obwieszczac : obwieszczać : (czas.) advertise | : (czas.) announce | : (czas.) peal | : (czas.) proclaim
obwieszczenie : obwieszczenie : (rzecz.) advertisement | : (rzecz.) announcement | : (rzecz.) notice | : (rzecz.) statement
obwieszenie : obwieszenie : (rzecz.) hanging
obwies : obwieś : (rzecz.) scoundrel
obwiescic : obwieścić : (czas.) notify | : (czas.) proclaim
obwiezc : obwieźć : (czas.) drive
obwijac : obwijać : (czas.) wind
obwinianie : obwinianie : (rzecz.) incrimination
obwiniac : obwiniać : (czas.) accuse | : (czas.) blame | : (czas.) incriminate
obwinienie : obwinienie : (rzecz.) accusation | : (rzecz.) blame | : (rzecz.) incrimination
obwinic : obwinić : (czas.) convict | : (czas.) inculcate | : (czas.) inculpate
obwisanie : obwisanie : (rzecz.) droop | : (rzecz.) sag
obwisac : obwisać : (czas.) sag
obwislosc : obwisłość : (rzecz.) droop | : (rzecz.) flabbiness
obwisly : obwisły : (przym.) flabby | : (przym.) flaccid
obwiazywac : obwiązywać : (czas.) tie
obwodnica : obwodnica : (rzecz.) beltway | : (rzecz.) bypass | : (rzecz.) by-pass
obwodowy : obwodowy : (przym.) circuital | : (przym.) circumferential | : (przym.) peripheral
obwoluta : obwoluta : (rzecz.) dustcover | : (rzecz.) dust-cover | : (rzecz.) jacket | : (rzecz.) wrapper
obwolac : obwołać : (czas.) hail
obwozny : obwoźny : (przym.) mobile
obwod : obwód : (rzecz.) ambit | : (rzecz.) circle | : (rzecz.) circuit | : (rzecz.) circumference | : (rzecz.) compass | : (rzecz.) district | : (rzecz.) girth | : (rzecz.) loop | : (rzecz.) network | : (rzecz.) perimeter | : (rzecz.) periphery
obwodka : obwódka : (rzecz.) areola | : (rzecz.) ban | : (rzecz.) band | : (rzecz.) border | : (rzecz.) hem | : (rzecz.) rim
obwoj : obwój : (rzecz.) serving
obwachac : obwąchać : (czas.) sniff
obwachiwac : obwąchiwać : (czas.) nose
obycie : obycie : (rzecz.) manner | : (rzecz.) manners | : (rzecz.) refinement
obyczaj : obyczaj : (rzecz.) custom | : (rzecz.) habit | : (rzecz.) manner | : (rzecz.) mode
obyczajnosc : obyczajność : (rzecz.) decency | : (rzecz.) decorum
obyczajny : obyczajny : (przym.) decent | : (przym.) decorous | : (przym.) modest | : (przym.) moral
obyczajowosc : obyczajowość : (rzecz.) customs
obyczajowy : obyczajowy : (przym.) moral | : (przym.) social
obywatel : obywatel : (rzecz.) burgess | : (rzecz.) citizen | : (rzecz.) civilian | : (rzecz.) commoner | : (rzecz.) denizen | : (rzecz.) freeman | : (rzecz.) national
obywatelski : obywatelski : (przym.) civic | : (przym.) civil
obywatelstwo : obywatelstwo : (rzecz.) citizenship | : (rzecz.) freedom | : (rzecz.) nationality
obywac : obywać : (czas.) forgo
obyc : obyć : (czas.) dispense | : (czas.) forgo
obznajomienie : obznajomienie : (rzecz.) acquainting | : (rzecz.) familiarity
oboj : obój : (rzecz.) hautboy | : (rzecz.) oboe
oboz : obóz : (rzecz.) camp | : (rzecz.) encampment
obladowac : obładować : (czas.) burden | : (czas.) burthen | : (czas.) heap | : (czas.) load
oblaskawiac : obłaskawiać : (czas.) tame
oblawa : obława : (rzecz.) chase | : (rzecz.) hunt | : (rzecz.) manhunt | : (rzecz.) raid | : (rzecz.) roundup | : (rzecz.) round-up
oblok : obłok : (rzecz.) cloud | : (rzecz.) pall
oblozenie : obłożenie : (rzecz.) occupancy
oblozny : obłożny : (przym.) severe
oblozyc : obłożyć : (czas.) wrap
obluda : obłuda : (rzecz.) cant | : (rzecz.) dissimulation | : (rzecz.) duplicity | : (rzecz.) hypocrisy | : (rzecz.) insincerity
obludnica : obłudnica : (rzecz.) hypocrite
obludnie : obłudnie : (przysł.) insincerely
obludnik : obłudnik : (rzecz.) dissembler | : (rzecz.) hypocrite
obludny : obłudny : (przym.) cant | : (przym.) canting | : (przym.) false | : (przym.) false-hearted | : (przym.) hypocritical | : (przym.) insincere | : (przym.) self-righteous | : (przym.) twofaced | : (przym.) two-faced | : (przym.) two-tongued
oblupac : obłupać : (czas.) shell
oblupic : obłupić : (czas.) rob
oblupywanie : obłupywanie : (rzecz.) shelling
oblupywac : obłupywać : (czas.) peel | : (czas.) shell
obluskiwacz : obłuskiwacz : (rzecz.) huller
obluskiwac : obłuskiwać : (czas.) husk
obly : obły : (przym.) cylindrical | : (przym.) oval | : (przym.) rounded
oblak : obłąk : (rzecz.) bail
oblakanie : obłąkanie : (rzecz.) bedlam | : (rzecz.) insanity | : (rzecz.) madness
oblakaniec : obłąkaniec : (rzecz.) lunatic
oblakanczo : obłąkańczo : (przysł.) insanely
oblakanczy : obłąkańczy : (przym.) insane
obled : obłęd : (rzecz.) alienation | : (rzecz.) insanity | : (rzecz.) lunacy | : (rzecz.) madness | : (rzecz.) mania
obledny : obłędny : (przym.) fantastic | : (przym.) fantastical
obzarstwo : obżarstwo : (rzecz.) gluttony
obzartuch : obżartuch : (rzecz.) glutton | : (rzecz.) gormandize | : (rzecz.) gourmand | : (rzecz.) guzzler
ocalac : ocalać : (czas.) rescue
ocalenie : ocalenie : (rzecz.) rescue | : (rzecz.) salvage | : (rzecz.) salvation | : (rzecz.) survival
ocalec : ocaleć : (czas.) delivered | : (czas.) salvage | : (czas.) survive
ocalic : ocalić : (czas.) rescue | : (czas.) salvage | : (czas.) salve | : (czas.) save
ocean : ocean : (rzecz.) ocean
oceaniczny : oceaniczny : (przym.) ocean-going | : (przym.) oceanic
oceanografia : oceanografia : (rzecz.) oceanography
oceanograficzny : oceanograficzny : (przym.) oceanographic
ocelot : ocelot : (rzecz.) ocelot
ocembrowanie : ocembrowanie : (rzecz.) timbering
ocembrowac : ocembrować : (czas.) timber
ocena : ocena : (rzecz.) appraisal | : (rzecz.) appraisement | : (rzecz.) appreciation | : (rzecz.) assessment | : (rzecz.) assignment | : (rzecz.) criticism | : (rzecz.) estimate | : (rzecz.) estimation | : (rzecz.) evaluation | : (rzecz.) grade | : (rzecz.) mark | : (rzecz.) opinion | : (rzecz.) rating | : (rzecz.) score | : (rzecz.) view
ocenianie : ocenianie : (rzecz.) evaluation
oceniac : oceniać : (czas.) account | : (czas.) appraise | : (czas.) appreciate | : (czas.) assess | : (czas.) assessed | : (czas.) calculate | : (czas.) esteem | : (czas.) estimate | : (czas.) evaluate | : (czas.) judge | : (czas.) measure
ocenic : ocenić : (czas.) account | : (czas.) appraise | : (czas.) appreciate | : (czas.) judge | : (czas.) measure | : (czas.) rate
ocenzurowac : ocenzurować : (czas.) censor | : (czas.) censurer
ocet : ocet : (rzecz.) vinegar
och : och : (wykrzyknik) oh | : (wykrzyknik) ugh
ochlapac : ochlapać : (czas.) splash
ochlapus : ochlapus : (rzecz.) boozer
ochlapywac : ochlapywać : (czas.) splatter
ochmistrz : ochmistrz : (rzecz.) chamberlain
ochoczo : ochoczo : (przysł.) eagerly | : (przysł.) enthusiastically | : (przysł.) gaily | : (przysł.) gamely | : (przysł.) heartily | : (przysł.) hotfoot | : (przysł.) jauntily | : (przysł.) readily | : (przysł.) willingly | : (przysł.) zestfully
ochoczosc : ochoczość : (rzecz.) readiness
ochoczy : ochoczy : (przym.) cheerful | : (przym.) game | : (przym.) ready
ochota : ochota : (rzecz.) alacrity | : (rzecz.) craving | : (rzecz.) readiness | : (rzecz.) willingness | : (rzecz.) zest
ochotnik : ochotnik : (rzecz.) volunteer
ochra : ochra : (rzecz.) ochre
ochraniacz : ochraniacz : (rzecz.) bumper | : (rzecz.) fender | : (rzecz.) guard | : (rzecz.) pad | : (rzecz.) protector | : (rzecz.) screener | : (rzecz.) spacer
ochraniac : ochraniać : (czas.) protect | : (czas.) safeguard | : (czas.) shield
ochrona : ochrona : (rzecz.) bodyguard | : (rzecz.) conservation | : (rzecz.) custody | : (rzecz.) guard | : (rzecz.) precaution | : (rzecz.) preservation | : (rzecz.) preserver | : (rzecz.) protection | : (rzecz.) rampart | : (rzecz.) safeguard | : (rzecz.) security | : (rzecz.) shelter
ochroniarz : ochroniarz : (rzecz.) bodyguard | : (rzecz.) enforcer | : (rzecz.) guardsman | : (rzecz.) lifeguard
ochronic : ochronić : (czas.) protect
ochronka : ochronka : (rzecz.) nursery | : (rzecz.) orphanage
ochronnie : ochronnie : (przysł.) protectively
ochronnik : ochronnik : (rzecz.) protector
ochronny : ochronny : (przym.) preservative | : (przym.) preventive | : (przym.) prohibitive | : (przym.) protective | : (przym.) retardant
ochrypniecie : ochrypnięcie : (rzecz.) huskiness
ochryply : ochrypły : (przym.) hoarse
ochrzcic : ochrzcić : (czas.) baptize | : (czas.) christen
ochrzczenie : ochrzczenie : (rzecz.) baptism
ochwat : ochwat : (rzecz.) founder | : (rzecz.) laminitis
ochladzacz : ochładzacz : (rzecz.) cooler
ochladzalnik : ochładzalnik : (rzecz.) chill
ochladzanie : ochładzanie : (rzecz.) cooling | : (rzecz.) refrigeration
ochladzac : ochładzać : (czas.) chill | : (czas.) cool | : (czas.) freshen | : (czas.) refrigerate
ochlap : ochłap : (rzecz.) offal | : (rzecz.) pittance | : (rzecz.) scrap
ochloda : ochłoda : (rzecz.) coolness | : (rzecz.) refreshment
ochlodzenie : ochłodzenie : (rzecz.) cooling
ochlodzic : ochłodzić : (czas.) cool | : (czas.) cools | : (czas.) refrigerate
ochlonac : ochłonąć : (czas.) recover
ociekajacy : ociekający : (przym.) dripping
ociekanie : ociekanie : (rzecz.) dripping | : (rzecz.) gravity | : (rzecz.) water
ociekac : ociekać : (czas.) drip | : (czas.) stream
ocielic : ocielić : (czas.) calve | : (czas.) fawn
ocienianie : ocienianie : (rzecz.) shading
ocieniac : ocieniać : (czas.) overshadow | : (czas.) shade
ocieplacz : ocieplacz : (rzecz.) lining
ocieplac : ocieplać : (czas.) insulate
ocieplic : ocieplić : (czas.) warm
ocierac : ocierać : (czas.) abrade | : (czas.) brush | : (czas.) chafe | : (czas.) mix | : (czas.) scrape | : (czas.) wipe
ocios : ocios : (rzecz.) sidewall
ociosac : ociosać : (czas.) hew
ociagajacy : ociągający : (przym.) lingering
ociaganie : ociąganie : (rzecz.) reluctance
ociagac : ociągać : (czas.) dillydally | : (czas.) dilly-dally | : (czas.) draggle | : (czas.) hover | : (czas.) linger | : (czas.) quail | : (czas.) tarry
ociezale : ociężale : (przysł.) heavily | : (przysł.) ponderously
ociezalosc : ociężałość : (rzecz.) heaviness | : (rzecz.) indolence | : (rzecz.) inertia
ociezaly : ociężały : (przym.) tardy
ockniecie : ocknięcie : (rzecz.) awakening
ocknac : ocknąć : (czas.) awake
oclenie : oclenie : (rzecz.) clearance
oclic : oclić : (czas.) clear
octan : octan : (rzecz.) acetate
octowy : octowy : (przym.) acetic
ocucac : ocucać : (czas.) revive
ocucenie : ocucenie : (rzecz.) revival
ocucic : ocucić : (czas.) revive | : (czas.) rouse
ocyganic : ocyganić : (czas.) swindle
ocynkowac : ocynkować : (czas.) galvanize
ocynowac : ocynować : (czas.) tin-plate
oczarowanie : oczarowanie : (rzecz.) charm | : (rzecz.) enchantment | : (rzecz.) fascination | : (rzecz.) infatuation
oczarowany : oczarowany : (przym.) spellbound
oczarowac : oczarować : (czas.) becharm | : (czas.) bewitch | : (czas.) charm | : (czas.) enchant | : (czas.) enthral | : (czas.) fascinate | : (czas.) spellbind
oczarowywanie : oczarowywanie : (rzecz.) spellbinding
oczarowywac : oczarowywać : (czas.) beguile | : (czas.) bewitch | : (czas.) enchant | : (czas.) enthral | : (czas.) ravish
oczekiwany : oczekiwany : (przym.) pending
oczekiwac : oczekiwać : (czas.) abide | : (czas.) anticipate | : (czas.) await | : (czas.) expect | : (czas.) expected | : (czas.) listen | : (czas.) wait
oczekujacy : oczekujący : (przym.) pending
oczep : oczep : (rzecz.) wale
oczeret : oczeret : (rzecz.) bulrush
oczernianie : oczernianie : (rzecz.) defamation | : (rzecz.) mudslinging | : (rzecz.) slander
oczerniac : oczerniać : (czas.) backbite | : (czas.) besmirch | : (czas.) blacken | : (czas.) calumniate | : (czas.) decry | : (czas.) defame | : (czas.) detract | : (czas.) slander | : (czas.) slur | : (czas.) traduce
oczernienie : oczernienie : (rzecz.) denigration
oczernic : oczernić : (czas.) blacken | : (czas.) decry
oczko : oczko : (rzecz.) ace | : (rzecz.) asterisk | : (rzecz.) blackjack | : (rzecz.) eye | : (rzecz.) eyelet | : (rzecz.) ladder | : (rzecz.) mesh | : (rzecz.) stitch | : (rzecz.) stone
oczkowac : oczkować : (czas.) bud
oczny : oczny : (przym.) ocular | : (przym.) ophthalmic | : (przym.) optic
oczodolowy : oczodołowy : (przym.) orbital
oczodol : oczodół : (rzecz.) socket
oczy : oczy : (rzecz.) eyes
oczyszczacz : oczyszczacz : (rzecz.) cleaner | : (rzecz.) purifier
oczyszczalnia : oczyszczalnia : (rzecz.) treatment
oczyszczalnik : oczyszczalnik : (rzecz.) cleaner | : (rzecz.) purifier
oczyszczanie : oczyszczanie : (rzecz.) cleaning | : (rzecz.) cleansing | : (rzecz.) clearing | : (rzecz.) expurgation | : (rzecz.) purge | : (rzecz.) purification | : (rzecz.) refinement | : (rzecz.) scavenging
oczyszczarka : oczyszczarka : (rzecz.) cleaner
oczyszczac : oczyszczać : (czas.) brighten | : (czas.) brush | : (czas.) chasten | : (czas.) clarify | : (czas.) cleanse | : (czas.) expurgate | : (czas.) purge | : (czas.) purify | : (czas.) rectify | : (czas.) refine | : (czas.) rid | : (czas.) sanctify | : (czas.) scavenge | : (czas.) treat
oczyszczenie : oczyszczenie : (rzecz.) catharsis | : (rzecz.) cleaning | : (rzecz.) clearance | : (rzecz.) defecation | : (rzecz.) purgation | : (rzecz.) purge | : (rzecz.) purification
oczytanie : oczytanie : (rzecz.) reading
oczytany : oczytany : (przym.) lettered
oczywistosc : oczywistość : (rzecz.) clearness | : (rzecz.) evidence | : (rzecz.) obviousness
oczywisty : oczywisty : (przym.) apparent | : (przym.) clear | : (przym.) cut-and-dried | : (przym.) evident | : (przym.) manifest | : (przym.) obvious | : (przym.) patent | : (przym.) plain | : (przym.) self-evident | : (przym.) self-explanatory | : (przym.) unmistakable
oczywiscie : oczywiście : (przysł.) absolutely | : (przysł.) ay | : (przysł.) aye | : (przysł.) certainly | : (przysł.) definitely | : (przysł.) evidently | : (przysł.) naturally | : (przysł.) obviously | : (przysł.) rather
oczyscic : oczyścić : (czas.) absolve | : (czas.) clarify | : (czas.) clean | : (czas.) cleanse | : (czas.) rid
od : od : (przyim.) from | : (przyim.) of | : (przyim.) off | : (przyim.) since
oda : oda : (rzecz.) ode
odautorski : odautorski : (przym.) author's
odbarwianie : odbarwianie : (rzecz.) decolourisation
odbarwiac : odbarwiać : (czas.) decolorize | : (czas.) decolour | : (czas.) decolourize | : (czas.) discolour
odbarwienie : odbarwienie : (rzecz.) discoloration | : (rzecz.) discolouration
odbarwic : odbarwić : (czas.) discolour
odbezpieczac : odbezpieczać : (czas.) unlock
odbicie : odbicie : (rzecz.) bounce | : (rzecz.) image | : (rzecz.) impression | : (rzecz.) imprint | : (rzecz.) mirror | : (rzecz.) parry | : (rzecz.) rebound | : (rzecz.) reflection | : (rzecz.) reflex | : (rzecz.) repercussion | : (rzecz.) rescue | : (rzecz.) return | : (rzecz.) shadow
odbieganie : odbieganie : (rzecz.) departure | : (rzecz.) scamper
odbiegac : odbiegać : (czas.) depart | : (czas.) digress | : (czas.) diverge
odbielanie : odbielanie : (rzecz.) bleaching
odbieracz : odbieracz : (rzecz.) doffer
odbierak : odbierak : (rzecz.) collector
odbieralnik : odbieralnik : (rzecz.) receiver | : (rzecz.) receptacle
odbierac : odbierać : (czas.) answer | : (czas.) collect | : (czas.) construe | : (czas.) discourage | : (czas.) disfranchise | : (czas.) pick | : (czas.) receive | : (czas.) reclaim | : (czas.) retake
odbijacz : odbijacz : (rzecz.) fender
odbijajacy : odbijający : (przym.) reflective | : (przym.) resilient
odbijak : odbijak : (rzecz.) knocker-off
odbijanie : odbijanie : (rzecz.) belching | : (rzecz.) eructation | : (rzecz.) printing
odbijac : odbijać : (czas.) bandy | : (czas.) bounce | : (czas.) echo | : (czas.) eruct | : (czas.) imprint | : (czas.) mirror | : (czas.) rebound | : (czas.) recapture | : (czas.) reflect | : (czas.) retake | : (czas.) reverberate | : (czas.) stamp
odbiorca : odbiorca : (rzecz.) audience | : (rzecz.) consignee | : (rzecz.) consumer | : (rzecz.) payee | : (rzecz.) receiver | : (rzecz.) recipient | : (rzecz.) user
odbiorczy : odbiorczy : (przym.) recipient
odbiornik : odbiornik : (rzecz.) listener | : (rzecz.) radioed | : (rzecz.) receiver | : (rzecz.) set
odbitka : odbitka : (rzecz.) blueprint | : (rzecz.) copy | : (rzecz.) ectype | : (rzecz.) heliotype | : (rzecz.) offprint | : (rzecz.) off-print | : (rzecz.) print | : (rzecz.) reprint
odbior : odbiór : (rzecz.) collection | : (rzecz.) over | : (rzecz.) receipt | : (rzecz.) reception
odbic : odbić : (czas.) eruct | : (czas.) rebound | : (czas.) recapture
odblask : odblask : (rzecz.) gleam | : (rzecz.) halo | : (rzecz.) reflection
odblaskowy : odblaskowy : (przym.) reflective
odblokowac : odblokować : (czas.) clear | : (czas.) unblock | : (czas.) unfreeze | : (czas.) unlock
odblokowywac : odblokowywać : (czas.) unblock | : (czas.) unlock
odbojnica : odbojnica : (rzecz.) check
odbojnosc : odbojność : (rzecz.) resilience | : (rzecz.) resiliency
odbrazawiac : odbrązawiać : (czas.) debunk
odbudowa : odbudowa : (rzecz.) reconstruction | : (rzecz.) restoration
odbudowanie : odbudowanie : (rzecz.) reconstruction
odbudowac : odbudować : (czas.) rebuild | : (czas.) rebuilt | : (czas.) reconstruct | : (czas.) redevelop | : (czas.) restore
odbudowywac : odbudowywać : (czas.) rebuild | : (czas.) reconstruct
odbyt : odbyt : (rzecz.) anus
odbytnica : odbytnica : (rzecz.) anus | : (rzecz.) rectum
odbytnicowy : odbytnicowy : (przym.) recta
odbytniczy : odbytniczy : (przym.) anal | : (przym.) rectal
odbytowy : odbytowy : (przym.) anal
odbywac : odbywać : (czas.) done | : (czas.) hold | : (czas.) serve
odbyc : odbyć : (czas.) done
odboj : odbój : (rzecz.) buffer | : (rzecz.) fender
odbebnic : odbębnić : (czas.) drum
odblysnik : odbłyśnik : (rzecz.) reflector
odcedzanie : odcedzanie : (rzecz.) straining
odcedzac : odcedzać : (czas.) drain
odcedzic : odcedzić : (czas.) drain | : (czas.) strain
odchody : odchody : (rzecz.) discharges | : (rzecz.) droppings | : (rzecz.) excrement | : (rzecz.) faeces | : (rzecz.) manure | : (rzecz.) ordure
odchodzic : odchodzić : (czas.) depart | : (czas.) retire
odchowac : odchować : (czas.) feed
odchrzakiwac : odchrząkiwać : (czas.) hawk
odchrzakniecie : odchrząknięcie : (rzecz.) hem
odchudzac : odchudzać : (czas.) diet | : (czas.) slim
odchudzic : odchudzić : (czas.) slim
odchwascic : odchwaścić : (czas.) weed
odchylanie : odchylanie : (rzecz.) deflection | : (rzecz.) deviation | : (rzecz.) sweeping
odchylac : odchylać : (czas.) deflect | : (czas.) deviate | : (czas.) diverge | : (czas.) divert | : (czas.) evade | : (czas.) rake | : (czas.) swerve
odchylenie : odchylenie : (rzecz.) aberration | : (rzecz.) bias | : (rzecz.) declension | : (rzecz.) deflection | : (rzecz.) departure | : (rzecz.) deviation | : (rzecz.) divergence | : (rzecz.) diversion | : (rzecz.) swelter | : (rzecz.) variation | : (rzecz.) yaw
odchylic : odchylić : (czas.) move
odchylka : odchyłka : (rzecz.) deviation
odciek : odciek : (rzecz.) efflux
odcierpiec : odcierpieć : (czas.) expiate
odcien : odcień : (rzecz.) hue | : (rzecz.) nuance | : (rzecz.) shade | : (rzecz.) shadow | : (rzecz.) spice | : (rzecz.) streak | : (rzecz.) tincture | : (rzecz.) tinge | : (rzecz.) tint | : (rzecz.) tone
odcinak : odcinak : (rzecz.) cut-off
odcinanie : odcinanie : (rzecz.) sheaf | : (rzecz.) shear
odcinac : odcinać : (czas.) dissociate | : (czas.) handle | : (czas.) lop | : (czas.) retort | : (czas.) sever | : (czas.) shutoff
odcinek : odcinek : (rzecz.) counterfoil | : (rzecz.) coupon | : (rzecz.) episode | : (rzecz.) exergue | : (rzecz.) instalment | : (rzecz.) length | : (rzecz.) part | : (rzecz.) section | : (rzecz.) sector | : (rzecz.) segment | : (rzecz.) snip | : (rzecz.) stub
odcinkowy : odcinkowy : (przym.) segmental | : (przym.) serial
odcisk : odcisk : (rzecz.) blister | : (rzecz.) corn | : (rzecz.) fingerprint | : (rzecz.) footprint | : (rzecz.) impression | : (rzecz.) imprint | : (rzecz.) print | : (rzecz.) stamp
odciskac : odciskać : (czas.) impress
odcisnac : odcisnąć : (czas.) impress
odciag : odciąg : (rzecz.) guy | : (rzecz.) stay
odciaga : odciąga : (rzecz.) broaching
odciaganie : odciąganie : (rzecz.) drafting
odciagac : odciągać : (czas.) decoy | : (czas.) deduct | : (czas.) detract | : (czas.) distract | : (czas.) divert | : (czas.) hitch
odciagniecie : odciągnięcie : (rzecz.) revulsion
odciac : odciąć : (czas.) ablate | : (czas.) amputate | : (czas.) snip
odciazac : odciążać : (czas.) unburden
odciazyc : odciążyć : (czas.) lighten | : (czas.) unburden | : (czas.) unload
odciecie : odcięcie : (rzecz.) amputation | : (rzecz.) cut | : (rzecz.) cut-off | : (rzecz.) lockout | : (rzecz.) lock-out | : (rzecz.) snip
odcieta : odcięta : (rzecz.) abscissa
odcisniecie : odciśnięcie : (rzecz.) trace
odcumowanie : odcumowanie : (rzecz.) unmoor
odcumowac : odcumować : (czas.) unmoor
odcyfrowanie : odcyfrowanie : (rzecz.) decipherment
odcyfrowac : odcyfrować : (czas.) decipher | : (czas.) decode
odcyfrowywac : odcyfrowywać : (czas.) decipher
odczarowanie : odczarowanie : (rzecz.) disenchantment
odczarowac : odczarować : (czas.) disenchant
odczasownikowy : odczasownikowy : (przym.) verbal
odczekac : odczekać : (czas.) wait
odczepiac : odczepiać : (czas.) detach | : (czas.) uncouple | : (czas.) unfasten | : (czas.) unhitch | : (czas.) unlink
odczepienie : odczepienie : (rzecz.) disconnection
odczepic : odczepić : (czas.) detach | : (czas.) unfix
odczucie : odczucie : (rzecz.) feeling | : (rzecz.) sensation | : (rzecz.) sentiment
odczulanie : odczulanie : (rzecz.) desensitization
odczulac : odczulać : (czas.) desensitise | : (czas.) desensitize
odczulenie : odczulenie : (rzecz.) desensitization | : (rzecz.) felt
odczulic : odczulić : (czas.) desensitise
odczuwalnosc : odczuwalność : (rzecz.) perceptibility
odczuwalny : odczuwalny : (przym.) noticeable | : (przym.) palpable | : (przym.) perceptible
odczuwanie : odczuwanie : (rzecz.) feel
odczuwac : odczuwać : (czas.) feel
odczuc : odczuć : (czas.) perceive
odczyn : odczyn : (rzecz.) reaction
odczynnik : odczynnik : (rzecz.) agent | : (rzecz.) reagent
odczyszczenie : odczyszczenie : (rzecz.) cleaning
odczyt : odczyt : (rzecz.) lecture | : (rzecz.) non-return-to-reference | : (rzecz.) non-return-to-zero | : (rzecz.) readout
odczytanie : odczytanie : (rzecz.) reading
odczytac : odczytać : (czas.) decode | : (czas.) read | : (czas.) retrieve
odczytywanie : odczytywanie : (rzecz.) reading
odczytywac : odczytywać : (czas.) read | : (czas.) sense
odczyscic : odczyścić : (czas.) clean
oddalac : oddalać : (czas.) avert | : (czas.) disallow | : (czas.) dismiss | : (czas.) overrule | : (czas.) recede | : (czas.) relegate | : (czas.) remove | : (czas.) wean
oddalenie : oddalenie : (rzecz.) dismissal | : (rzecz.) distance | : (rzecz.) estrangement | : (rzecz.) remoteness
oddalic : oddalić : (czas.) avert | : (czas.) dismiss | : (czas.) rejected | : (czas.) remove
oddanie : oddanie : (rzecz.) abandonment | : (rzecz.) commitment | : (rzecz.) dedication | : (rzecz.) devotion | : (rzecz.) disposal | : (rzecz.) faithfulness | : (rzecz.) putting | : (rzecz.) rendition | : (rzecz.) surrender
oddany : oddany : (przym.) dedicated | : (przym.) devoted
oddawanie : oddawanie : (rzecz.) donation | : (rzecz.) render | : (rzecz.) restitution
oddawac : oddawać : (czas.) addict | : (czas.) cast | : (czas.) convey | : (czas.) devote | : (czas.) indulge | : (czas.) reverberate | : (czas.) submit
oddawca : oddawca : (rzecz.) deliverer
oddac : oddać : (czas.) cast | : (czas.) dedicate | : (czas.) grant | : (czas.) remit
oddech : oddech : (rzecz.) breath | : (rzecz.) breathing | : (rzecz.) respiration
oddechowy : oddechowy : (przym.) respiratory
oddolny : oddolny : (przym.) bottom-up
oddychanie : oddychanie : (rzecz.) breathing | : (rzecz.) respiration
oddychac : oddychać : (czas.) breathe | : (czas.) respire | : (czas.) suspire
oddzial : oddział : (rzecz.) affiliate | : (rzecz.) agency | : (rzecz.) body | : (rzecz.) branch | : (rzecz.) compartment | : (rzecz.) department | : (rzecz.) detachment | : (rzecz.) division | : (rzecz.) form | : (rzecz.) picket | : (rzecz.) posse | : (rzecz.) section | : (rzecz.) squad | : (rzecz.) subsidiary | : (rzecz.) troop | : (rzecz.) ward
oddzialowy : oddziałowy : (przym.) departmental
oddzialywanie : oddziaływanie : (rzecz.) impact | : (rzecz.) influence | : (rzecz.) interplay | : (rzecz.) power
oddzialywac : oddziaływać : (czas.) affect | : (czas.) interact
oddzielacz : oddzielacz : (rzecz.) separator
oddzielanie : oddzielanie : (rzecz.) separation
oddzielac : oddzielać : (czas.) abstract | : (czas.) detach | : (czas.) disengage | : (czas.) disestablish | : (czas.) dissever | : (czas.) dissociate | : (czas.) isolate | : (czas.) part | : (czas.) seclude | : (czas.) separate | : (czas.) separated | : (czas.) sever
oddzielenie : oddzielenie : (rzecz.) abstraction | : (rzecz.) detachment | : (rzecz.) dieresis | : (rzecz.) extrication | : (rzecz.) isolation | : (rzecz.) secession | : (rzecz.) seclusion | : (rzecz.) separation | : (rzecz.) severance
oddzielic : oddzielić : (czas.) disestablish | : (czas.) separated
oddzielnie : oddzielnie : (przysł.) apart | : (przysł.) extra | : (przysł.) separately | : (przysł.) severally
oddzielny : oddzielny : (przym.) distinct | : (przym.) extra | : (przym.) separable | : (przym.) separate | : (przym.) several | : (przym.) single
oddzwanianie : oddzwanianie : (rzecz.) dial-back
oddzwiek : oddźwięk : (rzecz.) chord | : (rzecz.) echo | : (rzecz.) repercussion | : (rzecz.) response
odebranie : odebranie : (rzecz.) disqualification | : (rzecz.) reception | : (rzecz.) return
odebrac : odebrać : (czas.) answer | : (czas.) deprive | : (czas.) revoke
odegranie : odegranie : (rzecz.) enactment | : (rzecz.) play | : (rzecz.) playing
odegrac : odegrać : (czas.) play
odejmowalny : odejmowalny : (przym.) detachable
odejmowanie : odejmowanie : (rzecz.) deduction | : (rzecz.) subtraction
odejmowany : odejmowany : (przym.) demountable | : (przym.) detachable | : (przym.) removable
odejmowac : odejmować : (czas.) deduct | : (czas.) disable | : (czas.) subtract
odejscie : odejście : (rzecz.) departure | : (rzecz.) exit | : (rzecz.) going | : (rzecz.) recess
odejsc : odejść : (czas.) abort | : (czas.) depart | : (czas.) go | : (czas.) leave | : (czas.) retire
odepchniecie : odepchnięcie : (rzecz.) push | : (rzecz.) rebuff | : (rzecz.) repulse
odepchniety : odepchnięty : (przym.) outcast
odeprzec : odeprzeć : (czas.) fend | : (czas.) rebuff | : (czas.) rebut | : (czas.) repel
oderwanie : oderwanie : (rzecz.) avulsion | : (rzecz.) detachment | : (rzecz.) distraction | : (rzecz.) lift-off | : (rzecz.) separation | : (rzecz.) severance
oderwany : oderwany : (przym.) abstract
oderwac : oderwać : (czas.) detach | : (czas.) detached | : (czas.) distract | : (czas.) loosen | : (czas.) secede | : (czas.) tear
odeskowanie : odeskowanie : (rzecz.) timbering
odeslanie : odesłanie : (rzecz.) reference | : (rzecz.) referral | : (rzecz.) remitter
odeslac : odesłać : (czas.) return
odetkac : odetkać : (czas.) unblock | : (czas.) unstop
odezwa : odezwa : (rzecz.) address | : (rzecz.) appeal | : (rzecz.) manifesto | : (rzecz.) proclamation
odezwanie : odezwanie : (rzecz.) response | : (rzecz.) saying
odezwac : odezwać : (czas.) address | : (czas.) speak
odfajkowac : odfajkować : (czas.) tick
odfiltrowac : odfiltrować : (czas.) filter
odfiltrowywac : odfiltrowywać : (czas.) filter
odgadniecie : odgadnięcie : (rzecz.) second-guessing
odgadywac : odgadywać : (czas.) assume | : (czas.) guess
odgazowanie : odgazowanie : (rzecz.) degassing
odgazowac : odgazować : (czas.) degas
odgazowywanie : odgazowywanie : (rzecz.) degasification | : (rzecz.) degasifying | : (rzecz.) degassed | : (rzecz.) degassing
odgazowywac : odgazowywać : (czas.) degas | : (czas.) degasify
odgaleziac : odgałęziać : (czas.) branch
odgalezienie : odgałęzienie : (rzecz.) branch | : (rzecz.) branching | : (rzecz.) fork | : (rzecz.) offset | : (rzecz.) offshoot | : (rzecz.) spur | : (rzecz.) turnoff
odginac : odginać : (czas.) deflect | : (czas.) straighten | : (czas.) unbend
odgiac : odgiąć : (czas.) straighten | : (czas.) unbend
odgniecenie : odgniecenie : (rzecz.) gall | : (rzecz.) impression
odgniesc : odgnieść : (czas.) bruise
odgradzac : odgradzać : (czas.) isolate
odgraniczac : odgraniczać : (czas.) separate
odgraniczony : odgraniczony : (przym.) bounded
odgraniczyc : odgraniczyć : (czas.) shut
odgrazac : odgrażać : (czas.) menace | : (czas.) threaten
odgromnik : odgromnik : (rzecz.) arrester | : (rzecz.) discharger
odgrywac : odgrywać : (czas.) enact | : (czas.) impersonate | : (czas.) perform | : (czas.) play
odgryzc : odgryźć : (czas.) bite
odgrzac : odgrzać : (czas.) reheat
odgrzebac : odgrzebać : (czas.) disinter
odgorny : odgórny : (przym.) top-down
odglos : odgłos : (rzecz.) echo | : (rzecz.) noise | : (rzecz.) report | : (rzecz.) sound
odhaczac : odhaczać : (czas.) unhook
odhaczyc : odhaczyć : (czas.) unhook
odizolowanie : odizolowanie : (rzecz.) isolation | : (rzecz.) seclusion
odizolowac : odizolować : (czas.) detach | : (czas.) insulate | : (czas.) isolate
odizolowywac : odizolowywać : (czas.) seclude
odjazd : odjazd : (rzecz.) clearance | : (rzecz.) departure
odjazdowy : odjazdowy : (przym.) cool
odjechac : odjechać : (czas.) depart | : (czas.) leave
odjemna : odjemna : (rzecz.) minuend
odjemnik : odjemnik : (rzecz.) subtrahend
odjezdzac : odjeżdżać : (czas.) depart | : (czas.) leave
odjac : odjąć : (czas.) ablate | : (czas.) subtract
odjecie : odjęcie : (rzecz.) subtraction
odkarmic : odkarmić : (czas.) feed
odkaszlniecie : odkaszlnięcie : (rzecz.) hem
odkazic : odkazić : (czas.) disinfect | : (czas.) disinfected
odkazanie : odkażanie : (rzecz.) chlorination | : (rzecz.) decontamination | : (rzecz.) disinfectant | : (rzecz.) fumigation
odkazac : odkażać : (czas.) decontaminate | : (czas.) disinfect
odkazenie : odkażenie : (rzecz.) decontamination | : (rzecz.) disinfection | : (rzecz.) sterilisation
odkleic : odkleić : (czas.) unglue
odklejanie : odklejanie : (rzecz.) boiling-off | : (rzecz.) deglutination
odklejac : odklejać : (czas.) detach | : (czas.) unglue
odkomenderowac : odkomenderować : (czas.) attach | : (czas.) detach | : (czas.) draft
odkopac : odkopać : (czas.) unearth
odkopywac : odkopywać : (czas.) excavate | : (czas.) unearth
odkorkowac : odkorkować : (czas.) uncork
odkorkowywac : odkorkowywać : (czas.) uncork
odkrycia : odkrycia : (rzecz.) discoveries
odkrycie : odkrycie : (rzecz.) detection | : (rzecz.) disclosure | : (rzecz.) discovery | : (rzecz.) find | : (rzecz.) finding | : (rzecz.) revelation | : (rzecz.) showdown
odkrywanie : odkrywanie : (rzecz.) discovery | : (rzecz.) exploration
odkrywac : odkrywać : (czas.) bare | : (czas.) detect | : (czas.) discover | : (czas.) find | : (czas.) make | : (czas.) reveal | : (czas.) support | : (czas.) uncover
odkrywca : odkrywca : (rzecz.) discoverer | : (rzecz.) explorer | : (rzecz.) finder
odkrywcy : odkrywcy : (rzecz.) discoverers
odkrywczosc : odkrywczość : (rzecz.) novelty
odkrywczy : odkrywczy : (przym.) explorative | : (przym.) exploratory | : (przym.) revealing | : (przym.) visionary
odkrywczyni : odkrywczyni : (rzecz.) discoverer
odkrywka : odkrywka : (rzecz.) opencast | : (rzecz.) outcrop
odkrywkowy : odkrywkowy : (przym.) opencast
odkryc : odkryć : (czas.) detect | : (czas.) discover | : (czas.) find | : (czas.) reveal | : (czas.) uncover | : (czas.) unhide | : (czas.) unveil
odkrztuszanie : odkrztuszanie : (rzecz.) expectoration
odkrecac : odkręcać : (czas.) unbolt | : (czas.) unscrew
odkrecic : odkręcić : (czas.) unbolt | : (czas.) unscrew
odksztalcalnosc : odkształcalność : (rzecz.) deformability | : (rzecz.) formability
odksztalcalny : odkształcalny : (przym.) deformable
odksztalcanie : odkształcanie : (rzecz.) straining
odksztalcac : odkształcać : (czas.) buckle | : (czas.) deform
odksztalcenie : odkształcenie : (rzecz.) distortion | : (rzecz.) strain | : (rzecz.) straining
odksztalcic : odkształcić : (czas.) buckle | : (czas.) strain
odkupiciel : odkupiciel : (rzecz.) redeemer
odkupicielski : odkupicielski : (przym.) redemptive
odkupienie : odkupienie : (rzecz.) expiation | : (rzecz.) redemption | : (rzecz.) salvation
odkupic : odkupić : (czas.) buy | : (czas.) redeem | : (czas.) repurchase
odkupny : odkupny : (przym.) redeemable
odkupywanie : odkupywanie : (rzecz.) repurchased
odkupywac : odkupywać : (czas.) redeem
odkurzacz : odkurzacz : (rzecz.) carpet-sweeper | : (rzecz.) charwoman | : (rzecz.) cleaner | : (rzecz.) vacuum
odkurzanie : odkurzanie : (rzecz.) dust | : (rzecz.) dusting
odkurzac : odkurzać : (czas.) dust | : (czas.) vacuum
odkurzyc : odkurzyć : (czas.) vacuum
odkuc : odkuć : (czas.) remove
odkad : odkąd : (przysł.) since | : (przysł.) when
odklad : odkład : (rzecz.) slip
odkladanie : odkładanie : (rzecz.) deposition
odkladac : odkładać : (czas.) accumulate | : (czas.) delay | : (czas.) deposit | : (czas.) postpone | : (czas.) postponed | : (czas.) procrastinate | : (czas.) save | : (czas.) stow
odkladnica : odkładnica : (rzecz.) mouldboard
odlatywac : odlatywać : (czas.) depart
odlac : odlać : (czas.) pee | : (czas.) piss
odleglosciomierz : odległościomierz : (rzecz.) rangefinder | : (rzecz.) range-finder
odleglosc : odległość : (rzecz.) distance | : (rzecz.) length | : (rzecz.) prospect | : (rzecz.) remoteness | : (rzecz.) space
odlegly : odległy : (przym.) distant | : (przym.) equidistant | : (przym.) far | : (przym.) faraway | : (przym.) far-off | : (przym.) remote
odlepianie : odlepianie : (rzecz.) deglutination
odlepiac : odlepiać : (czas.) detach
odlepic : odlepić : (czas.) detach
odlew : odlew : (rzecz.) cast
odlewanie : odlewanie : (rzecz.) casting | : (rzecz.) pouring
odlewarka : odlewarka : (rzecz.) caster
odlewac : odlewać : (czas.) cast | : (czas.) drain | : (czas.) found | : (czas.) mould | : (czas.) piss
odlewnia : odlewnia : (rzecz.) foundry
odlewnictwo : odlewnictwo : (rzecz.) casting | : (rzecz.) foundry
odlewnik : odlewnik : (rzecz.) caster | : (rzecz.) founder
odlezec : odleżeć : (czas.) mellow
odlezyna : odleżyna : (rzecz.) bedside | : (rzecz.) bedsore
odliczanie : odliczanie : (rzecz.) count | : (rzecz.) countdown
odliczac : odliczać : (czas.) count | : (czas.) deduct
odliczenie : odliczenie : (rzecz.) deduction
odliczyc : odliczyć : (czas.) deduct
odlot : odlot : (rzecz.) departure | : (rzecz.) migration | : (rzecz.) takeoff | : (rzecz.) take-off
odlotowy : odlotowy : (przym.) cool | : (przym.) snazzy
odludek : odludek : (rzecz.) anchorite | : (rzecz.) misanthropist | : (rzecz.) recluse
odludny : odludny : (przym.) desolate | : (przym.) lone | : (przym.) lonely | : (przym.) lonesome | : (przym.) solitary
odludzie : odludzie : (rzecz.) seclusion | : (rzecz.) wilderness
odlutowac : odlutować : (czas.) unsolder
odmaczac : odmaczać : (czas.) soak
odmagnesowac : odmagnesować : (czas.) demagnetize
odmagnesowywac : odmagnesowywać : (czas.) demagnetize
odmalowac : odmalować : (czas.) redecorate | : (czas.) repaint
odmarzac : odmarzać : (czas.) defrost | : (czas.) melt | : (czas.) thaw
odmawiac : odmawiać : (czas.) contradict | : (czas.) default | : (czas.) denied | : (czas.) deny | : (czas.) rebuff | : (czas.) refuse | : (czas.) refused | : (czas.) repudiate | : (czas.) revoke
odmiana : odmiana : (rzecz.) alteration | : (rzecz.) alternation | : (rzecz.) brand | : (rzecz.) change | : (rzecz.) conjugation | : (rzecz.) decline | : (rzecz.) inflection | : (rzecz.) inflexion | : (rzecz.) softball | : (rzecz.) strain | : (rzecz.) variation | : (rzecz.) variety
odmieniac : odmieniać : (czas.) conjugate | : (czas.) inflect | : (czas.) transform
odmieniec : odmieniec : (rzecz.) changeling
odmienic : odmienić : (czas.) change | : (czas.) inflect | : (czas.) transform
odmiennie : odmiennie : (przysł.) differently
odmiennosc : odmienność : (rzecz.) dissimilarity | : (rzecz.) distinctness | : (rzecz.) otherness
odmienny : odmienny : (przym.) alien | : (przym.) declinable | : (przym.) different | : (przym.) disparate | : (przym.) dissident | : (przym.) dissimilar | : (przym.) distinct | : (przym.) diverse | : (przym.) variant
odmierzanie : odmierzanie : (rzecz.) metering
odmierzenie : odmierzenie : (rzecz.) metering
odmierzyc : odmierzyć : (czas.) measure
odmineralizowanie : odmineralizowanie : (rzecz.) demineralization
odmotac : odmotać : (czas.) disentangle
odmowa : odmowa : (rzecz.) denial | : (rzecz.) negation | : (rzecz.) no | : (rzecz.) rebuff | : (rzecz.) refusal | : (rzecz.) rejection | : (rzecz.) repudiation | : (rzecz.) repulse | : (rzecz.) scandal
odmownie : odmownie : (przysł.) negatively | : (przysł.) unfavourably
odmowny : odmowny : (przym.) negative
odmrazacz : odmrażacz : (rzecz.) antifreeze | : (rzecz.) defroster
odmrazac : odmrażać : (czas.) defrost
odmrozic : odmrozić : (czas.) defrost | : (czas.) freeze
odmrozenie : odmrożenie : (rzecz.) chilblain | : (rzecz.) defrosting | : (rzecz.) frostbite | : (rzecz.) frost-bite
odmrozony : odmrożony : (przym.) frostbitten
odmulanie : odmulanie : (rzecz.) blowing-down | : (rzecz.) blow-off
odmulac : odmulać : (czas.) elutriate
odmowienie : odmówienie : (rzecz.) denial
odmowic : odmówić : (czas.) contradict | : (czas.) deny | : (czas.) rebuff | : (czas.) refuse | : (czas.) refused | : (czas.) repudiate | : (czas.) revoke | : (czas.) withhold
odmet : odmęt : (rzecz.) vortex
odmladzanie : odmładzanie : (rzecz.) rejuvenation
odmladzac : odmładzać : (czas.) rejuvenate
odmlodniec : odmłodnieć : (czas.) feel | : (czas.) rejuvenate
odmlodzenie : odmłodzenie : (rzecz.) rejuvenation
odnajdowanie : odnajdowanie : (rzecz.) discovery | : (rzecz.) finding
odnajdowac : odnajdować : (czas.) find
odnajdywac : odnajdywać : (czas.) find
odnajac : odnająć : (czas.) rent
odnalezienie : odnalezienie : (rzecz.) discovery | : (rzecz.) retrieval | : (rzecz.) retrievals
odnalezc : odnaleźć : (czas.) found | : (czas.) trace
odnawialny : odnawialny : (przym.) renewable
odnawianie : odnawianie : (rzecz.) refurbishment | : (rzecz.) renewal
odnawiac : odnawiać : (czas.) decorate | : (czas.) recapitalize | : (czas.) recondition | : (czas.) redecorate | : (czas.) refurbish | : (czas.) regenerate | : (czas.) reload | : (czas.) renew | : (czas.) renovate | : (czas.) renovated | : (czas.) rest | : (czas.) restore | : (czas.) revamp
odniesienie : odniesienie : (rzecz.) cross-reference | : (rzecz.) reference | : (rzecz.) referral | : (rzecz.) regard
odniesc : odnieść : (czas.) apply | : (czas.) refer
odnoga : odnoga : (rzecz.) arm | : (rzecz.) branch | : (rzecz.) leg | : (rzecz.) offshoot | : (rzecz.) spur
odnosic : odnosić : (czas.) appertain | : (czas.) belong | : (czas.) concern | : (czas.) pertain | : (czas.) refer | : (czas.) relate | : (czas.) take
odnoszenie : odnoszenie : (rzecz.) carriage
odnotowac : odnotować : (czas.) record
odnotowywac : odnotowywać : (czas.) record
odnowa : odnowa : (rzecz.) renewal | : (rzecz.) renovation | : (rzecz.) restoration
odnowiciel : odnowiciel : (rzecz.) restorer
odnowienie : odnowienie : (rzecz.) redecoration | : (rzecz.) refurbishment | : (rzecz.) renewal | : (rzecz.) renovation
odnowic : odnowić : (czas.) decorate | : (czas.) recondition | : (czas.) reload | : (czas.) renew
odnosnie : odnośnie : (przysł.) about | : (przysł.) apropos
odnosnik : odnośnik : (rzecz.) cross-reference | : (rzecz.) footnote | : (rzecz.) hotlink | : (rzecz.) reference
odnosny : odnośny : (przym.) pertinent | : (przym.) referential | : (przym.) related | : (przym.) relative | : (przym.) relevant | : (przym.) respective | : (przym.) underlying
odnozka : odnóżka : (rzecz.) shoot
odosabniac : odosabniać : (czas.) insulate | : (czas.) seclude
odosobniac : odosobniać : (czas.) isolate
odosobnienie : odosobnienie : (rzecz.) confinement | : (rzecz.) detachment | : (rzecz.) detention | : (rzecz.) hermitage | : (rzecz.) isolation | : (rzecz.) privacy | : (rzecz.) seclusion
odosobniony : odosobniony : (przym.) insular | : (przym.) secluded | : (przym.) solitary
odosobnic : odosobnić : (czas.) box | : (czas.) isolate | : (czas.) maroon
odpad : odpad : (rzecz.) refuse | : (rzecz.) waste
odpadanie : odpadanie : (rzecz.) abandonment | : (rzecz.) secession
odpadac : odpadać : (czas.) fall
odpadek : odpadek : (rzecz.) fag-end | : (rzecz.) garbage | : (rzecz.) junk | : (rzecz.) spoilage | : (rzecz.) waste
odpadki : odpadki : (rzecz.) garbage | : (rzecz.) leavings | : (rzecz.) offal | : (rzecz.) refuse | : (rzecz.) rubbish | : (rzecz.) tailings | : (rzecz.) tails | : (rzecz.) trash
odpadkowy : odpadkowy : (przym.) residuary | : (przym.) spent
odpadowy : odpadowy : (przym.) waste
odpady : odpady : (rzecz.) discards
odpakowac : odpakować : (czas.) unpack | : (czas.) unwrap
odpakowywac : odpakowywać : (czas.) unpack
odpalac : odpalać : (czas.) fire | : (czas.) launch
odpalenie : odpalenie : (rzecz.) blastoff | : (rzecz.) blast-off | : (rzecz.) firing | : (rzecz.) smoke
odpalic : odpalić : (czas.) fire
odparcie : odparcie : (rzecz.) disproof | : (rzecz.) parry | : (rzecz.) rebuttal | : (rzecz.) repulse
odparowanie : odparowanie : (rzecz.) evaporation | : (rzecz.) vaporization
odparowac : odparować : (czas.) defog | : (czas.) evaporate | : (czas.) parry
odparowywacz : odparowywacz : (rzecz.) vaporizer
odparowywanie : odparowywanie : (rzecz.) evaporation | : (rzecz.) vaporization
odparowywac : odparowywać : (czas.) evaporate | : (czas.) retort | : (czas.) vaporize
odparzenie : odparzenie : (rzecz.) blister | : (rzecz.) chafe | : (rzecz.) scald
odparzyc : odparzyć : (czas.) chafe
odpasac : odpasać : (czas.) unbind
odpasc : odpaść : (czas.) fall | : (czas.) lapse
odpieczetowac : odpieczętować : (czas.) unseal
odpieprzyc : odpieprzyć : (czas.) fuck
odpierac : odpierać : (czas.) confute | : (czas.) counter | : (czas.) deflect | : (czas.) parry | : (czas.) rebut | : (czas.) refute | : (czas.) repel | : (czas.) retort
odpinac : odpinać : (czas.) unbuckle | : (czas.) unbutton | : (czas.) uncouple | : (czas.) unfasten | : (czas.) unhook
odpis : odpis : (rzecz.) copy | : (rzecz.) duplicate | : (rzecz.) transcript
odpisac : odpisać : (czas.) reply
odpisywanie : odpisywanie : (rzecz.) copying
odpisywac : odpisywać : (czas.) copy
odpiac : odpiąć : (czas.) unclasp
odpluskwiac : odpluskwiać : (czas.) debug
odplatac : odplątać : (czas.) unravel
odplatywac : odplątywać : (czas.) disentangle
odpoczynek : odpoczynek : (rzecz.) lie-down | : (rzecz.) recreation | : (rzecz.) refreshment | : (rzecz.) repose | : (rzecz.) rest
odpoczywac : odpoczywać : (czas.) recline | : (czas.) repose | : (czas.) rest
odpokutowanie : odpokutowanie : (rzecz.) atonement
odpokutowac : odpokutować : (czas.) assoil | : (czas.) atone | : (czas.) expiate
odpolityczniac : odpolityczniać : (czas.) depoliticize
odpolitycznic : odpolitycznić : (czas.) depoliticize
odpornosc : odporność : (rzecz.) immunity | : (rzecz.) resistance | : (rzecz.) robustness | : (rzecz.) tolerance
odporny : odporny : (przym.) foolproof | : (przym.) hardy | : (przym.) immune | : (przym.) impervious | : (przym.) insusceptible | : (przym.) invulnerable | : (przym.) proof | : (przym.) resilient | : (przym.) resistant | : (przym.) resistible | : (przym.) stanch | : (przym.) tolerant
odpowiadajacy : odpowiadający : (przym.) responsive
odpowiadanie : odpowiadanie : (rzecz.) answering | : (rzecz.) rejoinder
odpowiadac : odpowiadać : (czas.) agree | : (czas.) answer | : (czas.) correspond | : (czas.) please | : (czas.) rejoin | : (czas.) reply | : (czas.) respond
odpowiedni : odpowiedni : (przym.) adequate | : (przym.) applicable | : (przym.) apposite | : (przym.) appropriate | : (przym.) apt | : (przym.) conformal | : (przym.) congenial | : (przym.) convenient | : (przym.) correct | : (przym.) corresponding | : (przym.) decorous | : (przym.) desirable | : (przym.) due | : (przym.) eligible | : (przym.) enough | : (przym.) equal | : (przym.) fair | : (przym.) fit | : (przym.) good | : (przym.) homologous | : (przym.) opportune | : (przym.) pertinent | : (przym.) relevant | : (przym.) right | : (przym.) seemly | : (przym.) suitable | : (przym.) suited | : (przym.) timely | : (przym.) underlying
odpowiednik : odpowiednik : (rzecz.) counterpart | : (rzecz.) equivalent | : (rzecz.) matcher | : (rzecz.) parallel
odpowiednio : odpowiednio : (przysł.) acceptably | : (przysł.) accordingly | : (przysł.) adequately | : (przysł.) appropriately | : (przysł.) correspondingly | : (przysł.) fittingly | : (przysł.) pertly | : (przysł.) properly | : (przysł.) proportionately | : (przysł.) respectively | : (przysł.) suitably
odpowiedniosc : odpowiedniość : (rzecz.) adequacy | : (rzecz.) appropriateness | : (rzecz.) congruence | : (rzecz.) correspondence | : (rzecz.) pertinence | : (rzecz.) property | : (rzecz.) suitability
odpowiedzialnie : odpowiedzialnie : (przysł.) responsibly
odpowiedzialnosc : odpowiedzialność : (rzecz.) accountability | : (rzecz.) blaming | : (rzecz.) liability | : (rzecz.) responsibility
odpowiedzialny : odpowiedzialny : (przym.) accountable | : (przym.) amenable | : (przym.) answerable | : (przym.) guilty | : (przym.) liable | : (przym.) related | : (przym.) reliable | : (przym.) responsible | : (przym.) trustworthy
odpowiedziec : odpowiedzieć : (czas.) answer | : (czas.) replay | : (czas.) reply | : (czas.) respond
odpowiedz : odpowiedź : (rzecz.) answer | : (rzecz.) feedback | : (rzecz.) plea | : (rzecz.) rejoinder | : (rzecz.) replication | : (rzecz.) reply | : (rzecz.) response
odpowietrzanie : odpowietrzanie : (rzecz.) venting
odpowietrzac : odpowietrzać : (czas.) de-aerate | : (czas.) vent
odpowietrzenie : odpowietrzenie : (rzecz.) air-release
odpowietrznik : odpowietrznik : (rzecz.) air-escape | : (rzecz.) air-release | : (rzecz.) breather | : (rzecz.) vent
odpowietrzony : odpowietrzony : (przym.) air-free
odprawa : odprawa : (rzecz.) briefing | : (rzecz.) check-in | : (rzecz.) dismissal | : (rzecz.) payoff | : (rzecz.) repulse
odprawiac : odprawiać : (czas.) dismiss | : (czas.) dispatch | : (czas.) officiate
odprawienie : odprawienie : (rzecz.) dismissal
odprowadzac : odprowadzać : (czas.) accompany | : (czas.) dissipate
odprowadzenie : odprowadzenie : (rzecz.) extraction
odprysk : odprysk : (rzecz.) chip | : (rzecz.) flake | : (rzecz.) remnants | : (rzecz.) splinter
odpryskiwac : odpryskiwać : (czas.) flake
odprzedaz : odprzedaż : (rzecz.) resale
odprzeganie : odprzęganie : (rzecz.) decoupling
odprzegac : odprzęgać : (czas.) uncouple
odprezajacy : odprężający : (przym.) relaxing
odprezac : odprężać : (czas.) relax | : (czas.) slacken | : (czas.) unbend | : (czas.) unwind | : (czas.) unwound
odprezenie : odprężenie : (rzecz.) decompression | : (rzecz.) detente | : (rzecz.) détente | : (rzecz.) relaxation
odprezyc : odprężyć : (czas.) unbend
odpust : odpust : (rzecz.) fair | : (rzecz.) indulgence | : (rzecz.) pardon
odpustowy : odpustowy : (przym.) fair
odpuszczac : odpuszczać : (czas.) absolve | : (czas.) forgive | : (czas.) temper
odpuszczenie : odpuszczenie : (rzecz.) absolution | : (rzecz.) forgiveness | : (rzecz.) remission
odpuscic : odpuścić : (czas.) forgive
odpychajacy : odpychający : (przym.) obnoxious | : (przym.) repellent | : (przym.) repulsive
odpychanie : odpychanie : (rzecz.) repellent | : (rzecz.) repulsion
odpychac : odpychać : (czas.) disaffect | : (czas.) repel | : (czas.) repulse
odpylacz : odpylacz : (rzecz.) duster
odpytywanie : odpytywanie : (rzecz.) polling
odpytywac : odpytywać : (czas.) question
odpor : odpór : (rzecz.) resistance
odplacac : odpłacać : (czas.) reciprocate | : (czas.) repay | : (czas.) requite | : (czas.) retaliate
odplacic : odpłacić : (czas.) repay | : (czas.) requite
odplata : odpłata : (rzecz.) retaliation | : (rzecz.) retribution | : (rzecz.) reward
odplatac : odpłatać : (czas.) unravel
odplatnosc : odpłatność : (rzecz.) payment | : (rzecz.) repayment
odplatny : odpłatny : (przym.) chargeable | : (przym.) metered | : (przym.) payable
odplyw : odpływ : (rzecz.) drain | : (rzecz.) ebb | : (rzecz.) ebb-tide | : (rzecz.) effluent | : (rzecz.) emigration | : (rzecz.) outflow | : (rzecz.) outlet | : (rzecz.) plughole | : (rzecz.) reflux | : (rzecz.) spillway | : (rzecz.) tide
odplywac : odpływać : (czas.) ebb | : (czas.) ooze
odra : odra : (rzecz.) measles
odraczanie : odraczanie : (rzecz.) delay | : (rzecz.) postponement
odraczac : odraczać : (czas.) adjourn | : (czas.) defer | : (czas.) deposit | : (czas.) postpone | : (czas.) prorogue | : (czas.) regenerate | : (czas.) revive | : (czas.) suspend
odradzanie : odradzanie : (rzecz.) dissuasion | : (rzecz.) rebirth | : (rzecz.) regeneration
odradzac : odradzać : (czas.) dissuade | : (czas.) regenerate | : (czas.) revive
odrapac : odrapać : (czas.) dilapidate
odratowac : odratować : (czas.) rescue
odraza : odraza : (rzecz.) abhorrence | : (rzecz.) aversion | : (rzecz.) disgust | : (rzecz.) dislike | : (rzecz.) disrelish | : (rzecz.) loathing | : (rzecz.) repugnance
odrazajaco : odrażająco : (przysł.) abominably | : (przysł.) revoltingly
odrazajacy : odrażający : (przym.) abhorrent | : (przym.) horrid | : (przym.) offensive
odrdzewiac : odrdzewiać : (czas.) tumble
odredakcyjny : odredakcyjny : (przym.) editorial | : (przym.) editor's
odremontowac : odremontować : (czas.) renovate
odrestaurowanie : odrestaurowanie : (rzecz.) restoration
odrestaurowac : odrestaurować : (czas.) restore
odrobina : odrobina : (rzecz.) atom | : (rzecz.) bit | : (rzecz.) dab | : (rzecz.) grain | : (rzecz.) iota | : (rzecz.) jot | : (rzecz.) modicum | : (rzecz.) ounce | : (rzecz.) pittance | : (rzecz.) scantling | : (rzecz.) scrap | : (rzecz.) smidgen | : (rzecz.) soupcon | : (rzecz.) spark | : (rzecz.) spot | : (rzecz.) sprinkling | : (rzecz.) straw | : (rzecz.) tincture | : (rzecz.) trace | : (rzecz.) wee | : (rzecz.) whit
odrobic : odrobić : (czas.) undo
odroczenie : odroczenie : (rzecz.) adjournment | : (rzecz.) continuance | : (rzecz.) deferment | : (rzecz.) deferral | : (rzecz.) moratorium | : (rzecz.) postponement | : (rzecz.) respite | : (rzecz.) stay | : (rzecz.) suspension
odroczyc : odroczyć : (czas.) adjourn | : (czas.) defer | : (czas.) reprieve | : (czas.) suspend
odrodzenie : odrodzenie : (rzecz.) rebirth | : (rzecz.) regeneration | : (rzecz.) renaissance | : (rzecz.) renascence | : (rzecz.) revival
odrodzic : odrodzić : (czas.) regenerate
odrost : odrost : (rzecz.) sucker
odrosl : odrośl : (rzecz.) offset | : (rzecz.) offshoot
odruch : odruch : (rzecz.) impulse | : (rzecz.) reflex
odruchowo : odruchowo : (przysł.) instinctively | : (przysł.) involuntarily
odruchowy : odruchowy : (przym.) reflexive
odryglowac : odryglować : (czas.) unbar | : (czas.) unbolt | : (czas.) unlock
odrys : odrys : (rzecz.) copy
odrysowac : odrysować : (czas.) copy
odrywac : odrywać : (czas.) detach | : (czas.) distract | : (czas.) pull | : (czas.) sever
odrzec : odrzeć : (czas.) strip
odrzucajacy : odrzucający : (przym.) resilient
odrzucac : odrzucać : (czas.) abort | : (czas.) bandy | : (czas.) decline | : (czas.) defeat | : (czas.) disallow | : (czas.) discard | : (czas.) dismiss | : (czas.) overrule | : (czas.) rebuff | : (czas.) recast | : (czas.) refuse | : (czas.) reject | : (czas.) repel | : (czas.) repudiate | : (czas.) scrap | : (czas.) spurn | : (czas.) toss
odrzucenie : odrzucenie : (rzecz.) rebuff | : (rzecz.) rejection | : (rzecz.) repercussion | : (rzecz.) repudiation | : (rzecz.) throwback
odrzucic : odrzucić : (czas.) decline | : (czas.) discard | : (czas.) overrule | : (czas.) recast | : (czas.) refuse | : (czas.) reject | : (czas.) repudiate
odrzut : odrzut : (rzecz.) kick | : (rzecz.) recoil | : (rzecz.) reject | : (rzecz.) thrust
odrzutnik : odrzutnik : (rzecz.) deflector | : (rzecz.) thrower
odrzutowiec : odrzutowiec : (rzecz.) jet | : (rzecz.) jet-plane
odrzutowy : odrzutowy : (przym.) jet-propelled
odrzwia : odrzwia : (rzecz.) door | : (rzecz.) door-case | : (rzecz.) door-frames
odroznianie : odróżnianie : (rzecz.) discrimination
odrozniac : odróżniać : (czas.) differentiate | : (czas.) distinguish | : (czas.) separate
odroznienie : odróżnienie : (rzecz.) distinction
odroznic : odróżnić : (czas.) distinguished | : (czas.) separate
odrebnie : odrębnie : (przysł.) independently | : (przysł.) separately
odrebnosc : odrębność : (rzecz.) autonomy | : (rzecz.) distinction | : (rzecz.) distinctiveness | : (rzecz.) identity | : (rzecz.) individuality
odrebny : odrębny : (przym.) different | : (przym.) distinct | : (przym.) separate
odreczny : odręczny : (przym.) freehand | : (przym.) handmade | : (przym.) hand-made | : (przym.) handwritten | : (przym.) instant
odretwienie : odrętwienie : (rzecz.) numbness | : (rzecz.) stupor | : (rzecz.) torpidity | : (rzecz.) torpor
odretwiec : odrętwieć : (czas.) benumb
odsadzac : odsadzać : (czas.) remove
odsadzka : odsadzka : (rzecz.) offset | : (rzecz.) plinth | : (rzecz.) set-off
odsalanie : odsalanie : (rzecz.) desalination | : (rzecz.) desalinise | : (rzecz.) desalinization
odsalac : odsalać : (czas.) desalinate
odseparowanie : odseparowanie : (rzecz.) separation
odseparowac : odseparować : (czas.) cut | : (czas.) detach | : (czas.) seclude | : (czas.) separate
odseparowywac : odseparowywać : (czas.) distance
odsetek : odsetek : (rzecz.) percentage | : (rzecz.) proportion
odsetki : odsetki : (rzecz.) interest
odsiadywac : odsiadywać : (czas.) serve
odsiecz : odsiecz : (rzecz.) alleviation | : (rzecz.) relief | : (rzecz.) troops
odsiedzenie : odsiedzenie : (rzecz.) sitting
odsiew : odsiew : (rzecz.) screening | : (rzecz.) shakeout | : (rzecz.) shorts
odsiewanie : odsiewanie : (rzecz.) bolting
odsiewac : odsiewać : (czas.) screen | : (czas.) sift
odskakiwac : odskakiwać : (czas.) bound | : (czas.) rebound | : (czas.) recoil
odskocznia : odskocznia : (rzecz.) springboard | : (rzecz.) spring-board | : (rzecz.) steppingstone | : (rzecz.) stepping-stone | : (rzecz.) toehold
odskoczyc : odskoczyć : (czas.) bounce | : (czas.) recoil
odskok : odskok : (rzecz.) bound | : (rzecz.) rebound | : (rzecz.) recoil
odsolic : odsolić : (czas.) desalinate
odspajac : odspajać : (czas.) prise
odsprzedawac : odsprzedawać : (czas.) sell
odsprzedawca : odsprzedawca : (rzecz.) reseller
odsprzedac : odsprzedać : (czas.) resell | : (czas.) sell
odsprzedaz : odsprzedaż : (rzecz.) resale
odstawa : odstawa : (rzecz.) delivery | : (rzecz.) haulage
odstawac : odstawać : (czas.) mature | : (czas.) protrude
odstawiac : odstawiać : (czas.) shelve
odstawienie : odstawienie : (rzecz.) discontinuation
odstawic : odstawić : (czas.) discontinued | : (czas.) shelve
odstac : odstać : (czas.) stray
odstojnik : odstojnik : (rzecz.) clarifier | : (rzecz.) decanter | : (rzecz.) setter | : (rzecz.) settler
odstraszanie : odstraszanie : (rzecz.) deterrence | : (rzecz.) deterring
odstraszac : odstraszać : (czas.) daunt | : (czas.) deter
odstraszenie : odstraszenie : (rzecz.) determent | : (rzecz.) deterrence
odstraszyc : odstraszyć : (czas.) deter
odstrzal : odstrzał : (rzecz.) firing | : (rzecz.) killing | : (rzecz.) shooting
odstrzelic : odstrzelić : (czas.) fire
odstreczac : odstręczać : (czas.) deter
odstreczenie : odstręczenie : (rzecz.) alienation | : (rzecz.) repulsion
odstreczyc : odstręczyć : (czas.) alienate
odstapienie : odstąpienie : (rzecz.) cession | : (rzecz.) transfer | : (rzecz.) waiver
odstapic : odstąpić : (czas.) cede | : (czas.) depart | : (czas.) derogate | : (czas.) desist | : (czas.) recede | : (czas.) relinquish | : (czas.) remit | : (czas.) secede | : (czas.) transfer | : (czas.) waive
odstep : odstęp : (rzecz.) distance | : (rzecz.) gap | : (rzecz.) indention | : (rzecz.) interval | : (rzecz.) pedestal | : (rzecz.) setup | : (rzecz.) space | : (rzecz.) spacing
odstepca : odstępca : (rzecz.) apostate | : (rzecz.) defector | : (rzecz.) traitor
odstepowanie : odstępowanie : (rzecz.) derogation
odstepowac : odstępować : (czas.) cede | : (czas.) depart | : (czas.) derogate | : (czas.) desist | : (czas.) recede | : (czas.) relinquish | : (czas.) remit | : (czas.) secede | : (czas.) stand | : (czas.) waive
odstepstwo : odstępstwo : (rzecz.) apostasy | : (rzecz.) defection | : (rzecz.) departure | : (rzecz.) dissent | : (rzecz.) exception | : (rzecz.) secession
odsuniecie : odsunięcie : (rzecz.) estrangement
odsuwanie : odsuwanie : (rzecz.) marginalized
odsuwac : odsuwać : (czas.) avert | : (czas.) edge | : (czas.) move | : (czas.) wean | : (czas.) withdraw
odsypiac : odsypiać : (czas.) sleep
odsysacz : odsysacz : (rzecz.) aspirator
odsysac : odsysać : (czas.) draw | : (czas.) suck-off
odsylacz : odsyłacz : (rzecz.) ampersand | : (rzecz.) asterisk | : (rzecz.) cross-reference | : (rzecz.) hyperlink | : (rzecz.) reference
odsylac : odsyłać : (czas.) recommit | : (czas.) refer | : (czas.) remand | : (czas.) resend
odszaklowac : odszaklować : (czas.) unshackle
odszczepieniec : odszczepieniec : (rzecz.) dissenter | : (rzecz.) dissident | : (rzecz.) dropout | : (rzecz.) renegade
odszczepienstwo : odszczepieństwo : (rzecz.) apostasy
odszkodowanie : odszkodowanie : (rzecz.) amends | : (rzecz.) award | : (rzecz.) compensation | : (rzecz.) damage | : (rzecz.) damages | : (rzecz.) indemnification | : (rzecz.) indemnity | : (rzecz.) reparation | : (rzecz.) restitution
odsznurowac : odsznurować : (czas.) unlace | : (czas.) unstring
odszpuntowac : odszpuntować : (czas.) tap
odszukac : odszukać : (czas.) find | : (czas.) search | : (czas.) trace
odszukiwanie : odszukiwanie : (rzecz.) finding | : (rzecz.) lookup
odszukiwac : odszukiwać : (czas.) locate
odszyfrowanie : odszyfrowanie : (rzecz.) decipherment | : (rzecz.) decrypted | : (rzecz.) decryption
odszyfrowac : odszyfrować : (czas.) decipher | : (czas.) decrypt | : (czas.) descramble
odszyfrowywac : odszyfrowywać : (czas.) decrypt
odsaczanie : odsączanie : (rzecz.) bleeding
odsaczyc : odsączyć : (czas.) filter
odsadzac : odsądzać : (czas.) remove
odslaniac : odsłaniać : (czas.) bare | : (czas.) denude | : (czas.) disclose | : (czas.) expose | : (czas.) reveal | : (czas.) uncover | : (czas.) unfold | : (czas.) unroll | : (czas.) unveil
odslona : odsłona : (rzecz.) opening | : (rzecz.) scene
odslonic : odsłonić : (czas.) denude | : (czas.) disclose | : (czas.) reveal | : (czas.) uncover | : (czas.) unfold | : (czas.) unroll | : (czas.) unveil
odsloniecie : odsłonięcie : (rzecz.) basset | : (rzecz.) disclosure | : (rzecz.) exposure
odsloniety : odsłonięty : (przym.) vulnerable
odsluchac : odsłuchać : (czas.) listen
odsluchiwac : odsłuchiwać : (czas.) listen
odtajac : odtajać : (czas.) thaw | : (czas.) unfreeze
odtajnienie : odtajnienie : (rzecz.) declassification
odtajnic : odtajnić : (czas.) declassify
odtleniacz : odtleniacz : (rzecz.) deoxidizer
odtlenianie : odtlenianie : (rzecz.) deoxidizing | : (rzecz.) reduction
odtleniac : odtleniać : (czas.) deoxidize
odtlenienie : odtlenienie : (rzecz.) deoxidizing | : (rzecz.) reduction
odtransportowac : odtransportować : (czas.) send
odtrutka : odtrutka : (rzecz.) antidote | : (rzecz.) detoxifier
odtruwanie : odtruwanie : (rzecz.) detoxification
odtruwac : odtruwać : (czas.) detoxify
odtracac : odtrącać : (czas.) rebuff | : (czas.) repel | : (czas.) repulse | : (czas.) spurn
odtracenie : odtrącenie : (rzecz.) repudiation
odtwarzacz : odtwarzacz : (rzecz.) player | : (rzecz.) reproducer
odtwarzalnosc : odtwarzalność : (rzecz.) reproducibility
odtwarzalny : odtwarzalny : (przym.) reproducible
odtwarzanie : odtwarzanie : (rzecz.) playback | : (rzecz.) playing | : (rzecz.) recovery | : (rzecz.) render | : (rzecz.) replication | : (rzecz.) reproduction
odtwarzac : odtwarzać : (czas.) enact | : (czas.) play | : (czas.) reconstruct | : (czas.) recreate | : (czas.) regenerate | : (czas.) reproduce | : (czas.) restore | : (czas.) retrace
odtworzenie : odtworzenie : (rzecz.) reproduction | : (rzecz.) restoration
odtworzyc : odtworzyć : (czas.) play | : (czas.) reconstruct | : (czas.) recreate | : (czas.) reproduce | : (czas.) undelete
odtworca : odtwórca : (rzecz.) impersonator | : (rzecz.) performer | : (rzecz.) reproducer
odtworczy : odtwórczy : (przym.) imitative | : (przym.) reproductive
odtworczyni : odtwórczyni : (rzecz.) performer
odtykac : odtykać : (czas.) unblock
odtad : odtąd : (przysł.) hence | : (przysł.) henceforth | : (przysł.) henceforward | : (przysł.) now | : (przysł.) since | : (przysł.) thenceforth | : (przysł.) thenceforward
odtluszczacz : odtłuszczacz : (rzecz.) degreaser
odtluszczac : odtłuszczać : (czas.) degrease | : (czas.) scour
odtluszczenie : odtłuszczenie : (rzecz.) degreasing
odtluscic : odtłuścić : (czas.) degrease
oduczac : oduczać : (czas.) unlearn
odurzac : odurzać : (czas.) bemuse | : (czas.) dope | : (czas.) fuddle | : (czas.) intoxicate
odurzenie : odurzenie : (rzecz.) intoxication
odurzyc : odurzyć : (czas.) intoxicate
odwach : odwach : (rzecz.) guardroom
odwadniacz : odwadniacz : (rzecz.) dehydrator | : (rzecz.) dewatering
odwadnianie : odwadnianie : (rzecz.) dehydration | : (rzecz.) dewatering | : (rzecz.) drainage
odwadniarka : odwadniarka : (rzecz.) drainer
odwadniac : odwadniać : (czas.) dehydrate | : (czas.) dewater | : (czas.) drain
odwaga : odwaga : (rzecz.) bravery | : (rzecz.) courage | : (rzecz.) daring | : (rzecz.) grit | : (rzecz.) guts | : (rzecz.) hardihood | : (rzecz.) mettle | : (rzecz.) nerve | : (rzecz.) pecker | : (rzecz.) pluck | : (rzecz.) spunk | : (rzecz.) valour
odwalic : odwalić : (czas.) crib
odwanianie : odwanianie : (rzecz.) deodorization
odwapnianie : odwapnianie : (rzecz.) decalcification
odwapniac : odwapniać : (czas.) decalcify
odwapnienie : odwapnienie : (rzecz.) decalcification
odwapnic : odwapnić : (czas.) decalcify
odwar : odwar : (rzecz.) decoction
odwarstwianie : odwarstwianie : (rzecz.) exfoliation
odwazac : odważać : (czas.) dare | : (czas.) prize
odwaznie : odważnie : (przysł.) courageously | : (przysł.) gamely
odwaznik : odważnik : (rzecz.) weight
odwazny : odważny : (przym.) adventurous | : (przym.) bold | : (przym.) brave | : (przym.) courageous | : (przym.) hardy | : (przym.) manful | : (przym.) plucky | : (przym.) valiant
odwazyc : odważyć : (czas.) encourage | : (czas.) venture | : (czas.) weigh
odwdzieczac : odwdzięczać : (czas.) repaid | : (czas.) repay
odwdzieczyc : odwdzięczyć : (czas.) repay
odwet : odwet : (rzecz.) quittance | : (rzecz.) reprisal | : (rzecz.) retaliation | : (rzecz.) retribution
odwetowiec : odwetowiec : (rzecz.) revenge-seeker
odwetowy : odwetowy : (przym.) retaliatory
odwiecznie : odwiecznie : (przysł.) eternally | : (przysł.) everlastingly
odwieczny : odwieczny : (przym.) age-long | : (przym.) ancient | : (przym.) eternal | : (przym.) everlasting | : (przym.) immemorial | : (przym.) long-time | : (przym.) primeval
odwiedzanie : odwiedzanie : (rzecz.) caller
odwiedzac : odwiedzać : (czas.) call | : (czas.) frequent | : (czas.) haunt | : (czas.) visit | : (czas.) visited
odwiedziny : odwiedziny : (rzecz.) visit | : (rzecz.) visitation
odwiedzic : odwiedzić : (czas.) see | : (czas.) visit | : (czas.) visited
odwiercic : odwiercić : (czas.) bore
odwiert : odwiert : (rzecz.) aperture | : (rzecz.) bore | : (rzecz.) borehole | : (rzecz.) bore-hole
odwietrznik : odwietrznik : (rzecz.) ventilator
odwiesc : odwieść : (czas.) dissuade
odwiezc : odwieźć : (czas.) drive
odwijanie : odwijanie : (rzecz.) unreeling
odwijac : odwijać : (czas.) rewind | : (czas.) uncoil | : (czas.) unreel | : (czas.) unreeled | : (czas.) unroll | : (czas.) unwind
odwilz : odwilż : (rzecz.) thaw
odwilzacz : odwilżacz : (rzecz.) crop | : (rzecz.) dehumidifier
odwilzyc : odwilżyć : (czas.) moisten
odwirowanie : odwirowanie : (rzecz.) centrifugation
odwirowac : odwirować : (czas.) centrifuge | : (czas.) spin-dry
odwirowywac : odwirowywać : (czas.) centrifuge | : (czas.) spin
odwiazac : odwiązać : (czas.) unbend | : (czas.) unbind | : (czas.) undo | : (czas.) unlash | : (czas.) untie
odwiazywac : odwiązywać : (czas.) uncouple | : (czas.) unfasten
odwleczenie : odwleczenie : (rzecz.) deferment | : (rzecz.) delay
odwlekac : odwlekać : (czas.) delay | : (czas.) delay
odwodniac : odwodniać : (czas.) dehydrate
odwodnienie : odwodnienie : (rzecz.) dehydration
odwodnic : odwodnić : (czas.) dehydrate | : (czas.) drain
odwodornienie : odwodornienie : (rzecz.) dehydrogenation
odwodzenie : odwodzenie : (rzecz.) dissuasion
odwodziciel : odwodziciel : (rzecz.) abductor
odwodzic : odwodzić : (czas.) discourage | : (czas.) dissuade
odwolalny : odwołalny : (przym.) revocable
odwolanie : odwołanie : (rzecz.) abjuration | : (rzecz.) appeal | : (rzecz.) cancellation | : (rzecz.) countermand | : (rzecz.) dismissal | : (rzecz.) recall | : (rzecz.) reference | : (rzecz.) removal | : (rzecz.) renouncement | : (rzecz.) repeal | : (rzecz.) rescission | : (rzecz.) retraction | : (rzecz.) revocation | : (rzecz.) withdrawal
odwolac : odwołać : (czas.) cancel | : (czas.) countermand | : (czas.) discard | : (czas.) invoke | : (czas.) recant | : (czas.) receive | : (czas.) refer | : (czas.) repeal | : (czas.) rescind | : (czas.) revoke | : (czas.) undelete | : (czas.) unsay
odwolywac : odwoływać : (czas.) appeal | : (czas.) cancel | : (czas.) dismiss | : (czas.) invoke | : (czas.) recall | : (czas.) recant | : (czas.) refer | : (czas.) repeal | : (czas.) rescind | : (czas.) retract | : (czas.) revoke | : (czas.) swallow | : (czas.) withdraw
odwracalnosc : odwracalność : (rzecz.) reversibility
odwracalny : odwracalny : (przym.) convertible | : (przym.) invertible | : (przym.) reversible
odwracanie : odwracanie : (rzecz.) inversion | : (rzecz.) reversal | : (rzecz.) rollback
odwracac : odwracać : (czas.) avert | : (czas.) countersign | : (czas.) divert | : (czas.) flip | : (czas.) invert | : (czas.) overrule | : (czas.) reverse | : (czas.) revert | : (czas.) sidetrack | : (czas.) turn
odwrotnie : odwrotnie : (przysł.) conversely | : (przysł.) inversely
odwrotnosc : odwrotność : (rzecz.) converse | : (rzecz.) inverse | : (rzecz.) reciprocal | : (rzecz.) reverse
odwrotny : odwrotny : (przym.) back | : (przym.) contrary | : (przym.) converse | : (przym.) inverse | : (przym.) opposite | : (przym.) reciprocal | : (przym.) reverse
odwrocenie : odwrócenie : (rzecz.) diversion | : (rzecz.) inverse | : (rzecz.) inversion | : (rzecz.) reversal
odwrocic : odwrócić : (czas.) avert | : (czas.) countersign | : (czas.) invert | : (czas.) overrule | : (czas.) reverse | : (czas.) revert
odwrot : odwrót : (rzecz.) recess | : (rzecz.) retreat | : (rzecz.) revolution | : (rzecz.) withdrawal
odwszawic : odwszawić : (czas.) delouse
odwzajemniac : odwzajemniać : (czas.) reciprocate | : (czas.) retaliate | : (czas.) return
odwzajemnienie : odwzajemnienie : (rzecz.) reciprocation | : (rzecz.) reciprocity
odwzajemnic : odwzajemnić : (czas.) back | : (czas.) return
odwzorowanie : odwzorowanie : (rzecz.) bitmap | : (rzecz.) cartography | : (rzecz.) image | : (rzecz.) imagery | : (rzecz.) imitation | : (rzecz.) mapping | : (rzecz.) representation
odwzorowac : odwzorować : (czas.) map
odwzorowywanie : odwzorowywanie : (rzecz.) projection
odwod : odwód : (rzecz.) reserve
odweglanie : odwęglanie : (rzecz.) decarburization
odweglac : odwęglać : (czas.) decarburize
odwlaszanie : odwłaszanie : (rzecz.) depilation
odwlok : odwłok : (rzecz.) abdomen
odymianie : odymianie : (rzecz.) fumigation
odymic : odymić : (czas.) fumigate
odyniec : odyniec : (rzecz.) boar
odyseja : odyseja : (rzecz.) odyssey
odzew : odzew : (rzecz.) answerback | : (rzecz.) echo | : (rzecz.) reply | : (rzecz.) response
odziac : odziać : (czas.) dress
odziedziczyc : odziedziczyć : (czas.) inherit
odzienie : odzienie : (rzecz.) array | : (rzecz.) clothing | : (rzecz.) garb | : (rzecz.) youth
odziewac : odziewać : (czas.) array | : (czas.) attire | : (czas.) dress | : (czas.) invest
odziez : odzież : (rzecz.) apparel | : (rzecz.) attire | : (rzecz.) clothes | : (rzecz.) clothing | : (rzecz.) frock | : (rzecz.) garb | : (rzecz.) garment | : (rzecz.) gear | : (rzecz.) habiliment | : (rzecz.) habit | : (rzecz.) wear
odziomek : odziomek : (rzecz.) butt
odznaczenie : odznaczenie : (rzecz.) award | : (rzecz.) decoration | : (rzecz.) distinction
odznaczyc : odznaczyć : (czas.) deselect | : (czas.) distinguish | : (czas.) remove
odznaka : odznaka : (rzecz.) badge | : (rzecz.) brassard | : (rzecz.) ensign | : (rzecz.) pin | : (rzecz.) plaque
odzwierciedlac : odzwierciedlać : (czas.) mirror | : (czas.) rebound | : (czas.) reflect
odzwierciedlenie : odzwierciedlenie : (rzecz.) reflection
odzwierciedlic : odzwierciedlić : (czas.) reflect
odzwyczaic : odzwyczaić : (czas.) break
odzwyczajac : odzwyczajać : (czas.) wean
odzwyczajenie : odzwyczajenie : (rzecz.) disuse
odzysk : odzysk : (rzecz.) recovery | : (rzecz.) salvage
odzyskanie : odzyskanie : (rzecz.) recapture | : (rzecz.) recovery | : (rzecz.) redemption | : (rzecz.) retrieval
odzyskac : odzyskać : (czas.) recapture | : (czas.) reclaim | : (czas.) recover | : (czas.) regain | : (czas.) retrieve | : (czas.) undelete
odzyskiwanie : odzyskiwanie : (rzecz.) readout | : (rzecz.) reclamation | : (rzecz.) recovery | : (rzecz.) recuperation | : (rzecz.) retrieval
odzyskiwac : odzyskiwać : (czas.) recapture | : (czas.) reclaim | : (czas.) recover | : (czas.) recuperate | : (czas.) regained | : (czas.) repossess | : (czas.) retrieve
odzywka : odzywka : (rzecz.) bid | : (rzecz.) nutrient
odor : odór : (rzecz.) odour | : (rzecz.) smell | : (rzecz.) stench
odlam : odłam : (rzecz.) faction
odlamac : odłamać : (czas.) break | : (czas.) chip
odlamek : odłamek : (rzecz.) chip | : (rzecz.) fragment | : (rzecz.) shrapnel | : (rzecz.) sliver | : (rzecz.) splint | : (rzecz.) splinter
odlawiac : odławiać : (czas.) catch
odlogowy : odłogowy : (przym.) fallow
odlowic : odłowić : (czas.) catch
odlozenie : odłożenie : (rzecz.) postponement
odlozony : odłożony : (przym.) pending
odlozyc : odłożyć : (czas.) postpone | : (czas.) replace | : (czas.) shelve | : (czas.) shunt | : (czas.) snooze
odlupac : odłupać : (czas.) chip
odlupek : odłupek : (rzecz.) flake | : (rzecz.) splitter
odlupywac : odłupywać : (czas.) prise
odlog : odłóg : (rzecz.) fallow
odlaczalny : odłączalny : (przym.) detachable | : (przym.) removable | : (przym.) severable
odlaczanie : odłączanie : (rzecz.) dissociation
odlaczac : odłączać : (czas.) defect | : (czas.) detach | : (czas.) disable | : (czas.) disconnect | : (czas.) disengage | : (czas.) dissociate | : (czas.) override | : (czas.) secede
odlaczenie : odłączenie : (rzecz.) defection | : (rzecz.) detachment | : (rzecz.) disengagement | : (rzecz.) severance
odlacznik : odłącznik : (rzecz.) cut-out | : (rzecz.) switch
odlaczony : odłączony : (przym.) detached
odlaczyc : odłączyć : (czas.) allot | : (czas.) deactivate | : (czas.) detach | : (czas.) disconnect | : (czas.) disengage | : (czas.) separate
odsniezanie : odśnieżanie : (rzecz.) snow-clearing
odspiewac : odśpiewać : (czas.) sing
odsrodkowo : odśrodkowo : (przysł.) centrifugally
odsrodkowy : odśrodkowy : (przym.) centrifugal
odsrubowac : odśrubować : (czas.) unscrew
odswiezacz : odświeżacz : (rzecz.) freshener | : (rzecz.) fresheners
odswiezajaco : odświeżająco : (przysł.) refreshingly
odswiezanie : odświeżanie : (rzecz.) deodorization
odswiezac : odświeżać : (czas.) freshen | : (czas.) refresh | : (czas.) restore | : (czas.) update
odswiezenie : odświeżenie : (rzecz.) refreshment | : (rzecz.) refurbishment | : (rzecz.) revivification
odswiezyc : odświeżyć : (czas.) deodorize | : (czas.) refresh | : (czas.) renew
odswietny : odświętny : (przym.) festive | : (przym.) holistic | : (przym.) showy | : (przym.) special
odzwiernik : odźwiernik : (rzecz.) pylorus
odzegnac : odżegnać : (czas.) deprecate
odzegnywanie : odżegnywanie : (rzecz.) deprecation
odzegnywac : odżegnywać : (czas.) deprecate
odzuzlac : odżużlać : (czas.) skim
odzycie : odżycie : (rzecz.) resurgence | : (rzecz.) revival
odzywac : odżywać : (czas.) relive | : (czas.) resuscitate
odzywczo : odżywczo : (przysł.) nutritionally
odzywczy : odżywczy : (przym.) alimentary | : (przym.) healthful | : (przym.) nourishing | : (przym.) nutrient | : (przym.) nutritional | : (przym.) nutritious | : (przym.) nutritive | : (przym.) restorative | : (przym.) stout | : (przym.) substantial
odzywianie : odżywianie : (rzecz.) nourishment | : (rzecz.) nutrition
odzywiac : odżywiać : (czas.) feed | : (czas.) nourish
odzywienie : odżywienie : (rzecz.) nutrition
odzywka : odżywka : (rzecz.) conditioner | : (rzecz.) nutrient | : (rzecz.) nutriment
odzyc : odżyć : (czas.) relive | : (czas.) revive | : (czas.) reviving
ofensywa : ofensywa : (rzecz.) assault | : (rzecz.) attack | : (rzecz.) offence | : (rzecz.) offensive | : (rzecz.) thrust
ofensywnie : ofensywnie : (przysł.) offensively
ofensywny : ofensywny : (przym.) aggressive | : (przym.) offensive
oferent : oferent : (rzecz.) bidder | : (rzecz.) supplier
oferma : oferma : (rzecz.) duffer | : (rzecz.) milksop | : (rzecz.) muff
oferowanie : oferowanie : (rzecz.) offer | : (rzecz.) offering | : (rzecz.) tender
oferowac : oferować : (czas.) bid | : (czas.) offer | : (czas.) ship
oferta : oferta : (rzecz.) bid | : (rzecz.) offer | : (rzecz.) offering | : (rzecz.) overture | : (rzecz.) proffer | : (rzecz.) proposal | : (rzecz.) tender
ofiara : ofiara : (rzecz.) casualty | : (rzecz.) loser | : (rzecz.) manta | : (rzecz.) oblation | : (rzecz.) offering | : (rzecz.) prey | : (rzecz.) sacrifice | : (rzecz.) stooge | : (rzecz.) victim
ofiarnie : ofiarnie : (przysł.) generously | : (przysł.) sacrificially
ofiarnosc : ofiarność : (rzecz.) dedication | : (rzecz.) generosity
ofiarny : ofiarny : (przym.) dedicated | : (przym.) generous | : (przym.) sacrificial
ofiarodawca : ofiarodawca : (rzecz.) benefactor | : (rzecz.) contributor | : (rzecz.) donor
ofiarowanie : ofiarowanie : (rzecz.) donation | : (rzecz.) offer | : (rzecz.) offertory | : (rzecz.) volunteer
ofiarowac : ofiarować : (czas.) bid | : (czas.) dedicate | : (czas.) offer | : (czas.) victimize
oficer : oficer : (rzecz.) mate | : (rzecz.) officer
oficerki : oficerki : (rzecz.) jackboots | : (rzecz.) knee-boots
oficerski : oficerski : (przym.) officer's
oficjalista : oficjalista : (rzecz.) scribe
oficjalnie : oficjalnie : (przysł.) officially
oficjalny : oficjalny : (przym.) formal | : (przym.) official | : (przym.) offish | : (przym.) stiff
oficjal : oficjał : (rzecz.) official
oficyna : oficyna : (rzecz.) annex | : (rzecz.) annexe | : (rzecz.) backhouse | : (rzecz.) lean-to | : (rzecz.) office | : (rzecz.) outhouse
ofsajdowy : ofsajdowy : (przym.) offside
oftalmolog : oftalmolog : (rzecz.) ophthalmologist
oftalmoskop : oftalmoskop : (rzecz.) ophthalmoscope
ofukniecie : ofuknięcie : (rzecz.) rating | : (rzecz.) snub
ogar : ogar : (rzecz.) bloodhound | : (rzecz.) deerhound | : (rzecz.) deer-hound | : (rzecz.) hound
ogarek : ogarek : (rzecz.) candle-end | : (rzecz.) stump
ogarniac : ogarniać : (czas.) embrace | : (czas.) engulf | : (czas.) overwhelm | : (czas.) pervade | : (czas.) rake | : (czas.) whelm
ogier : ogier : (rzecz.) stallion
ogien : ogień : (rzecz.) blaze | : (rzecz.) camp-fire | : (rzecz.) fire | : (rzecz.) firing | : (rzecz.) flame | : (rzecz.) glow | : (rzecz.) gunfire | : (rzecz.) light
oglad : ogląd : (rzecz.) view
ogladalnosc : oglądalność : (rzecz.) audience
ogladac : oglądać : (czas.) contemplate | : (czas.) examine | : (czas.) inspect | : (czas.) view | : (czas.) watch
oglednosc : oględność : (rzecz.) caution | : (rzecz.) discretion
ogledny : oględny : (przym.) moderate | : (przym.) provident | : (przym.) wary
ogledziny : oględziny : (rzecz.) examination | : (rzecz.) perusal
ognicha : ognicha : (rzecz.) charlock
ognik : ognik : (rzecz.) flame | : (rzecz.) glimmer
ognioodporny : ognioodporny : (przym.) fireproof | : (przym.) fire-proof | : (przym.) fire-resistant | : (przym.) fire-resisting | : (przym.) flameproof
ognioszczelny : ognioszczelny : (przym.) fire-tight
ogniotrwalosc : ogniotrwałość : (rzecz.) refractoriness
ogniotrwaly : ogniotrwały : (przym.) fireproof | : (przym.) fire-resisting | : (przym.) refractory
ogniowy : ogniowy : (przym.) fired | : (przym.) igneous
ognisko : ognisko : (rzecz.) bonfire | : (rzecz.) campfire | : (rzecz.) camp-fire | : (rzecz.) fireplace | : (rzecz.) focus | : (rzecz.) grate | : (rzecz.) hearth
ogniskowa : ogniskowa : (rzecz.) focus
ogniskowac : ogniskować : (czas.) focalize | : (czas.) focus
ogniskowy : ogniskowy : (przym.) focal
ognistosc : ognistość : (rzecz.) fire
ognisty : ognisty : (przym.) ablaze | : (przym.) ardent | : (przym.) fiery | : (przym.) girasol | : (przym.) mettlesome
ogniwo : ogniwo : (rzecz.) cell | : (rzecz.) juncture | : (rzecz.) link | : (rzecz.) nexus | : (rzecz.) shackle
ogolenie : ogolenie : (rzecz.) shave
ogolic : ogolić : (czas.) shave
ogolony : ogolony : (przym.) shaven
ogon : ogon : (rzecz.) cue | : (rzecz.) tail
ogonek : ogonek : (rzecz.) hook | : (rzecz.) petiole | : (rzecz.) stalk | : (rzecz.) stem | : (rzecz.) tail
ogoniasty : ogoniasty : (przym.) caudate
ogonowy : ogonowy : (przym.) caudal
ogolacanie : ogołacanie : (rzecz.) denudation
ogolocenie : ogołocenie : (rzecz.) bareness | : (rzecz.) destitution
ogolocic : ogołocić : (czas.) strip
ograbiac : ograbiać : (czas.) fleece
ograbienie : ograbienie : (rzecz.) rifling | : (rzecz.) spoliation
ograbic : ograbić : (czas.) rake
ogradzac : ogradzać : (czas.) fence | : (czas.) surround
ograniczajaco : ograniczająco : (przysł.) restrictively
ograniczanie : ograniczanie : (rzecz.) hamper | : (rzecz.) strangulation
ograniczac : ograniczać : (czas.) abridge | : (czas.) bound | : (czas.) confine | : (czas.) constrain | : (czas.) cramp | : (czas.) curb | : (czas.) cut | : (czas.) delimit | : (czas.) demarcate | : (czas.) determine | : (czas.) disable | : (czas.) dwarf | : (czas.) incapacitate | : (czas.) limit | : (czas.) qualify | : (czas.) reduce | : (czas.) restrain | : (czas.) restrict | : (czas.) specialize | : (czas.) stint | : (czas.) terminate
ograniczenie : ograniczenie : (rzecz.) abridgment | : (rzecz.) border | : (rzecz.) brake | : (rzecz.) confinement | : (rzecz.) constraint | : (rzecz.) delimitation | : (rzecz.) deprivation | : (rzecz.) layoff | : (rzecz.) limit | : (rzecz.) limitation | : (rzecz.) qualification | : (rzecz.) reserve | : (rzecz.) restraint | : (rzecz.) restriction | : (rzecz.) stint | : (rzecz.) stringency
ogranicznik : ogranicznik : (rzecz.) borderer | : (rzecz.) delimiter | : (rzecz.) limiter
ograniczonosc : ograniczoność : (rzecz.) limitation
ograniczony : ograniczony : (przym.) bounded | : (przym.) confined | : (przym.) limited | : (przym.) narrow-minded | : (przym.) restrictive
ograniczyc : ograniczyć : (czas.) bound | : (czas.) confine | : (czas.) constrict | : (czas.) limit | : (czas.) narrow | : (czas.) restrict | : (czas.) stint
ograc : ograć : (czas.) win
ogroblic : ogroblić : (czas.) dam
ogrodnictwo : ogrodnictwo : (rzecz.) gardening | : (rzecz.) horticulture
ogrodniczy : ogrodniczy : (przym.) horticultural
ogrodnik : ogrodnik : (rzecz.) gardener | : (rzecz.) horticulturist
ogrodzenie : ogrodzenie : (rzecz.) enclosure | : (rzecz.) fence | : (rzecz.) fencing | : (rzecz.) hedge | : (rzecz.) kraal | : (rzecz.) precinct | : (rzecz.) railing | : (rzecz.) rails
ogrodzic : ogrodzić : (czas.) enclose | : (czas.) fence | : (czas.) pale
ogrom : ogrom : (rzecz.) colossus | : (rzecz.) enormity | : (rzecz.) greatness | : (rzecz.) grossness | : (rzecz.) hugeness | : (rzecz.) immeasurability | : (rzecz.) immensity | : (rzecz.) magnitude | : (rzecz.) vastness
ogromnie : ogromnie : (przysł.) awfully | : (przysł.) enormously | : (przysł.) extremely | : (przysł.) greatly | : (przysł.) hugely | : (przysł.) immensely | : (przysł.) mightily | : (przysł.) vastly | : (przysł.) wildly
ogromny : ogromny : (przym.) awful | : (przym.) cavernous | : (przym.) enormous | : (przym.) formidable | : (przym.) gargantuan | : (przym.) great | : (przym.) huge | : (przym.) immeasurable | : (przym.) immense | : (przym.) infinite | : (przym.) jumbo | : (przym.) mighty | : (przym.) monstrous | : (przym.) prodigious | : (przym.) thumping | : (przym.) tremendous | : (przym.) unlimited | : (przym.) vast | : (przym.) whooper
ogrywac : ogrywać : (czas.) play
ogryzac : ogryzać : (czas.) gnaw | : (czas.) nibble
ogryzek : ogryzek : (rzecz.) core | : (rzecz.) scrap
ogryzienie : ogryzienie : (rzecz.) picking
ogrzac : ogrzać : (czas.) heat | : (czas.) warm
ogrzewacz : ogrzewacz : (rzecz.) heater
ogrzewanie : ogrzewanie : (rzecz.) heat | : (rzecz.) heating
ogrzewac : ogrzewać : (czas.) heat
ogrzewnictwo : ogrzewnictwo : (rzecz.) heating
ogrod : ogród : (rzecz.) garden | : (rzecz.) park
ogrodek : ogródek : (rzecz.) garden | : (rzecz.) yard
ogolnie : ogólnie : (przysł.) broadly | : (przysł.) generally | : (przysł.) generically | : (przysł.) universally
ogolnik : ogólnik : (rzecz.) cliché | : (rzecz.) generality | : (rzecz.) truism
ogolnikowo : ogólnikowo : (przysł.) generally | : (przysł.) vaguely
ogolnikowy : ogólnikowy : (przym.) general | : (przym.) vague
ogolnobudowlany : ogólnobudowlany : (przym.) general
ogolnodostepny : ogólnodostępny : (przym.) public
ogolnogospodarczy : ogólnogospodarczy : (przym.) general
ogolnokrajowy : ogólnokrajowy : (przym.) countrywide | : (przym.) national | : (przym.) nationwide | : (przym.) wide
ogolnoludzki : ogólnoludzki : (przym.) universal
ogolnonarodowy : ogólnonarodowy : (przym.) nationwide
ogolnopanstwowy : ogólnopaństwowy : (przym.) nationwide
ogolnoustrojowy : ogólnoustrojowy : (przym.) systemic
ogolnoswiatowy : ogólnoświatowy : (przym.) global | : (przym.) worldwide | : (przym.) world-wide
ogolnosc : ogólność : (rzecz.) general | : (rzecz.) generality
ogolny : ogólny : (przym.) aggregate | : (przym.) all-in | : (przym.) broad | : (przym.) common | : (przym.) general | : (przym.) generalized | : (przym.) generic | : (przym.) global | : (przym.) high-level | : (przym.) overall | : (przym.) total
ogorecznik : ogórecznik : (rzecz.) borage
ogorek : ogórek : (rzecz.) cucumber
ogol : ogół : (rzecz.) all | : (rzecz.) assemblage | : (rzecz.) totality
ogolem : ogółem : (przysł.) all-in | : (przysł.) altogether
oglada : ogłada : (rzecz.) manner | : (rzecz.) polish | : (rzecz.) refinement
ogladzac : ogładzać : (czas.) polish
ogladzic : ogładzić : (czas.) polish
oglaszanie : ogłaszanie : (rzecz.) announcement
oglaszac : ogłaszać : (czas.) acclaim | : (czas.) advertise | : (czas.) announce | : (czas.) bill | : (czas.) declare | : (czas.) enunciate | : (czas.) notify | : (czas.) open | : (czas.) originate | : (czas.) post | : (czas.) proclaim | : (czas.) promulgate | : (czas.) pronounce
oglosic : ogłosić : (czas.) adumbrate | : (czas.) announce | : (czas.) herald | : (czas.) publish
ogloszenie : ogłoszenie : (rzecz.) ad | : (rzecz.) advert | : (rzecz.) advertisement | : (rzecz.) announcement | : (rzecz.) commercial | : (rzecz.) insertion | : (rzecz.) notice | : (rzecz.) notification | : (rzecz.) posting | : (rzecz.) publication
ogloszeniodawca : ogłoszeniodawca : (rzecz.) advertiser
ogluchnac : ogłuchnąć : (czas.) become
oglupiajaco : ogłupiająco : (przysł.) maddeningly
oglupianie : ogłupianie : (rzecz.) stupidity
oglupiac : ogłupiać : (czas.) bemuse | : (czas.) brutalize | : (czas.) fool | : (czas.) infatuate | : (czas.) stupefy
oglupienie : ogłupienie : (rzecz.) stupidity
oglupic : ogłupić : (czas.) brutalize | : (czas.) infatuate | : (czas.) stupefy
ogluszajaco : ogłuszająco : (przysł.) deafeningly
ogluszajacy : ogłuszający : (przym.) deafening
ogluszac : ogłuszać : (czas.) deafen | : (czas.) stun
ogluszyc : ogłuszyć : (czas.) deafen | : (czas.) dumbfound | : (czas.) stun
ohyda : ohyda : (rzecz.) atrociousness | : (rzecz.) atrocity | : (rzecz.) heinousness | : (rzecz.) monstrosity | : (rzecz.) odiousness | : (rzecz.) shocker
ohydnie : ohydnie : (przysł.) hideously
ohydny : ohydny : (przym.) abominable | : (przym.) atrocious | : (przym.) beastly | : (przym.) eldritch | : (przym.) execrable | : (przym.) filthy | : (przym.) flagrant | : (przym.) ghastly | : (przym.) heinous | : (przym.) hideous | : (przym.) obnoxious | : (przym.) odious | : (przym.) yucky
ojciec : ojciec : (rzecz.) father
ojcobojca : ojcobójca : (rzecz.) parricide | : (rzecz.) patricide
ojcobojczy : ojcobójczy : (przym.) parricidal
ojcobojstwo : ojcobójstwo : (rzecz.) parricide | : (rzecz.) patricide
ojcostwo : ojcostwo : (rzecz.) fatherhood | : (rzecz.) paternity
ojcowizna : ojcowizna : (rzecz.) inheritance | : (rzecz.) patrimony
ojcowski : ojcowski : (przym.) fatherly | : (przym.) paternal
ojczulek : ojczulek : (rzecz.) pa
ojczym : ojczym : (rzecz.) foster-father | : (rzecz.) stepfather | : (rzecz.) step-father
ojczysty : ojczysty : (przym.) native | : (przym.) paternal | : (przym.) vernacular
ojczyzna : ojczyzna : (rzecz.) country | : (rzecz.) fatherland | : (rzecz.) home | : (rzecz.) homeland | : (rzecz.) motherland
ojczyzniany : ojczyźniany : (przym.) home
ojej : ojej : (wykrzyknik) gee | : (wykrzyknik) gosh | : (wykrzyknik) oh | : (wykrzyknik) oops
okablowanie : okablowanie : (rzecz.) cabling | : (rzecz.) harness
okadzac : okadzać : (czas.) cense | : (czas.) incense
okadzenie : okadzenie : (rzecz.) fumigation
okalac : okalać : (czas.) border | : (czas.) surround
okaleczac : okaleczać : (czas.) cripple | : (czas.) disable | : (czas.) maim | : (czas.) mutilate
okaleczenie : okaleczenie : (rzecz.) mayhem | : (rzecz.) mutilation | : (rzecz.) wound
okaleczyc : okaleczyć : (czas.) deform | : (czas.) lame | : (czas.) maim | : (czas.) scathe | : (czas.) truncate
okantowac : okantować : (czas.) border
okap : okap : (rzecz.) eave | : (rzecz.) eaves | : (rzecz.) hood
okapturzyc : okapturzyć : (czas.) hood
okaryna : okaryna : (rzecz.) ocarina
okaz : okaz : (rzecz.) curio | : (rzecz.) exhibit | : (rzecz.) rattler | : (rzecz.) specimen
okazale : okazale : (przysł.) grandly | : (przysł.) richly
okazanie : okazanie : (rzecz.) presentation | : (rzecz.) render | : (rzecz.) showing
okazac : okazać : (czas.) impart | : (czas.) render | : (czas.) show
okazalosc : okazałość : (rzecz.) costliness | : (rzecz.) grandeur | : (rzecz.) stateliness
okazaly : okazały : (przym.) gorgeous | : (przym.) sumptuous
okaziciel : okaziciel : (rzecz.) bearer | : (rzecz.) carrier | : (rzecz.) holder
okazja : okazja : (rzecz.) bargain | : (rzecz.) chance | : (rzecz.) nonce | : (rzecz.) occasion | : (rzecz.) opportunity
okazjonalnie : okazjonalnie : (przysł.) occasionally
okazjonalny : okazjonalny : (przym.) occasional
okazyjnie : okazyjnie : (przysł.) occasionally
okazyjny : okazyjny : (przym.) chance
okazywac : okazywać : (czas.) accord | : (czas.) appear | : (czas.) bestow | : (czas.) display | : (czas.) exert | : (czas.) exhibit | : (czas.) prove | : (czas.) show | : (czas.) transpire
okcydentalny : okcydentalny : (przym.) occidental
okienko : okienko : (rzecz.) counter | : (rzecz.) shutter | : (rzecz.) slot | : (rzecz.) window
okienkowanie : okienkowanie : (rzecz.) windowing
okiennica : okiennica : (rzecz.) shutter
okielznac : okiełznać : (czas.) bridle
oklapnac : oklapnąć : (czas.) droop | : (czas.) flag | : (czas.) wilt
oklaski : oklaski : (rzecz.) applause | : (rzecz.) applauses
oklaskiwac : oklaskiwać : (czas.) acclaim | : (czas.) applaud | : (czas.) clap
oklepany : oklepany : (przym.) hackneyed | : (przym.) trite
oklepac : oklepać : (czas.) gallop
okludowac : okludować : (czas.) occlude
okluzja : okluzja : (rzecz.) occlusion
okno : okno : (rzecz.) pane | : (rzecz.) roundel | : (rzecz.) skylight | : (rzecz.) window
oko : oko : (rzecz.) eye | : (rzecz.) optic
okocic : okocić : (czas.) yean
okolica : okolica : (rzecz.) area | : (rzecz.) countryside | : (rzecz.) environs | : (rzecz.) locality | : (rzecz.) location | : (rzecz.) neighbourhood | : (rzecz.) region | : (rzecz.) side | : (rzecz.) site | : (rzecz.) surface | : (rzecz.) surroundings | : (rzecz.) vicinage
okolicznosciowy : okolicznościowy : (przym.) circumstantial | : (przym.) incidental | : (przym.) occasional
okolicznosc : okoliczność : (rzecz.) circumstance | : (rzecz.) fact | : (rzecz.) factor
okoliczny : okoliczny : (przym.) local | : (przym.) neighbouring
okop : okop : (rzecz.) ditch | : (rzecz.) entrenchment | : (rzecz.) foxhole | : (rzecz.) sap | : (rzecz.) trench
okopanie : okopanie : (rzecz.) entrenchment
okopac : okopać : (czas.) entrench | : (czas.) retrench
okopcic : okopcić : (czas.) smoke
okopowizna : okopowizna : (rzecz.) root
okopywac : okopywać : (czas.) entrench | : (czas.) unearth
okorek : okorek : (rzecz.) slab
okorowywac : okorowywać : (czas.) debark
okowy : okowy : (rzecz.) fetters
okolo : około : (przysł.) about | : (przysł.) approximately | : (przysł.) around | : (przysł.) by | : (przysł.) near | : (przysł.) toward
okoloksiezycowy : okołoksiężycowy : (przym.) encircling
okolosloneczny : okołosłoneczny : (przym.) encircling
okoloziemski : okołoziemski : (przym.) around
okon : okoń : (rzecz.) bass | : (rzecz.) perch
okpienie : okpienie : (rzecz.) dupery | : (rzecz.) take-in
okpic : okpić : (czas.) befool | : (czas.) diddle | : (czas.) jockey
okradanie : okradanie : (rzecz.) stealing
okradac : okradać : (czas.) defraud | : (czas.) rob | : (czas.) steal
okradzenie : okradzenie : (rzecz.) robbery
okrajac : okrajać : (czas.) bowdlerize | : (czas.) expurgate | : (czas.) prune
okrakiem : okrakiem : (przysł.) astraddle | : (przysł.) astride
okrasa : okrasa : (rzecz.) fat | : (rzecz.) gravy | : (rzecz.) grease
okraszenie : okraszenie : (rzecz.) gravy
okratowanie : okratowanie : (rzecz.) grating | : (rzecz.) grille | : (rzecz.) railing
okratowac : okratować : (czas.) grate
okrawanie : okrawanie : (rzecz.) expurgation | : (rzecz.) scissoring
okrawarka : okrawarka : (rzecz.) trimmer
okrawac : okrawać : (czas.) pare
okrawek : okrawek : (rzecz.) clipping | : (rzecz.) scrap
okrawki : okrawki : (rzecz.) trimmings
okrasc : okraść : (czas.) rob
okres : okres : (rzecz.) cycle | : (rzecz.) era | : (rzecz.) juvenescence | : (rzecz.) lapse | : (rzecz.) period | : (rzecz.) space | : (rzecz.) span | : (rzecz.) spell | : (rzecz.) stage | : (rzecz.) stint | : (rzecz.) streak | : (rzecz.) term | : (rzecz.) time
okresowo : okresowo : (przysł.) periodically
okresowosc : okresowość : (rzecz.) periodicity
okresowy : okresowy : (przym.) periodic | : (przym.) periodical | : (przym.) recurrent | : (przym.) temporary
okreslajacy : określający : (przym.) predicative
okreslanie : określanie : (rzecz.) attributive | : (rzecz.) description | : (rzecz.) determination
okreslac : określać : (czas.) appoint | : (czas.) assess | : (czas.) assign | : (czas.) define | : (czas.) denominate | : (czas.) describe | : (czas.) determine | : (czas.) predetermine | : (czas.) prescribe | : (czas.) qualify | : (czas.) specify | : (czas.) terminate
okreslenie : określenie : (rzecz.) appellation | : (rzecz.) definition | : (rzecz.) denomination | : (rzecz.) designation | : (rzecz.) determination | : (rzecz.) epithet | : (rzecz.) phrase | : (rzecz.) term
okreslic : określić : (czas.) define | : (czas.) denominate | : (czas.) specify
okreslnik : określnik : (rzecz.) determiner
okreslony : określony : (przym.) definite | : (przym.) determinate | : (przym.) specific
okroic : okroić : (czas.) expurgate
okrojenie : okrojenie : (rzecz.) abridgment | : (rzecz.) mutilation | : (rzecz.) pruning | : (rzecz.) truncation
okrojnik : okrojnik : (rzecz.) trimmer
okrojony : okrojony : (przym.) truncated
okropnie : okropnie : (przysł.) awfully | : (przysł.) beastly | : (przysł.) terribly
okropnosc : okropność : (rzecz.) atrociousness | : (rzecz.) atrocity | : (rzecz.) awfulness | : (rzecz.) ghastliness | : (rzecz.) hideousness | : (rzecz.) horror
okropny : okropny : (przym.) atrocious | : (przym.) awful | : (przym.) bad | : (przym.) dire | : (przym.) direful | : (przym.) disastrous | : (przym.) dreadful | : (przym.) fearful | : (przym.) fearsome | : (przym.) ghastly | : (przym.) grisly | : (przym.) gruesome | : (przym.) hateful | : (przym.) horrible | : (przym.) horrid | : (przym.) horrific | : (przym.) infernal | : (przym.) shocking | : (przym.) terrible | : (przym.) terrific | : (przym.) tremendous | : (przym.) unspeakable
okruch : okruch : (rzecz.) crumb | : (rzecz.) fragment
okrucienstwo : okrucieństwo : (rzecz.) atrociousness | : (rzecz.) atrocity | : (rzecz.) awfulness | : (rzecz.) cruelty | : (rzecz.) ferocity
okruszyna : okruszyna : (rzecz.) crumb
okrutnie : okrutnie : (przysł.) cruelly | : (przysł.) severely
okrutnik : okrutnik : (rzecz.) brute | : (rzecz.) tormentor
okrutny : okrutny : (przym.) atrocious | : (przym.) cruel | : (przym.) fell | : (przym.) ferocious | : (przym.) grim | : (przym.) sanguinary | : (przym.) savage | : (przym.) tyrannous
okrycie : okrycie : (rzecz.) coat | : (rzecz.) coating | : (rzecz.) covering | : (rzecz.) mantle | : (rzecz.) shroud
okrywa : okrywa : (rzecz.) coat
okrywanie : okrywanie : (rzecz.) coat | : (rzecz.) covering
okrywac : okrywać : (czas.) encase | : (czas.) envelop | : (czas.) shroud | : (czas.) vest
okryc : okryć : (czas.) cloak | : (czas.) clothe | : (czas.) cover | : (czas.) mantle
okrzemka : okrzemka : (rzecz.) diatom
okrzesanie : okrzesanie : (rzecz.) polish
okrzesac : okrzesać : (czas.) polish | : (czas.) rough-hew
okrzesywac : okrzesywać : (czas.) lop
okrzyczec : okrzyczeć : (czas.) decry
okrzyk : okrzyk : (rzecz.) cry | : (rzecz.) ejaculation | : (rzecz.) exclamation | : (rzecz.) interjection | : (rzecz.) outcry | : (rzecz.) shout
okrag : okrąg : (rzecz.) circle | : (rzecz.) township
okraglak : okrąglak : (rzecz.) boulder
okraglosc : okrągłość : (rzecz.) rotundity | : (rzecz.) roundness
okragly : okrągły : (przym.) circular | : (przym.) orbicular | : (przym.) plump | : (przym.) rotund | : (przym.) round
okrazac : okrążać : (czas.) circle | : (czas.) circumnavigate | : (czas.) encircle | : (czas.) encompass | : (czas.) orbit
okrazenie : okrążenie : (rzecz.) circuit | : (rzecz.) encirclement | : (rzecz.) envelopment | : (rzecz.) lap
okrazyc : okrążyć : (czas.) beset
okrecanie : okręcanie : (rzecz.) lathing
okrecac : okręcać : (czas.) slew | : (czas.) wrap
okreg : okręg : (rzecz.) ambit | : (rzecz.) circumference | : (rzecz.) district | : (rzecz.) precinct | : (rzecz.) township
okregowy : okręgowy : (przym.) regional | : (przym.) territorial
okret : okręt : (rzecz.) battleship | : (rzecz.) ship | : (rzecz.) ships | : (rzecz.) submarine | : (rzecz.) vessel | : (rzecz.) warship
okretka : okrętka : (rzecz.) swivel
okretowiec : okrętowiec : (rzecz.) shipbuilder
okretownictwo : okrętownictwo : (rzecz.) shipbuilding
okretowy : okrętowy : (przym.) maritime | : (przym.) naval
okreznica : okrężnica : (rzecz.) colon | : (rzecz.) gunwale | : (rzecz.) seine
okreznie : okrężnie : (przysł.) circularly | : (przysł.) circumferentially
okrezny : okrężny : (przym.) circuitous | : (przym.) circular | : (przym.) circumferential | : (przym.) devious | : (przym.) indirect | : (przym.) round | : (przym.) roundabout
oksydacja : oksydacja : (rzecz.) oxidation
oksydowanie : oksydowanie : (rzecz.) blueing | : (rzecz.) browning
oksydowac : oksydować : (czas.) oxidize
oksymoron : oksymoron : (rzecz.) oxymoron
oktagon : oktagon : (rzecz.) octagon
oktalny : oktalny : (przym.) octal
oktan : oktan : (rzecz.) octane
oktant : oktant : (rzecz.) octant
oktaw : oktaw : (rzecz.) octaves
oktawa : oktawa : (rzecz.) octave
oktet : oktet : (rzecz.) octet
oktylion : oktylion : (rzecz.) octillion
okucie : okucie : (rzecz.) ferrule | : (rzecz.) fitting | : (rzecz.) forge | : (rzecz.) tipi
okular : okular : (rzecz.) eyepiece | : (rzecz.) eye-piece | : (rzecz.) ocular | : (rzecz.) rest
okularnik : okularnik : (rzecz.) cobra
okularowy : okularowy : (przym.) eye-piece
okulary : okulary : (rzecz.) eyeglasses | : (rzecz.) glasses | : (rzecz.) specs | : (rzecz.) spectacle | : (rzecz.) spectacles
okulawiac : okulawiać : (czas.) lame
okulawic : okulawić : (czas.) lame
okulista : okulista : (rzecz.) oculist | : (rzecz.) ophthalmologist
okulistyka : okulistyka : (rzecz.) ophthalmology
okulizacja : okulizacja : (rzecz.) budding
okulizowanie : okulizowanie : (rzecz.) budding
okulizowac : okulizować : (czas.) bud
okultysta : okultysta : (rzecz.) occultist
okultystyczny : okultystyczny : (przym.) occult
okultyzm : okultyzm : (rzecz.) occultism
okup : okup : (rzecz.) ransom | : (rzecz.) sop
okupacja : okupacja : (rzecz.) occupancy | : (rzecz.) occupation | : (rzecz.) profession
okupacyjny : okupacyjny : (przym.) occupational
okupant : okupant : (rzecz.) invader | : (rzecz.) occupant | : (rzecz.) occupier
okupic : okupić : (czas.) buy | : (czas.) ransom
okupowac : okupować : (czas.) occupy
okupywac : okupywać : (czas.) buy
okurzanie : okurzanie : (rzecz.) dusting
okurzac : okurzać : (czas.) cense
okolnik : okólnik : (rzecz.) circular
okolny : okólny : (przym.) circuitous | : (przym.) circular | : (przym.) indirect | : (przym.) roundabout
oklad : okład : (rzecz.) cataplasm | : (rzecz.) compress | : (rzecz.) cover | : (rzecz.) poultice
okladanie : okładanie : (rzecz.) cataplasm | : (rzecz.) cladding
okladac : okładać : (czas.) fib | : (czas.) sandwich
okladka : okładka : (rzecz.) binder | : (rzecz.) cover | : (rzecz.) sleeve
okladzina : okładzina : (rzecz.) cladding | : (rzecz.) facing | : (rzecz.) lining
oklamac : okłamać : (czas.) deceive
oklamywac : okłamywać : (czas.) deceive
olbrzym : olbrzym : (rzecz.) biggie | : (rzecz.) colossus | : (rzecz.) giant | : (rzecz.) ogre | : (rzecz.) titan | : (rzecz.) whopper
olbrzymi : olbrzymi : (przym.) cavernous | : (przym.) colossal | : (przym.) enormous | : (przym.) gargantuan | : (przym.) giant | : (przym.) gigantic | : (przym.) huge | : (przym.) immense | : (przym.) king-size | : (przym.) mammoth | : (przym.) thundering | : (przym.) tremendous
olbrzymiec : olbrzymieć : (czas.) swell
olcha : olcha : (rzecz.) alder
oleander : oleander : (rzecz.) oleander
olefina : olefina : (rzecz.) olefin | : (rzecz.) olefins
oleinowy : oleinowy : (przym.) oleic
oleistosc : oleistość : (rzecz.) oiliness
oleisty : oleisty : (przym.) oiliest | : (przym.) oilseed | : (przym.) oily | : (przym.) oleaginous | : (przym.) unctuous
olej : olej : (rzecz.) oil
olejarka : olejarka : (rzecz.) oilcan
olejarnia : olejarnia : (rzecz.) mill
olejarz : olejarz : (rzecz.) oilman
olejek : olejek : (rzecz.) attar | : (rzecz.) oil
olejenie : olejenie : (rzecz.) oil
oleodruk : oleodruk : (rzecz.) chromolithograph
oleomargaryna : oleomargaryna : (rzecz.) oleomargarine
oligarcha : oligarcha : (rzecz.) oligarch
oligarchia : oligarchia : (rzecz.) oligarchy
oligarchiczny : oligarchiczny : (przym.) oligarchic
oligopol : oligopol : (rzecz.) oligopoly
oligosacharyd : oligosacharyd : (rzecz.) oligosaccharide
olimpiada : olimpiada : (rzecz.) contest | : (rzecz.) Olympiad | : (rzecz.) Olympics
olimpijczyk : olimpijczyk : (rzecz.) Olympian
olimpijski : olimpijski : (przym.) Olympian | : (przym.) Olympic
olinowanie : olinowanie : (rzecz.) cordage | : (rzecz.) rigging
oliwa : oliwa : (rzecz.) boozer | : (rzecz.) oil | : (rzecz.) olive | : (rzecz.) wino
oliwiarka : oliwiarka : (rzecz.) lubricator | : (rzecz.) oilcan
oliwienie : oliwienie : (rzecz.) lubrication
oliwin : oliwin : (rzecz.) olivine
oliwic : oliwić : (czas.) lubricate | : (czas.) oil
oliwka : oliwka : (rzecz.) olive
olstro : olstro : (rzecz.) holster
olsza : olsza : (rzecz.) alder
olsnienie : olśnienie : (rzecz.) brainwave | : (rzecz.) glare
olsniewajacy : olśniewający : (przym.) brilliant
olsniewac : olśniewać : (czas.) dazzle
olsnic : olśnić : (czas.) bedazzle | : (czas.) dazzle | : (czas.) enchant
om : om : (rzecz.) ohm
omackiem : omackiem : (przysł.) gropingly
omal : omal : (przysł.) almost | : (przysł.) nearly
omam : omam : (rzecz.) hallucination
omamiac : omamiać : (czas.) beguile | : (czas.) deceive | : (czas.) delude
omamienie : omamienie : (rzecz.) delusion | : (rzecz.) lure
omamic : omamić : (czas.) beguile | : (czas.) deceive | : (czas.) delude
oman : oman : (rzecz.) elecampane
omasta : omasta : (rzecz.) butter | : (rzecz.) fat
omaszczenie : omaszczenie : (rzecz.) greasing
omawiac : omawiać : (czas.) debate | : (czas.) discuss | : (czas.) negotiate
omascic : omaścić : (czas.) grease
omdlalosc : omdlałość : (rzecz.) fatigue
omdlenie : omdlenie : (rzecz.) collapse | : (rzecz.) faint | : (rzecz.) languor | : (rzecz.) swoon | : (rzecz.) syncope
omdlewajaco : omdlewająco : (przysł.) languidly
omdlewanie : omdlewanie : (rzecz.) droop | : (rzecz.) swelter
omdlewac : omdlewać : (czas.) languish | : (czas.) swoon
omdlec : omdleć : (czas.) languish | : (czas.) swoon
omiatanie : omiatanie : (rzecz.) sweeping
omiatac : omiatać : (czas.) sweep
omieszkac : omieszkać : (czas.) fail
omijanie : omijanie : (rzecz.) evasion | : (rzecz.) passing
omijac : omijać : (czas.) avoid | : (czas.) bypass | : (czas.) by-pass | : (czas.) dodge | : (czas.) evade | : (czas.) pass | : (czas.) pussyfoot
omlet : omlet : (rzecz.) omelette
omnibus : omnibus : (rzecz.) charabanc | : (rzecz.) char-a-banc
omnipotencja : omnipotencja : (rzecz.) omnipotence
omomierz : omomierz : (rzecz.) ohmmeter
omotac : omotać : (czas.) wrap
omotka : omotka : (rzecz.) frapping
omowny : omowny : (przym.) periphrastic
omszenie : omszenie : (rzecz.) pubescence
omurowanie : omurowanie : (rzecz.) walling
omurowac : omurować : (czas.) wall
omulek : omułek : (rzecz.) mussel
omylic : omylić : (czas.) lapse | : (czas.) mislead
omylnie : omylnie : (przysł.) fallibly
omylnosc : omylność : (rzecz.) erroneousness | : (rzecz.) fallibility
omylny : omylny : (przym.) fallible | : (przym.) misleading
omylka : omyłka : (rzecz.) blunder | : (rzecz.) error | : (rzecz.) fallaciousness | : (rzecz.) fault | : (rzecz.) lapse | : (rzecz.) mistake
omylkowy : omyłkowy : (przym.) erroneous | : (przym.) mistyped
omowienie : omówienie : (rzecz.) discussion | : (rzecz.) overview | : (rzecz.) review
omowic : omówić : (czas.) discuss
omlot : omłot : (rzecz.) threshing
onania : onania : (rzecz.) masturbation
onanizm : onanizm : (rzecz.) masturbation
onanizowac : onanizować : (czas.) masturbate
ondulacja : ondulacja : (rzecz.) wave
ondulowac : ondulować : (czas.) wave
onegdaj : onegdaj : (przysł.) once
ongis : ongiś : (przysł.) once
oniesmielac : onieśmielać : (czas.) browbeat | : (czas.) concuss | : (czas.) intimidate | : (czas.) overawe | : (czas.) overbear
oniesmielenie : onieśmielenie : (rzecz.) embarrassment | : (rzecz.) intimidation
oniesmielic : onieśmielić : (czas.) daunt | : (czas.) intimidate
onkolog : onkolog : (rzecz.) oncologist
onkologia : onkologia : (rzecz.) oncology
onomatopeiczny : onomatopeiczny : (przym.) onomatopoeic | : (przym.) onomatopoetic
onomatopeja : onomatopeja : (rzecz.) onomatopoeia
ontogeneza : ontogeneza : (rzecz.) ontogenesis
ontologia : ontologia : (rzecz.) ontology
ontologiczny : ontologiczny : (przym.) ontological
onyks : onyks : (rzecz.) onyx
opactwo : opactwo : (rzecz.) abbey
opacznie : opacznie : (przysł.) awry
opaczny : opaczny : (przym.) awry | : (przym.) erroneous | : (przym.) wrong
opad : opad : (rzecz.) fall | : (rzecz.) rainfall
opadajacy : opadający : (przym.) downward
opadanie : opadanie : (rzecz.) descent | : (rzecz.) droop | : (rzecz.) ebb | : (rzecz.) subsidence
opadac : opadać : (czas.) decline | : (czas.) decrease | : (czas.) descend | : (czas.) dip | : (czas.) droop | : (czas.) droops | : (czas.) drop | : (czas.) ebb | : (czas.) fall | : (czas.) fell | : (czas.) flag | : (czas.) gravitate | : (czas.) sag | : (czas.) sink | : (czas.) slake | : (czas.) slope | : (czas.) slump | : (czas.) subside
opadniecie : opadnięcie : (rzecz.) collapse | : (rzecz.) fallen | : (rzecz.) falling
opak : opak : (rzecz.) contrary
opakowanie : opakowanie : (rzecz.) carton | : (rzecz.) pack | : (rzecz.) package | : (rzecz.) packaging | : (rzecz.) packer | : (rzecz.) packet | : (rzecz.) packing | : (rzecz.) wrapper
opakowac : opakować : (czas.) wrap
opakowywac : opakowywać : (czas.) packaged
opal : opal : (rzecz.) opal
opalacz : opalacz : (rzecz.) beach-suit
opalanie : opalanie : (rzecz.) firing
opalac : opalać : (czas.) burn | : (czas.) singe | : (czas.) sunbathe | : (czas.) tan
opalenie : opalenie : (rzecz.) heating
opalenizna : opalenizna : (rzecz.) sunburn | : (rzecz.) suntan | : (rzecz.) sun-tan | : (rzecz.) tan
opalescencja : opalescencja : (rzecz.) opalescence
opalizacja : opalizacja : (rzecz.) iridescence | : (rzecz.) opalescence
opalizowanie : opalizowanie : (rzecz.) iridescence | : (rzecz.) opalescence
opalizujacy : opalizujący : (przym.) opalescent
opalic : opalić : (czas.) singe
opalony : opalony : (przym.) sunburnt | : (przym.) sun-tanned
opamietanie : opamiętanie : (rzecz.) reason | : (rzecz.) reflection
opamietac : opamiętać : (czas.) remember
opancerzanie : opancerzanie : (rzecz.) casing | : (rzecz.) plating
opancerzenie : opancerzenie : (rzecz.) armour | : (rzecz.) armour-plating | : (rzecz.) plate-armour | : (rzecz.) plating
opancerzony : opancerzony : (przym.) armoured | : (przym.) bullet-proof
opancerzyc : opancerzyć : (czas.) armour
opanowanie : opanowanie : (rzecz.) aplomb | : (rzecz.) capture | : (rzecz.) command | : (rzecz.) composure | : (rzecz.) coolness | : (rzecz.) countenance | : (rzecz.) equanimity | : (rzecz.) grip | : (rzecz.) mastery | : (rzecz.) restraint | : (rzecz.) self-command
opanowany : opanowany : (przym.) composed | : (przym.) cool | : (przym.) undemonstrative
opanowac : opanować : (czas.) engross | : (czas.) overmaster | : (czas.) overpower | : (czas.) overrule | : (czas.) subjugate | : (czas.) surmount
opanowywac : opanowywać : (czas.) capture | : (czas.) infest | : (czas.) overrun | : (czas.) subdue
opar : opar : (rzecz.) fume | : (rzecz.) haze | : (rzecz.) vapour
oparcie : oparcie : (rzecz.) arm | : (rzecz.) back | : (rzecz.) backbone | : (rzecz.) backrest | : (rzecz.) base | : (rzecz.) bolster | : (rzecz.) foothold | : (rzecz.) footing | : (rzecz.) maintenance | : (rzecz.) reliance | : (rzecz.) support
oparkanic : oparkanić : (czas.) fence
oparzelina : oparzelina : (rzecz.) burn | : (rzecz.) gall | : (rzecz.) scald
oparzelizna : oparzelizna : (rzecz.) burn
oparzenie : oparzenie : (rzecz.) burn | : (rzecz.) scald | : (rzecz.) sunburn
oparzyc : oparzyć : (czas.) burn | : (czas.) scald
opas : opas : (rzecz.) store
opasanie : opasanie : (rzecz.) belt | : (rzecz.) girder
opasac : opasać : (czas.) begird | : (czas.) enlace | : (czas.) gird | : (czas.) girdle
opaska : opaska : (rzecz.) armband | : (rzecz.) armlet | : (rzecz.) band | : (rzecz.) brassard | : (rzecz.) filler | : (rzecz.) fillet | : (rzecz.) headband | : (rzecz.) sweatband
opasywac : opasywać : (czas.) engird | : (czas.) gird | : (czas.) girdle | : (czas.) surround
opat : opat : (rzecz.) abbot
opatrunek : opatrunek : (rzecz.) bandage | : (rzecz.) binding | : (rzecz.) dressing | : (rzecz.) ligature
opatrywanie : opatrywanie : (rzecz.) dressing
opatrywac : opatrywać : (czas.) bind | : (czas.) dress | : (czas.) fix
opatrznosciowy : opatrznościowy : (przym.) heaven-sent | : (przym.) provident | : (przym.) providential
opatrznosc : opatrzność : (rzecz.) providence
opatrzyc : opatrzyć : (czas.) attach | : (czas.) dress
opatulac : opatulać : (czas.) muffle
opal : opał : (rzecz.) fuel | : (rzecz.) wood
opasc : opaść : (czas.) abate | : (czas.) fall | : (czas.) lapse | : (czas.) subside
opchac : opchać : (czas.) stuff
opcja : opcja : (rzecz.) option
opcje : opcje : (rzecz.) preferences
opcjonalnie : opcjonalnie : (przysł.) optionally
opcjonalny : opcjonalny : (przym.) optional
opera : opera : (rzecz.) doubler | : (rzecz.) opera | : (rzecz.) opera-house
operacja : operacja : (rzecz.) operation | : (rzecz.) surgery
operacyjny : operacyjny : (przym.) operable | : (przym.) operating | : (przym.) operational | : (przym.) operative | : (przym.) surgical
operand : operand : (rzecz.) operand
operator : operator : (rzecz.) operator | : (rzecz.) provider
operatorowy : operatorowy : (przym.) operational
operatywnosc : operatywność : (rzecz.) efficiency
operatywny : operatywny : (przym.) efficient | : (przym.) operative
operetka : operetka : (rzecz.) operetta
operetkowy : operetkowy : (przym.) farcical
operowac : operować : (czas.) operate
operowy : operowy : (przym.) operatic
opieczetowac : opieczętować : (czas.) seal
opieka : opieka : (rzecz.) attention | : (rzecz.) care | : (rzecz.) custody | : (rzecz.) keeping | : (rzecz.) patronage | : (rzecz.) protection | : (rzecz.) provision | : (rzecz.) safekeeping | : (rzecz.) tutelage | : (rzecz.) ward
opiekacz : opiekacz : (rzecz.) grill | : (rzecz.) toaster
opiekac : opiekać : (czas.) broil | : (czas.) toast
opiekowac : opiekować : (czas.) care | : (czas.) chaperon | : (czas.) patronize | : (czas.) tend
opiekun : opiekun : (rzecz.) carer | : (rzecz.) caretaker | : (rzecz.) chaperone | : (rzecz.) curator | : (rzecz.) foster-father | : (rzecz.) guardian | : (rzecz.) keeper | : (rzecz.) patrol | : (rzecz.) patron | : (rzecz.) protector | : (rzecz.) trustee | : (rzecz.) tutor | : (rzecz.) warden | : (rzecz.) warder
opiekunczosc : opiekuńczość : (rzecz.) assistance | : (rzecz.) protectiveness
opiekunczy : opiekuńczy : (przym.) caring | : (przym.) custodial | : (przym.) tutelary
opieprzyc : opieprzyć : (czas.) pepper
opierac : opierać : (czas.) abut | : (czas.) base | : (czas.) build | : (czas.) defy | : (czas.) found | : (czas.) ground | : (czas.) jib | : (czas.) kick | : (czas.) lean | : (czas.) rely | : (czas.) repose | : (czas.) resist | : (czas.) rest | : (czas.) stay | : (czas.) withstand | : (czas.) withstood
opierunek : opierunek : (rzecz.) washing
opierzenie : opierzenie : (rzecz.) feather | : (rzecz.) feathering
opierzony : opierzony : (przym.) fledged
opieszalec : opieszalec : (rzecz.) laggard
opieszalosc : opieszałość : (rzecz.) indolence | : (rzecz.) laziness | : (rzecz.) slowness | : (rzecz.) tardiness
opieszaly : opieszały : (przym.) backward | : (przym.) slack
opiewac : opiewać : (czas.) chant | : (czas.) state
opilstwo : opilstwo : (rzecz.) drunkenness | : (rzecz.) intoxication
opinia : opinia : (rzecz.) estimation | : (rzecz.) feedback | : (rzecz.) mind | : (rzecz.) opinion | : (rzecz.) peer | : (rzecz.) preconception | : (rzecz.) sentiment | : (rzecz.) verdict | : (rzecz.) view
opiniodawca : opiniodawca : (rzecz.) adviser
opiniodawczy : opiniodawczy : (przym.) advisory | : (przym.) deliberative
opinka : opinka : (rzecz.) waling
opis : opis : (rzecz.) circumscription | : (rzecz.) delineation | : (rzecz.) description | : (rzecz.) designation | : (rzecz.) overview | : (rzecz.) picture | : (rzecz.) review
opisanie : opisanie : (rzecz.) description | : (rzecz.) portrayal
opisac : opisać : (czas.) characterize | : (czas.) circumscribe | : (czas.) describe | : (czas.) represent
opisowy : opisowy : (przym.) descriptive | : (przym.) narrative
opisywalny : opisywalny : (przym.) describable
opisywac : opisywać : (czas.) circumscribe | : (czas.) delineate | : (czas.) depict | : (czas.) describe | : (czas.) document | : (czas.) feature | : (czas.) portray
opium : opium : (rzecz.) opium
opiac : opiąć : (czas.) enwrap
opilek : opiłek : (rzecz.) filing | : (rzecz.) shaving
opilki : opiłki : (rzecz.) filings
oplatanie : oplatanie : (rzecz.) braiding | : (rzecz.) cost
oplatarka : oplatarka : (rzecz.) braider
oplatac : oplatać : (czas.) braid | : (czas.) entangle | : (czas.) entwine | : (czas.) twine | : (czas.) wind
oplot : oplot : (rzecz.) braid | : (rzecz.) braiding
opluc : opluć : (czas.) spit
oplatac : oplątać : (czas.) captivate | : (czas.) entwine
opodal : opodal : (przysł.) near | : (przysł.) nearby | : (przysł.) off
opodatkowanie : opodatkowanie : (rzecz.) assessment | : (rzecz.) tax | : (rzecz.) taxation
opodatkowac : opodatkować : (czas.) tax
opodatkowywanie : opodatkowywanie : (rzecz.) taxing
opodatkowywac : opodatkowywać : (czas.) tax
opoka : opoka : (rzecz.) rock
opona : opona : (rzecz.) tire | : (rzecz.) tyre
oponent : oponent : (rzecz.) adversary | : (rzecz.) antagonist | : (rzecz.) objector | : (rzecz.) opponent
oponowac : oponować : (czas.) object | : (czas.) oppose | : (czas.) withstand
opornica : opornica : (rzecz.) resistance
opornik : opornik : (rzecz.) resistance | : (rzecz.) resistor
opornik-kondensator : opornik-kondensator : (rzecz.) resistor-capacitor
opornikow : oporników : (rzecz.) capping
opornosc : oporność : (rzecz.) resistance
opornosc-indukcyjnosc : oporność-indukcyjność : (rzecz.) resistance-inductance
opornosc-pojemnosc : oporność-pojemność : (rzecz.) resistance-capacitance
oporny : oporny : (przym.) contumacious | : (przym.) defiant | : (przym.) deficient | : (przym.) disobedient | : (przym.) obstreperous | : (przym.) recalcitrant | : (przym.) refractory | : (przym.) reluctant | : (przym.) resistant | : (przym.) resistive | : (przym.) restive | : (przym.) stubborn | : (przym.) tough | : (przym.) untoward
oportunista : oportunista : (rzecz.) goody-goody | : (rzecz.) opportunist | : (rzecz.) timeserver | : (rzecz.) time-server
oportunistyczny : oportunistyczny : (przym.) opportunistic
oportunizm : oportunizm : (rzecz.) expedience | : (rzecz.) expediency | : (rzecz.) opportunism
oporzadzanie : oporządzanie : (rzecz.) grooming
oporzadzac : oporządzać : (czas.) trim
oporzadzenie : oporządzenie : (rzecz.) equipment
opos : opos : (rzecz.) opossum
opowiadacz : opowiadacz : (rzecz.) storyteller | : (rzecz.) story-teller
opowiadanie : opowiadanie : (rzecz.) narration | : (rzecz.) narrative | : (rzecz.) novelette | : (rzecz.) recital | : (rzecz.) recitals | : (rzecz.) relation | : (rzecz.) story | : (rzecz.) storytelling | : (rzecz.) tale | : (rzecz.) whodunit | : (rzecz.) yarn
opowiadac : opowiadać : (czas.) narrate | : (czas.) recount | : (czas.) relate | : (czas.) tell
opowiastka : opowiastka : (rzecz.) tale
opowiedziec : opowiedzieć : (czas.) opt | : (czas.) tell
opowiesc : opowieść : (rzecz.) spiel | : (rzecz.) story | : (rzecz.) tale
opozycja : opozycja : (rzecz.) dissidence | : (rzecz.) opposition
opozycjonista : opozycjonista : (rzecz.) oppositionist
opozycyjnosc : opozycyjność : (rzecz.) resistance
opozycyjny : opozycyjny : (przym.) oppositional
opracowanie : opracowanie : (rzecz.) development | : (rzecz.) elaboration | : (rzecz.) handling | : (rzecz.) study
opracowac : opracować : (czas.) compile | : (czas.) develop | : (czas.) elaborate
opracowywanie : opracowywanie : (rzecz.) development
opracowywac : opracowywać : (czas.) compile | : (czas.) develop | : (czas.) devise | : (czas.) elaborate | : (czas.) operate
oprawa : oprawa : (rzecz.) binding | : (rzecz.) casing | : (rzecz.) frame | : (rzecz.) mount | : (rzecz.) mounting | : (rzecz.) selling | : (rzecz.) setting | : (rzecz.) stock
oprawca : oprawca : (rzecz.) assassin | : (rzecz.) butcher | : (rzecz.) hangman | : (rzecz.) torturer
oprawianie : oprawianie : (rzecz.) binding | : (rzecz.) framing
oprawiac : oprawiać : (czas.) bind | : (czas.) encase | : (czas.) enchase | : (czas.) frame
oprawienie : oprawienie : (rzecz.) binding | : (rzecz.) framing
oprawic : oprawić : (czas.) encase
oprawka : oprawka : (rzecz.) holder | : (rzecz.) rim | : (rzecz.) socket
oprawny : oprawny : (przym.) bound
opresja : opresja : (rzecz.) oppression | : (rzecz.) press
oprocentowanie : oprocentowanie : (rzecz.) interest
oprofilowanie : oprofilowanie : (rzecz.) fairing
oprofilowany : oprofilowany : (przym.) faired
oprogramowanie : oprogramowanie : (rzecz.) software
opromieniac : opromieniać : (czas.) cheer
oprosic : oprosić : (czas.) pig
oprowadzac : oprowadzać : (czas.) guide | : (czas.) round
opryskac : opryskać : (czas.) bespatter | : (czas.) splash | : (czas.) sprinkle
opryskiwacz : opryskiwacz : (rzecz.) sprayer | : (rzecz.) sprinkler
opryskiwanie : opryskiwanie : (rzecz.) spray
opryskiwac : opryskiwać : (czas.) spatter | : (czas.) spray
opryskliwie : opryskliwie : (przysł.) brusquely | : (przysł.) harshly
opryskliwosc : opryskliwość : (rzecz.) brusqueness | : (rzecz.) harshness | : (rzecz.) petulance
opryskliwy : opryskliwy : (przym.) abrupt | : (przym.) crabbed | : (przym.) fractious | : (przym.) gruff | : (przym.) ill-natured | : (przym.) pettish | : (przym.) petulant | : (przym.) sassy | : (przym.) short | : (przym.) surly
opryszczka : opryszczka : (rzecz.) herpes
opryszczkowy : opryszczkowy : (przym.) herpetic
oprzec : oprzeć : (czas.) base
oprzyrzadowania : oprzyrządowania : (rzecz.) tooling
oprzyrzadowanie : oprzyrządowanie : (rzecz.) instrumentation
oprzytomniec : oprzytomnieć : (czas.) consciousness | : (czas.) rally
oprzatac : oprzątać : (czas.) tidy
oprzed : oprzęd : (rzecz.) cocoon
oprocz : oprócz : (przyim.) beside | : (przyim.) besides | : (przyim.) beyond | : (przyim.) but | : (przyim.) except | : (przyim.) excepting
oproznianie : opróżnianie : (rzecz.) evacuation
oprozniac : opróżniać : (czas.) empty | : (czas.) evacuate | : (czas.) exhaust | : (czas.) vacate
oproznienie : opróżnienie : (rzecz.) exhaustion | : (rzecz.) flush
oproznic : opróżnić : (czas.) empty | : (czas.) exhaust | : (czas.) vacate
optimum : optimum : (rzecz.) optimum
optoelektronika : optoelektronika : (rzecz.) optoelectronics
optowac : optować : (czas.) espouse | : (czas.) opt
optycznie : optycznie : (przysł.) optically
optyczny : optyczny : (przym.) optic | : (przym.) optical
optyk : optyk : (rzecz.) oculist | : (rzecz.) optician
optyka : optyka : (rzecz.) optician | : (rzecz.) optics
optymalizacja : optymalizacja : (rzecz.) optimization
optymalizator : optymalizator : (rzecz.) optimizer
optymalizowanie : optymalizowanie : (rzecz.) optimizing
optymalizowac : optymalizować : (czas.) optimize
optymalnie : optymalnie : (przysł.) best | : (przysł.) ideally | : (przysł.) optimally
optymalnosc : optymalność : (rzecz.) optimality
optymalny : optymalny : (przym.) optimal
optymista : optymista : (rzecz.) optimist
optymistycznie : optymistycznie : (przysł.) optimistically
optymistyczny : optymistyczny : (przym.) hopeful | : (przym.) optimistic | : (przym.) positive | : (przym.) sanguine
optymizacja : optymizacja : (rzecz.) optimization
optymizator : optymizator : (rzecz.) optimizer | : (rzecz.) optimizers
optymizm : optymizm : (rzecz.) hopefulness | : (rzecz.) optimism
opublikowanie : opublikowanie : (rzecz.) posting
opublikowac : opublikować : (czas.) print | : (czas.) publish
opuchlina : opuchlina : (rzecz.) swelling
opuchlizna : opuchlizna : (rzecz.) protuberance | : (rzecz.) puffiness | : (rzecz.) swell | : (rzecz.) swelling | : (rzecz.) tumour
opuchniecie : opuchnięcie : (rzecz.) swelling
opuchniety : opuchnięty : (przym.) swollen
opuchnac : opuchnąć : (czas.) swell
opukanie : opukanie : (rzecz.) auscultation
opukac : opukać : (czas.) tap
opust : opust : (rzecz.) discount | : (rzecz.) rebate
opustoszec : opustoszeć : (czas.) empty
opustoszyc : opustoszyć : (czas.) ravage
opuszczanie : opuszczanie : (rzecz.) abandoning | : (rzecz.) absenting | : (rzecz.) disembarkation
opuszczac : opuszczać : (czas.) abandon | : (czas.) abort | : (czas.) absent | : (czas.) descend | : (czas.) desert | : (czas.) desolate | : (czas.) elide | : (czas.) exit | : (czas.) forsake | : (czas.) forsaken | : (czas.) leave | : (czas.) left | : (czas.) lower | : (czas.) miss | : (czas.) omit | : (czas.) quit | : (czas.) relinquish | : (czas.) skip | : (czas.) slacken | : (czas.) slouch | : (czas.) vacate
opuszczenie : opuszczenie : (rzecz.) abandonment | : (rzecz.) dereliction | : (rzecz.) lapse | : (rzecz.) leave | : (rzecz.) omission
opuszczony : opuszczony : (przym.) abandoned | : (przym.) forlorn | : (przym.) godforsaken | : (przym.) unfrequented
opuszka : opuszka : (rzecz.) bulb | : (rzecz.) fingertip
opuscic : opuścić : (czas.) abandon | : (czas.) abort | : (czas.) desert | : (czas.) desolate | : (czas.) elide | : (czas.) exit | : (czas.) forsake | : (czas.) leave | : (czas.) miss | : (czas.) relinquish | : (czas.) skip | : (czas.) slacken | : (czas.) slouch
opychanie : opychanie : (rzecz.) stuffing
opylacz : opylacz : (rzecz.) duster | : (rzecz.) sprinkler
opylanie : opylanie : (rzecz.) dusting | : (rzecz.) sprinkling
opylic : opylić : (czas.) spray
opoj : opój : (rzecz.) dipsomaniac | : (rzecz.) drunkard
opor : opór : (rzecz.) capacitance | : (rzecz.) contumacy | : (rzecz.) defiance | : (rzecz.) drag | : (rzecz.) impedance | : (rzecz.) opposition | : (rzecz.) reluctance | : (rzecz.) resistance | : (rzecz.) shoulder
opozniacz : opóźniacz : (rzecz.) delayer | : (rzecz.) retardant
opozniajacy : opóźniający : (przym.) retardant
opoznianie : opóźnianie : (rzecz.) delay
opozniac : opóźniać : (czas.) delay | : (czas.) delay | : (czas.) impede | : (czas.) lag | : (czas.) retard
opoznienie : opóźnienie : (rzecz.) deceleration | : (rzecz.) delay | : (rzecz.) lag | : (rzecz.) latency | : (rzecz.) retardation
opozniony : opóźniony : (przym.) delayed | : (przym.) overdue
opoznic : opóźnić : (czas.) delay | : (czas.) retard
opedzac : opędzać : (czas.) defray
opetanie : opętanie : (rzecz.) obsession
opetaniec : opętaniec : (rzecz.) fanatic
opetany : opętany : (przym.) possessed
opetac : opętać : (czas.) obsess
opetanczy : opętańczy : (przym.) daemonic | : (przym.) demoniac | : (przym.) demoniacal
opetywac : opętywać : (czas.) possess
oplacajacy : opłacający : (przym.) remunerative
oplacalnosc : opłacalność : (rzecz.) payoff | : (rzecz.) profitability
oplacalny : opłacalny : (przym.) cost-effective | : (przym.) profitable | : (przym.) remunerative
oplacanie : opłacanie : (rzecz.) payment
oplacac : opłacać : (czas.) cash | : (czas.) defray | : (czas.) pay
oplacenie : opłacenie : (rzecz.) pay
oplacic : opłacić : (czas.) cash | : (czas.) pay
oplakany : opłakany : (przym.) deplorable | : (przym.) lamentable | : (przym.) regrettable
oplakiwanie : opłakiwanie : (rzecz.) bewailing
oplakiwac : opłakiwać : (czas.) bemoan | : (czas.) bewail | : (czas.) deplore | : (czas.) lament | : (czas.) mourn | : (czas.) weep
oplata : opłata : (rzecz.) charge | : (rzecz.) defrayal | : (rzecz.) fare | : (rzecz.) fee | : (rzecz.) payment | : (rzecz.) premium | : (rzecz.) toll
oplatek : opłatek : (rzecz.) wafer
oplotek : opłotek : (rzecz.) hurdle
oplucna : opłucna : (rzecz.) pleura
oplucnowy : opłucnowy : (przym.) pleural
oplukac : opłukać : (czas.) rinse
oplukiwac : opłukiwać : (czas.) lap
oplyniecie : opłynięcie : (rzecz.) circumnavigation
oplywac : opływać : (czas.) circumnavigate | : (czas.) row
oplywowosc : opływowość : (rzecz.) streamlining
oplywowy : opływowy : (przym.) streamlined
oracja : oracja : (rzecz.) oration
oracz : oracz : (rzecz.) ploughman
oralny : oralny : (przym.) oral
orangutan : orangutan : (rzecz.) orang-utan
oranz : oranż : (rzecz.) orange
oranzada : oranżada : (rzecz.) orangeade
oranzeria : oranżeria : (rzecz.) conservatory | : (rzecz.) hothouse
oratorium : oratorium : (rzecz.) oratorio | : (rzecz.) oratory
oratorski : oratorski : (przym.) oratorical
oratorstwo : oratorstwo : (rzecz.) eloquence | : (rzecz.) oratory
oratoryjny : oratoryjny : (przym.) oratorical
oraz : oraz : (spójnik) and
orac : orać : (czas.) furrow | : (czas.) plough | : (czas.) till
orbita : orbita : (rzecz.) orbit
orbitalny : orbitalny : (przym.) orbital
orbitowanie : orbitowanie : (rzecz.) orbiting
orbitowac : orbitować : (czas.) orbit
orchidea : orchidea : (rzecz.) orchid
orczyca : orczyca : (rzecz.) evener
orczyk : orczyk : (rzecz.) brail | : (rzecz.) whiffletree
orda : orda : (rzecz.) horde
order : order : (rzecz.) decoration
ordynacja : ordynacja : (rzecz.) law
ordynans : ordynans : (rzecz.) batman | : (rzecz.) orderly
ordynariusz : ordynariusz : (rzecz.) ordinary
ordynarnie : ordynarnie : (przysł.) coarsely | : (przysł.) outright | : (przysł.) roughly
ordynarnosc : ordynarność : (rzecz.) coarseness | : (rzecz.) crudeness | : (rzecz.) grossness | : (rzecz.) rankness | : (rzecz.) ribaldry
ordynarny : ordynarny : (przym.) coarse | : (przym.) gross | : (przym.) offensive | : (przym.) ornery | : (przym.) raffish | : (przym.) rude | : (przym.) scurrilous | : (przym.) vulgar
ordynator : ordynator : (rzecz.) head
ordynowac : ordynować : (czas.) practice
ordynus : ordynus : (rzecz.) boor | : (rzecz.) cad
organ : organ : (rzecz.) body | : (rzecz.) organ
organdyna : organdyna : (rzecz.) organdie
organek : organek : (rzecz.) galley
organiczny : organiczny : (przym.) organic
organista : organista : (rzecz.) organist
organizacja : organizacja : (rzecz.) establishment | : (rzecz.) management | : (rzecz.) organisation | : (rzecz.) organization
organizacyjnie : organizacyjnie : (przysł.) organisationally | : (przysł.) organizationally
organizacyjny : organizacyjny : (przym.) organizational
organizator : organizator : (rzecz.) arranger | : (rzecz.) manager | : (rzecz.) marshal | : (rzecz.) organizer | : (rzecz.) promoter
organizatorski : organizatorski : (przym.) organizational
organizm : organizm : (rzecz.) body | : (rzecz.) organism | : (rzecz.) system
organizowanie : organizowanie : (rzecz.) organisation | : (rzecz.) organization
organizowac : organizować : (czas.) arrange | : (czas.) organise | : (czas.) organize | : (czas.) sort | : (czas.) stage
organki : organki : (rzecz.) mouth
organy : organy : (rzecz.) organ
orgazm : orgazm : (rzecz.) orgasm
orgia : orgia : (rzecz.) mutiny | : (rzecz.) orgy | : (rzecz.) saturnalia
orgiastyczny : orgiastyczny : (przym.) orgiastic
orientacja : orientacja : (rzecz.) acumen | : (rzecz.) alignment | : (rzecz.) attitude | : (rzecz.) discernment | : (rzecz.) orientation
orientacyjny : orientacyjny : (przym.) explorative
orientalny : orientalny : (przym.) oriental
orientowanie : orientowanie : (rzecz.) orientation
orientowac : orientować : (czas.) align | : (czas.) orientate
orka : orka : (rzecz.) tillage
orkan : orkan : (rzecz.) hurricane
orkiestra : orkiestra : (rzecz.) band | : (rzecz.) orchestra
orkiestracja : orkiestracja : (rzecz.) orchestration
orkiestralny : orkiestralny : (przym.) orchestral
orkiestrowac : orkiestrować : (czas.) orchestrate
orkiestrowy : orkiestrowy : (przym.) orchestral
orli : orli : (przym.) aquiline
orlik : orlik : (rzecz.) columbine
orlatko : orlątko : (rzecz.) eaglet
ornament : ornament : (rzecz.) dingbat | : (rzecz.) ornament
ornamentacja : ornamentacja : (rzecz.) ornament | : (rzecz.) ornamentation
ornamentacyjny : ornamentacyjny : (przym.) ornamental
ornamentalny : ornamentalny : (przym.) decorative | : (przym.) ornamental
ornamentowanie : ornamentowanie : (rzecz.) ornamentation
ornamentowy : ornamentowy : (przym.) ornamental
ornamentyka : ornamentyka : (rzecz.) ornamentation | : (rzecz.) ornaments
ornat : ornat : (rzecz.) chasuble | : (rzecz.) vestment
ornitofauna : ornitofauna : (rzecz.) avifauna
ornitolog : ornitolog : (rzecz.) ornithologist
ornitologia : ornitologia : (rzecz.) ornithology
ornitologiczny : ornitologiczny : (przym.) ornithological
orny : orny : (przym.) arable
orosienie : orosienie : (rzecz.) reflux
orszak : orszak : (rzecz.) host | : (rzecz.) procession | : (rzecz.) retainer | : (rzecz.) retainers | : (rzecz.) retinue | : (rzecz.) suite | : (rzecz.) train
orsztyn : orsztyn : (rzecz.) hardpan
ortikon : ortikon : (rzecz.) orthicon
ortodoksja : ortodoksja : (rzecz.) orthodoxy
ortodoksyjny : ortodoksyjny : (przym.) orthodox
ortodoncja : ortodoncja : (rzecz.) orthodontia | : (rzecz.) orthodontics
ortodonta : ortodonta : (rzecz.) orthodontist
ortogonalny : ortogonalny : (przym.) orthogonal
ortografia : ortografia : (rzecz.) orthography | : (rzecz.) spelling
ortograficznie : ortograficznie : (przysł.) correctly | : (przysł.) orthographically
ortograficzny : ortograficzny : (przym.) correct | : (przym.) orthographic | : (przym.) orthographical
ortoklaz : ortoklaz : (rzecz.) orthoclase
ortopeda : ortopeda : (rzecz.) orthopaedist
ortopedyczny : ortopedyczny : (przym.) orthopaedic
oryginalnie : oryginalnie : (przysł.) originally
oryginalnosc : oryginalność : (rzecz.) originality | : (rzecz.) quaintness
oryginalny : oryginalny : (przym.) genuine | : (przym.) original | : (przym.) quaint
oryginal : oryginał : (rzecz.) dork | : (rzecz.) individual | : (rzecz.) kook | : (rzecz.) original
orzech : orzech : (rzecz.) cashew | : (rzecz.) nut | : (rzecz.) walnut
orzechowy : orzechowy : (przym.) nut-brown
orzechowka : orzechówka : (rzecz.) nutcracker | : (rzecz.) nut-cracker
orzeczenie : orzeczenie : (rzecz.) judgement | : (rzecz.) judgment | : (rzecz.) predicate | : (rzecz.) pronouncement | : (rzecz.) ruling | : (rzecz.) syndication
orzecznictwo : orzecznictwo : (rzecz.) jurisdiction
orzecznikowy : orzecznikowy : (przym.) predicative
orzekac : orzekać : (czas.) predicate | : (czas.) rule | : (czas.) state
orzekniecie : orzeknięcie : (rzecz.) adjudication | : (rzecz.) rule
orzesznik : orzesznik : (rzecz.) hickory
orzel : orzeł : (rzecz.) eagle
orzezwiac : orzeźwiać : (czas.) invigorate | : (czas.) refresh
orzezwienie : orzeźwienie : (rzecz.) refresher | : (rzecz.) refreshment
orzezwic : orzeźwić : (czas.) invigorate
oredowac : orędować : (czas.) advocate
oredownictwo : orędownictwo : (rzecz.) espousal
oredownik : orędownik : (rzecz.) advocate | : (rzecz.) apostle | : (rzecz.) barrister | : (rzecz.) spokesman
oredzie : orędzie : (rzecz.) message | : (rzecz.) proclamation
orez : oręż : (rzecz.) weapon
orzniecie : orżnięcie : (rzecz.) swindle
osa : osa : (rzecz.) wasp
osaczac : osaczać : (czas.) encircle
osaczenie : osaczenie : (rzecz.) encirclement
osad : osad : (rzecz.) debris | : (rzecz.) deposit | : (rzecz.) dreg | : (rzecz.) dregs | : (rzecz.) faeces | : (rzecz.) lees | : (rzecz.) residual | : (rzecz.) residuum | : (rzecz.) sediment | : (rzecz.) settlings | : (rzecz.) silt
osada : osada : (rzecz.) colony | : (rzecz.) hamlet | : (rzecz.) settlement
osadnictwo : osadnictwo : (rzecz.) colonization | : (rzecz.) settlement
osadniczka : osadniczka : (rzecz.) settler
osadniczy : osadniczy : (przym.) colonial
osadnik : osadnik : (rzecz.) colonist | : (rzecz.) homesteader | : (rzecz.) settler
osadowy : osadowy : (przym.) alluvial | : (przym.) residual | : (przym.) sedimentary
osadzanie : osadzanie : (rzecz.) deposition | : (rzecz.) sediment | : (rzecz.) sedimentation
osadzac : osadzać : (czas.) commit | : (czas.) embed | : (czas.) mount | : (czas.) precipitate | : (czas.) reside | : (czas.) settle
osadzenie : osadzenie : (rzecz.) deposition | : (rzecz.) seating | : (rzecz.) sediment | : (rzecz.) set-back
osadzic : osadzić : (czas.) embed | : (czas.) mount | : (czas.) settle
osamotnienie : osamotnienie : (rzecz.) desolation | : (rzecz.) isolation | : (rzecz.) loneliness | : (rzecz.) retirement | : (rzecz.) seclusion | : (rzecz.) solitude
osamotniony : osamotniony : (przym.) retired
osamotnic : osamotnić : (czas.) desert
oschle : oschle : (przysł.) coldly | : (przysł.) dryly
oschlosc : oschłość : (rzecz.) coldness
oschly : oschły : (przym.) curt
oscylacja : oscylacja : (rzecz.) oscillation
oscylacje : oscylacje : (rzecz.) vibrations
oscylacyjny : oscylacyjny : (przym.) oscillatory
oscylator : oscylator : (rzecz.) oscillator | : (rzecz.) vibrator
oscyloskop : oscyloskop : (rzecz.) oscilloscope | : (rzecz.) oscilloscopes
oscylowac : oscylować : (czas.) oscillate | : (czas.) vibrate
oscylujacy : oscylujący : (przym.) oscillatory
osesek : osesek : (rzecz.) nurseling | : (rzecz.) nursling | : (rzecz.) sucker | : (rzecz.) suckling
oset : oset : (rzecz.) thistle
oselka : osełka : (rzecz.) burr | : (rzecz.) grindstone | : (rzecz.) hone | : (rzecz.) whetstone
osiadanie : osiadanie : (rzecz.) settling | : (rzecz.) subsidence
osiadac : osiadać : (czas.) settle | : (czas.) sink | : (czas.) subside
osiedlanie : osiedlanie : (rzecz.) settle | : (rzecz.) settlement | : (rzecz.) settling
osiedlac : osiedlać : (czas.) fix | : (czas.) locate | : (czas.) plant | : (czas.) setting | : (czas.) settle
osiedle : osiedle : (rzecz.) area | : (rzecz.) estate | : (rzecz.) settlement
osiedleniec : osiedleniec : (rzecz.) colonizer | : (rzecz.) settler
osiedlic : osiedlić : (czas.) fix | : (czas.) locate | : (czas.) settle
osiemnasty : osiemnasty : (przym.) eighteenth
osierdzie : osierdzie : (rzecz.) pericardium
osierocenie : osierocenie : (rzecz.) bereavement
osierocic : osierocić : (czas.) bereave | : (czas.) bereft | : (czas.) orphan
osika : osika : (rzecz.) asp | : (rzecz.) aspen
osiowanie : osiowanie : (rzecz.) alignment
osiowac : osiować : (czas.) align
osiowo : osiowo : (przysł.) axially
osiowy : osiowy : (przym.) axial | : (przym.) pivotal
osiol : osioł : (rzecz.) ass | : (rzecz.) burro | : (rzecz.) donkey | : (rzecz.) idol | : (rzecz.) jackass
osiagalnosc : osiągalność : (rzecz.) attainability | : (rzecz.) availability
osiagalny : osiągalny : (przym.) accessible | : (przym.) achievable | : (przym.) approachable | : (przym.) attainable | : (przym.) available | : (przym.) get-at-able | : (przym.) obtainable | : (przym.) reachable | : (przym.) touchable
osiagac : osiągać : (czas.) accomplish | : (czas.) achieve | : (czas.) achieved | : (czas.) acquire | : (czas.) amount | : (czas.) attain | : (czas.) gain | : (czas.) produce | : (czas.) reach | : (czas.) score
osiagi : osiągi : (rzecz.) performance
osiagniecie : osiągniecie : (rzecz.) achieving | : (rzecz.) development
osiagniecie : osiągnięcie : (rzecz.) accomplishment | : (rzecz.) achievement | : (rzecz.) attainment
osiagnac : osiągnąć : (czas.) achieve | : (czas.) acquire | : (czas.) attain
osiasc : osiąść : (czas.) jam | : (czas.) settle
osilek : osiłek : (rzecz.) bruiser
oskalpowac : oskalpować : (czas.) scalp
oskard : oskard : (rzecz.) mattock | : (rzecz.) pickaxe | : (rzecz.) pike
oskarzac : oskarżać : (czas.) accuse | : (czas.) arraign | : (czas.) asperse | : (czas.) blame | : (czas.) denounce | : (czas.) impeach | : (czas.) impute | : (czas.) indict
oskarzenie : oskarżenie : (rzecz.) accusation | : (rzecz.) arraignment | : (rzecz.) charge | : (rzecz.) denunciation | : (rzecz.) impeachment | : (rzecz.) imputation | : (rzecz.) indictment
oskarzony : oskarżony : (przym.) accused
oskarzyciel : oskarżyciel : (rzecz.) accuser | : (rzecz.) plaintiff | : (rzecz.) prosecutor
oskarzycielski : oskarżycielski : (przym.) accusatory | : (przym.) accusing
oskarzyc : oskarżyć : (czas.) accuse | : (czas.) impeach | : (czas.) sue
oskrobanie : oskrobanie : (rzecz.) gilled
oskrobac : oskrobać : (czas.) scrape
oskrobywac : oskrobywać : (czas.) scrape
oskrzele : oskrzele : (rzecz.) bronchus
oskrzelik : oskrzelik : (rzecz.) bronchiole
oskrzelowy : oskrzelowy : (przym.) bronchial
oskubac : oskubać : (czas.) deplume | : (czas.) pluck
oskubywanie : oskubywanie : (rzecz.) deplumation
osm : osm : (rzecz.) osmium
osmagac : osmagać : (czas.) lash
osmalac : osmalać : (czas.) singe
osmalic : osmalić : (czas.) burn
osmarowac : osmarować : (czas.) smear
osmolic : osmolić : (czas.) dirty
osmotyczny : osmotyczny : (przym.) osmotic
osmoza : osmoza : (rzecz.) osmosis
osnowa : osnowa : (rzecz.) contexture | : (rzecz.) framework | : (rzecz.) groundmass | : (rzecz.) warp
osnuc : osnuć : (czas.) envelop
osoba : osoba : (rzecz.) character | : (rzecz.) dropout | : (rzecz.) hedger | : (rzecz.) individual | : (rzecz.) person | : (rzecz.) persona | : (rzecz.) persons | : (rzecz.) stinger | : (rzecz.) stunner
osobistosc : osobistość : (rzecz.) celebrity | : (rzecz.) high-up | : (rzecz.) personage | : (rzecz.) personality
osobisty : osobisty : (przym.) individual | : (przym.) peculiar | : (przym.) personal
osobiscie : osobiście : (przysł.) peculiarly | : (przysł.) personally
osobliwie : osobliwie : (przysł.) oddly | : (przysł.) peculiarly | : (przysł.) quaintly
osobliwosc : osobliwość : (rzecz.) curio | : (rzecz.) curiosity | : (rzecz.) oddity | : (rzecz.) originality | : (rzecz.) particularity | : (rzecz.) peculiarity | : (rzecz.) quaintness | : (rzecz.) singularity | : (rzecz.) technicality
osobliwy : osobliwy : (przym.) curious | : (przym.) especial | : (przym.) individual | : (przym.) peculiar | : (przym.) quaint | : (przym.) singular
osobnik : osobnik : (rzecz.) individual | : (rzecz.) pallbearer | : (rzecz.) specimen
osobno : osobno : (przysł.) alone | : (przysł.) apart | : (przysł.) separately | : (przysł.) severally
osobny : osobny : (przym.) isolated | : (przym.) separate
osobowosc : osobowość : (rzecz.) character | : (rzecz.) feature | : (rzecz.) nature | : (rzecz.) personage | : (rzecz.) personality | : (rzecz.) self | : (rzecz.) singularity
osobowy : osobowy : (przym.) personal
osocze : osocze : (rzecz.) plasma | : (rzecz.) serum
osowialosc : osowiałość : (rzecz.) depression
ospa : ospa : (rzecz.) pox | : (rzecz.) smallpox | : (rzecz.) small-pox
ospale : ospale : (przysł.) drowsily | : (przysł.) sluggishly
ospalosc : ospałość : (rzecz.) indolence | : (rzecz.) languidness | : (rzecz.) lethargy | : (rzecz.) sloth
ospaly : ospały : (przym.) drowsy | : (przym.) laggard | : (przym.) remiss | : (przym.) sluggish
ospowaty : ospowaty : (przym.) pockmarked | : (przym.) pock-marked
osprzet : osprzęt : (rzecz.) accessories | : (rzecz.) accessory | : (rzecz.) equipment | : (rzecz.) fixture | : (rzecz.) hardware
ostaniec : ostaniec : (rzecz.) outlier
ostatecznie : ostatecznie : (przysł.) eventually | : (przysł.) finally | : (przysł.) ultimately
ostatecznosc : ostateczność : (rzecz.) exigency | : (rzecz.) extreme | : (rzecz.) extremity | : (rzecz.) finality
ostateczny : ostateczny : (przym.) conclusive | : (przym.) definite | : (przym.) definitive | : (przym.) determinate | : (przym.) eventual | : (przym.) extreme | : (przym.) final | : (przym.) last-ditch | : (przym.) outermost | : (przym.) outmost | : (przym.) peremptory | : (przym.) terminable | : (przym.) ultimate | : (przym.) utmost
ostatek : ostatek : (rzecz.) remainder | : (rzecz.) rest
ostatni : ostatni : (przym.) endmost | : (przym.) final | : (przym.) hindmost | : (przym.) last | : (przym.) last-ditch | : (przym.) last-minute | : (przym.) late | : (przym.) latter | : (przym.) rearmost | : (przym.) recent
ostatnio : ostatnio : (przysł.) last | : (przysł.) lately | : (przysł.) latterly | : (przysł.) newly | : (przysł.) recently
ostemplowanie : ostemplowanie : (rzecz.) stamp
ostemplowac : ostemplować : (czas.) postmark | : (czas.) stamp
ostentacja : ostentacja : (rzecz.) display | : (rzecz.) ostentation | : (rzecz.) panache
ostentacyjnie : ostentacyjnie : (przysł.) manifestly | : (przysł.) ostentatiously
ostentacyjny : ostentacyjny : (przym.) ostentatious
osteopatia : osteopatia : (rzecz.) osteopathy
osteoporoza : osteoporoza : (rzecz.) osteoporosis
ostoja : ostoja : (rzecz.) backbone | : (rzecz.) mainstay | : (rzecz.) refuge
ostra : ostra : (rzecz.) retort
ostracyzm : ostracyzm : (rzecz.) ostracism
ostro : ostro : (przysł.) keenly | : (przysł.) sharply
ostroga : ostroga : (rzecz.) carina | : (rzecz.) groin | : (rzecz.) spur
ostrokrzew : ostrokrzew : (rzecz.) holly
ostrokol : ostrokół : (rzecz.) palisade | : (rzecz.) stockade
ostromlecz : ostromlecz : (rzecz.) euphorbia | : (rzecz.) spurge
ostroslup : ostrosłup : (rzecz.) pyramid
ostrowlosy : ostrowłosy : (przym.) wirehaired | : (przym.) wire-haired
ostrosc : ostrość : (rzecz.) abruptness | : (rzecz.) acuity | : (rzecz.) acuteness | : (rzecz.) asperity | : (rzecz.) chilliness | : (rzecz.) focus | : (rzecz.) poignancy | : (rzecz.) severity | : (rzecz.) sharper | : (rzecz.) sharpness | : (rzecz.) spiciness | : (rzecz.) stridency | : (rzecz.) stringency
ostrozen : ostrożeń : (rzecz.) thistle
ostroznie : ostrożnie : (przysł.) carefully | : (przysł.) cautiously | : (przysł.) gingerly | : (przysł.) guardedly | : (przysł.) prudently | : (przysł.) warily
ostroznosc : ostrożność : (rzecz.) care | : (rzecz.) carefulness | : (rzecz.) caution | : (rzecz.) cautiousness | : (rzecz.) chariness | : (rzecz.) circumspection | : (rzecz.) foresight | : (rzecz.) precaution | : (rzecz.) providence | : (rzecz.) stimulant | : (rzecz.) wariness
ostrozny : ostrożny : (przym.) cagey | : (przym.) careful | : (przym.) cautious | : (przym.) chary | : (przym.) circumspect | : (przym.) considerate | : (przym.) farsighted | : (przym.) far-sighted | : (przym.) heedful | : (przym.) leery | : (przym.) mindful | : (przym.) prospective | : (przym.) prudent | : (przym.) reserved | : (przym.) safe | : (przym.) scrupulous | : (przym.) shy | : (przym.) wary
ostrugac : ostrugać : (czas.) pare
ostry : ostry : (przym.) acrid | : (przym.) acute | : (przym.) biting | : (przym.) hackly | : (przym.) hard | : (przym.) harsh | : (przym.) horny | : (przym.) hot | : (przym.) incisive | : (przym.) inclement | : (przym.) keen | : (przym.) keener | : (przym.) keenest | : (przym.) nippy | : (przym.) peppery | : (przym.) piercing | : (przym.) poignant | : (przym.) pointed | : (przym.) pungent | : (przym.) severe | : (przym.) sharp | : (przym.) short | : (przym.) shrewd | : (przym.) shrill | : (przym.) spicy | : (przym.) steep | : (przym.) strident | : (przym.) stringent | : (przym.) violent
ostryga : ostryga : (rzecz.) oyster
ostrygojad : ostrygojad : (rzecz.) oyster
ostryz : ostryż : (rzecz.) curcuma
ostrzarka : ostrzarka : (rzecz.) sharpener
ostrzal : ostrzał : (rzecz.) fire | : (rzecz.) fusillade | : (rzecz.) gunfire | : (rzecz.) shelling
ostrze : ostrze : (rzecz.) arrowhead | : (rzecz.) arrow-head | : (rzecz.) bit | : (rzecz.) blade | : (rzecz.) edge | : (rzecz.) knife-edge | : (rzecz.) nib | : (rzecz.) point | : (rzecz.) spear | : (rzecz.) spike | : (rzecz.) warning
ostrzegacz : ostrzegacz : (rzecz.) points
ostrzeganie : ostrzeganie : (rzecz.) warning
ostrzegawczo : ostrzegawczo : (przysł.) warningly
ostrzegawczy : ostrzegawczy : (przym.) cautionary | : (przym.) monitory
ostrzegac : ostrzegać : (czas.) admonish | : (czas.) alert | : (czas.) caution | : (czas.) warn
ostrzelac : ostrzelać : (czas.) strafeo
ostrzeliwanie : ostrzeliwanie : (rzecz.) shooting
ostrzeliwac : ostrzeliwać : (czas.) bombard | : (czas.) fire | : (czas.) rake | : (czas.) strafe
ostrzezenie : ostrzeżenie : (rzecz.) admonition | : (rzecz.) caution | : (rzecz.) monition | : (rzecz.) notice | : (rzecz.) premonition | : (rzecz.) warning
ostrzyc : ostrzyc : (rzecz.) clip | : (rzecz.) shear
ostrzyc : ostrzyć : (czas.) edge | : (czas.) hone | : (czas.) point | : (czas.) poll | : (czas.) sharpen | : (czas.) strop | : (czas.) whet | : (czas.) whittle
ostrzyzenie : ostrzyżenie : (rzecz.) clip | : (rzecz.) haircut
ostrog : ostróg : (rzecz.) donjon | : (rzecz.) groins
ostrow : ostrów : (rzecz.) islet
ostrozka : ostróżka : (rzecz.) delphinium | : (rzecz.) larkspur
ostudzac : ostudzać : (czas.) cool | : (czas.) quench
ostudzenie : ostudzenie : (rzecz.) cooling
ostudzic : ostudzić : (czas.) cool | : (czas.) quench
ostygac : ostygać : (czas.) cool
ostygniecie : ostygnięcie : (rzecz.) cool
osuszacz : osuszacz : (rzecz.) dehumidifier | : (rzecz.) desiccant | : (rzecz.) dryer
osuszanie : osuszanie : (rzecz.) dehumidification | : (rzecz.) desiccation | : (rzecz.) drainage
osuszac : osuszać : (czas.) dehumidify | : (czas.) drain | : (czas.) exsiccate
osuszenie : osuszenie : (rzecz.) desiccation
osuszyc : osuszyć : (czas.) dry
osuwanie : osuwanie : (rzecz.) landslides | : (rzecz.) subsidence
osuwac : osuwać : (czas.) slump | : (czas.) subside
osuwisko : osuwisko : (rzecz.) event | : (rzecz.) landslide | : (rzecz.) landslip
oswajalny : oswajalny : (przym.) tameable
oswajac : oswajać : (czas.) domesticate | : (czas.) tame
oswobodzenie : oswobodzenie : (rzecz.) deliverance | : (rzecz.) liberation | : (rzecz.) release
oswobodziciel : oswobodziciel : (rzecz.) liberator
oswobodzic : oswobodzić : (czas.) liberate
oswoic : oswoić : (czas.) domesticate | : (czas.) tame
oswojenie : oswojenie : (rzecz.) domestication | : (rzecz.) domesticity
oswojony : oswojony : (przym.) tame
osypac : osypać : (czas.) spill
osypisko : osypisko : (rzecz.) rubble | : (rzecz.) talus
oszachrowac : oszachrować : (czas.) cheat
oszacowanie : oszacowanie : (rzecz.) appraisal | : (rzecz.) appraisement | : (rzecz.) appreciation | : (rzecz.) assessment | : (rzecz.) conservative | : (rzecz.) estimate | : (rzecz.) estimation | : (rzecz.) evaluation | : (rzecz.) extent | : (rzecz.) rating | : (rzecz.) valuation
oszacowac : oszacować : (czas.) appraise | : (czas.) appreciate | : (czas.) assess | : (czas.) estimate | : (czas.) evaluate
oszacowywac : oszacowywać : (czas.) estimated
oszalaly : oszalały : (przym.) frantic
oszalec : oszaleć : (czas.) craze | : (czas.) infatuate | : (czas.) infuriate | : (czas.) infuriated
oszalowanie : oszalowanie : (rzecz.) crib | : (rzecz.) hoarding | : (rzecz.) timbering
oszalowac : oszalować : (czas.) board
oszalamianie : oszałamianie : (rzecz.) stagger
oszalamiac : oszałamiać : (czas.) bemuse | : (czas.) benumb | : (czas.) bewilder | : (czas.) daze | : (czas.) dazzle | : (czas.) dumbfound | : (czas.) fluster | : (czas.) intoxicate | : (czas.) maze | : (czas.) stun | : (czas.) stupefy
oszancowanie : oszańcowanie : (rzecz.) entrenchment | : (rzecz.) retrenchment
oszancowac : oszańcować : (czas.) entrench
oszczekac : oszczekać : (czas.) slander
oszczenic : oszczenić : (czas.) whelp
oszczep : oszczep : (rzecz.) dart | : (rzecz.) javelin | : (rzecz.) spear
oszczepnik : oszczepnik : (rzecz.) spearman
oszczerca : oszczerca : (rzecz.) backbiter | : (rzecz.) calumniator | : (rzecz.) defamer | : (rzecz.) detractor | : (rzecz.) libeller | : (rzecz.) scandalmonger | : (rzecz.) slanderer
oszczerczy : oszczerczy : (przym.) calumnious | : (przym.) defamatory | : (przym.) libellous | : (przym.) slanderous
oszczerstwo : oszczerstwo : (rzecz.) aspersion | : (rzecz.) calumny | : (rzecz.) libel | : (rzecz.) scandal | : (rzecz.) slander | : (rzecz.) slur
oszczednie : oszczędnie : (przysł.) economically | : (przysł.) frugally | : (przysł.) sparely | : (przysł.) sparingly
oszczednosci : oszczędności : (rzecz.) savings
oszczednosc : oszczędność : (rzecz.) chariness | : (rzecz.) economizer | : (rzecz.) economy | : (rzecz.) frugality | : (rzecz.) nearness | : (rzecz.) parsimony | : (rzecz.) providence | : (rzecz.) savings | : (rzecz.) thrift | : (rzecz.) thriftiness
oszczedny : oszczędny : (przym.) cost-effective | : (przym.) economic | : (przym.) economical | : (przym.) frugal | : (przym.) nimble | : (przym.) parsimonious | : (przym.) provident | : (przym.) saving | : (przym.) sparing | : (przym.) thrifty
oszczedzac : oszczędzać : (czas.) economize | : (czas.) save | : (czas.) skimp | : (czas.) spar | : (czas.) spare
oszczedzic : oszczędzić : (czas.) save | : (czas.) spar
oszkalowac : oszkalować : (czas.) calumniate
oszklenie : oszklenie : (rzecz.) glass
oszklic : oszklić : (czas.) glaze
oszolamiajacy : oszołamiający : (przym.) intoxicant
oszolamiac : oszołamiać : (czas.) stun
oszolom : oszołom : (rzecz.) fanatic
oszolomienie : oszołomienie : (rzecz.) alarm | : (rzecz.) bewilderment | : (rzecz.) intoxication | : (rzecz.) maze | : (rzecz.) stupefaction
oszolomiony : oszołomiony : (przym.) numb | : (przym.) tipsy
oszolomic : oszołomić : (czas.) benumb | : (czas.) bewilder | : (czas.) daze | : (czas.) dumbfound | : (czas.) intoxicate | : (czas.) maze | : (czas.) stun | : (czas.) stupefy
oszpecac : oszpecać : (czas.) disfigure
oszpecenie : oszpecenie : (rzecz.) disfigurement
oszpecic : oszpecić : (czas.) deform
oszronienie : oszronienie : (rzecz.) frosting
oszukanie : oszukanie : (rzecz.) beguilement
oszukac : oszukać : (czas.) befoul | : (czas.) betray | : (czas.) bilk | : (czas.) cheat | : (czas.) defraud | : (czas.) dupe | : (czas.) fool | : (czas.) hoodwink | : (czas.) jockey | : (czas.) mountebank | : (czas.) screw
oszukanczo : oszukańczo : (przysł.) fraudulently
oszukanczy : oszukańczy : (przym.) bogus | : (przym.) crooked | : (przym.) deceitful | : (przym.) deceptive | : (przym.) delusive | : (przym.) fraudulent | : (przym.) trumpery | : (przym.) underhand
oszukanstwo : oszukaństwo : (rzecz.) deceitfulness
oszukiwanie : oszukiwanie : (rzecz.) deceit
oszukiwac : oszukiwać : (czas.) adulterate | : (czas.) befoul | : (czas.) beguile | : (czas.) betray | : (czas.) bluff | : (czas.) cheat | : (czas.) deceive | : (czas.) defraud | : (czas.) dupe | : (czas.) fake | : (czas.) fool | : (czas.) gouge | : (czas.) impose | : (czas.) jockey | : (czas.) rook | : (czas.) swindle | : (czas.) trick
oszust : oszust : (rzecz.) beguiler | : (rzecz.) cheat | : (rzecz.) cheater | : (rzecz.) crook | : (rzecz.) deceiver | : (rzecz.) duper | : (rzecz.) faker | : (rzecz.) fiddler | : (rzecz.) fraud | : (rzecz.) humbug | : (rzecz.) impostor | : (rzecz.) juggler | : (rzecz.) racketeer | : (rzecz.) rook | : (rzecz.) shark | : (rzecz.) sharper | : (rzecz.) swindler | : (rzecz.) trickster
oszustwo : oszustwo : (rzecz.) bluff | : (rzecz.) cheat | : (rzecz.) deceit | : (rzecz.) deception | : (rzecz.) delusion | : (rzecz.) dishonesty | : (rzecz.) eyewash | : (rzecz.) fake | : (rzecz.) fraud | : (rzecz.) gammon | : (rzecz.) guile | : (rzecz.) hanky-panky | : (rzecz.) humbug | : (rzecz.) imposition | : (rzecz.) imposture | : (rzecz.) juggler | : (rzecz.) rig | : (rzecz.) swindle | : (rzecz.) take-in | : (rzecz.) trickery
oszwabic : oszwabić : (czas.) chisel
osaczac : osączać : (czas.) encircle
osad : osąd : (rzecz.) adjudication | : (rzecz.) censure | : (rzecz.) discretion | : (rzecz.) judgement | : (rzecz.) judgment
osadzac : osądzać : (czas.) adjudge | : (czas.) doom | : (czas.) forejudge | : (czas.) judge
osadzenie : osądzenie : (rzecz.) judgment
osadzic : osądzić : (czas.) adjudge | : (czas.) doom | : (czas.) judge
osek : osęk : (rzecz.) fish-gig
oseka : osęka : (rzecz.) boathook | : (rzecz.) boat-hook | : (rzecz.) gaff
oslabiacz : osłabiacz : (rzecz.) reducer
oslabianie : osłabianie : (rzecz.) enervation
oslabiac : osłabiać : (czas.) abate | : (czas.) allay | : (czas.) attenuate | : (czas.) cripple | : (czas.) debilitate | : (czas.) dilute | : (czas.) emasculate | : (czas.) enervate | : (czas.) enfeeble | : (czas.) eviscerate | : (czas.) extenuate | : (czas.) impair | : (czas.) relax | : (czas.) remit | : (czas.) sap | : (czas.) sicken | : (czas.) slake | : (czas.) subdue | : (czas.) unnerve | : (czas.) vitiate | : (czas.) weaken
oslabienie : osłabienie : (rzecz.) attenuation | : (rzecz.) enervation | : (rzecz.) impairment | : (rzecz.) labefaction | : (rzecz.) languor | : (rzecz.) qualm | : (rzecz.) relaxation | : (rzecz.) remission | : (rzecz.) weakness
oslabiony : osłabiony : (przym.) languid | : (przym.) notorious
oslabic : osłabić : (czas.) allay | : (czas.) cripple | : (czas.) debilitate | : (czas.) enervate | : (czas.) eviscerate | : (czas.) impair | : (czas.) relax | : (czas.) remit | : (czas.) sicken | : (czas.) unnerve | : (czas.) weaken
oslabniecie : osłabnięcie : (rzecz.) viability
oslabnac : osłabnąć : (czas.) abate | : (czas.) subside | : (czas.) unbend | : (czas.) weaken
osladzac : osładzać : (czas.) cheer | : (czas.) sugar
oslanianie : osłanianie : (rzecz.) screening
oslaniac : osłaniać : (czas.) becalm | : (czas.) debilitate | : (czas.) enshroud | : (czas.) guard | : (czas.) screen | : (czas.) sheathe | : (czas.) shield
osloda : osłoda : (rzecz.) comfort | : (rzecz.) solace
oslodzic : osłodzić : (czas.) gild | : (czas.) sugar
oslona : osłona : (rzecz.) apron | : (rzecz.) bonnet | : (rzecz.) cloak | : (rzecz.) cover | : (rzecz.) cowl | : (rzecz.) cowling | : (rzecz.) defence | : (rzecz.) fender | : (rzecz.) guard | : (rzecz.) housing | : (rzecz.) jacket | : (rzecz.) lee | : (rzecz.) mantle | : (rzecz.) muff | : (rzecz.) overcoat | : (rzecz.) protection | : (rzecz.) safety | : (rzecz.) screen | : (rzecz.) sheath | : (rzecz.) shelter | : (rzecz.) shield | : (rzecz.) shroud | : (rzecz.) tilt | : (rzecz.) visor | : (rzecz.) volute | : (rzecz.) wrapper
oslonic : osłonić : (czas.) becalm | : (czas.) shield
oslonka : osłonka : (rzecz.) aril | : (rzecz.) skin
oslonny : osłonny : (przym.) protective
oslonowy : osłonowy : (przym.) protective
osluchanie : osłuchanie : (rzecz.) auscultation | : (rzecz.) familiarization
osluchiwanie : osłuchiwanie : (rzecz.) auscultation
oslupienie : osłupienie : (rzecz.) amazement | : (rzecz.) bewilderment | : (rzecz.) stupefaction | : (rzecz.) stupor
oslupiec : osłupieć : (czas.) petrify
otaczanie : otaczanie : (rzecz.) encirclements
otaczac : otaczać : (czas.) beset | : (czas.) besiege | : (czas.) circle | : (czas.) encircle | : (czas.) enclose | : (czas.) encompass | : (czas.) enfold | : (czas.) entrench | : (czas.) environ | : (czas.) surround
otaksowac : otaksować : (czas.) assess | : (czas.) evaluate
otamowac : otamować : (czas.) dyke
otarcie : otarcie : (rzecz.) abrasion | : (rzecz.) attrition
otchlanny : otchłanny : (przym.) cavernous
otchlan : otchłań : (rzecz.) abyss | : (rzecz.) chasm | : (rzecz.) depth | : (rzecz.) gulf | : (rzecz.) limbo
otoczak : otoczak : (rzecz.) boulder | : (rzecz.) cobble | : (rzecz.) pebble
otoczenie : otoczenie : (rzecz.) ambience | : (rzecz.) encirclement | : (rzecz.) entourage | : (rzecz.) environment | : (rzecz.) milieu | : (rzecz.) neighbourhood | : (rzecz.) scene | : (rzecz.) selling | : (rzecz.) setting | : (rzecz.) surroundings | : (rzecz.) vicinity
otoczka : otoczka : (rzecz.) areola | : (rzecz.) envelope | : (rzecz.) hull
otoczony : otoczony : (przym.) rimmed
otoczyc : otoczyć : (czas.) beset | : (czas.) enclose | : (czas.) encrust | : (czas.) lap | : (czas.) surround
otok : otok : (rzecz.) rim
otologia : otologia : (rzecz.) otology
otrucie : otrucie : (rzecz.) poisoning
otruc : otruć : (czas.) poison
otrzepac : otrzepać : (czas.) flick
otrzewna : otrzewna : (rzecz.) peritoneum
otrzec : otrzeć : (czas.) abrade
otrzezwienie : otrzeźwienie : (rzecz.) disillusion
otrzezwic : otrzeźwić : (czas.) sober
otrzymanie : otrzymanie : (rzecz.) receipt
otrzymac : otrzymać : (czas.) get | : (czas.) got | : (czas.) obtain | : (czas.) receive | : (czas.) touch
otrzymywac : otrzymywać : (czas.) get | : (czas.) obtain | : (czas.) qualify | : (czas.) receive
otrabki : otrąbki : (rzecz.) pollard
otreby : otręby : (rzecz.) bran
otucha : otucha : (rzecz.) comfort | : (rzecz.) courage | : (rzecz.) reassurance | : (rzecz.) uplift
otulac : otulać : (czas.) enfold | : (czas.) envelop | : (czas.) fold | : (czas.) muffle | : (czas.) tuck
otulina : otulina : (rzecz.) cover | : (rzecz.) lag
otulic : otulić : (czas.) enfold | : (czas.) muffle
otumaniac : otumaniać : (czas.) dupe
otumanienie : otumanienie : (rzecz.) haze
otwarcie : otwarcie : (rzecz.) opening
otwartosc : otwartość : (rzecz.) amicability | : (rzecz.) candour | : (rzecz.) frankness | : (rzecz.) openness
otwarty : otwarty : (przym.) candid | : (przym.) ingenuous | : (przym.) open | : (przym.) open-end | : (przym.) open-ended | : (przym.) outgoing | : (przym.) outright | : (przym.) outspoken | : (przym.) overt | : (przym.) patent
otwarty-zamkniety : otwarty-zamknięty : (przym.) open-closed
otwieracz : otwieracz : (rzecz.) opener | : (rzecz.) tin-opener
otwierac : otwierać : (czas.) open | : (czas.) unlock
otworek : otworek : (rzecz.) aperture | : (rzecz.) eyelet | : (rzecz.) stoma
otwornica : otwornica : (rzecz.) foraminifer
otworzyc : otworzyć : (czas.) broach | : (czas.) open | : (czas.) unclasp | : (czas.) unfasten | : (czas.) unlatch | : (czas.) unlock
otwor : otwór : (rzecz.) aperture | : (rzecz.) bore | : (rzecz.) cavity | : (rzecz.) foramen | : (rzecz.) gap | : (rzecz.) gape | : (rzecz.) hole | : (rzecz.) inlet | : (rzecz.) opening | : (rzecz.) orifice | : (rzecz.) peephole | : (rzecz.) perforation | : (rzecz.) slot | : (rzecz.) socket | : (rzecz.) vent
otylosc : otyłość : (rzecz.) fatness | : (rzecz.) obesity | : (rzecz.) overweight | : (rzecz.) stoutness
otyly : otyły : (przym.) corpulent | : (przym.) obese
otepienie : otępienie : (rzecz.) senility | : (rzecz.) stupor
owacja : owacja : (rzecz.) applause | : (rzecz.) ovation
owacyjny : owacyjny : (przym.) enthusiastic
owad : owad : (rzecz.) insect
owadobojczy : owadobójczy : (przym.) insecticidal
owadoznawstwo : owadoznawstwo : (rzecz.) entomology
owadozerca : owadożerca : (rzecz.) insectivore
owadozerny : owadożerny : (przym.) insectivorous
owady : owady : (rzecz.) insects
owak : owak : (przysł.) otherwise
owal : owal : (rzecz.) oval
owalny : owalny : (przym.) oval
owca : owca : (rzecz.) ewe | : (rzecz.) sheep
owczarek : owczarek : (rzecz.) sheepdog | : (rzecz.) sheep-dog
owczarnia : owczarnia : (rzecz.) flock | : (rzecz.) fold | : (rzecz.) sheepfold | : (rzecz.) sheep-fold
owczarstwo : owczarstwo : (rzecz.) sheep-farming
owczarz : owczarz : (rzecz.) shepherd
owczy : owczy : (przym.) ovine | : (przym.) sheepish
owiac : owiać : (czas.) enwrap
owies : owies : (rzecz.) oat | : (rzecz.) oats
owiewek : owiewek : (rzecz.) fairing
owiewka : owiewka : (rzecz.) deflector | : (rzecz.) fairing
owijacz : owijacz : (rzecz.) puttee | : (rzecz.) wrapper
owijac : owijać : (czas.) entwine | : (czas.) envelop | : (czas.) enwrap | : (czas.) implicate | : (czas.) muffle | : (czas.) shroud | : (czas.) swaddle | : (czas.) swathe | : (czas.) twine | : (czas.) twist | : (czas.) wrap
owinac : owinąć : (czas.) muffle | : (czas.) wrap
owoc : owoc : (rzecz.) fruit | : (rzecz.) fruitage | : (rzecz.) rowan
owocnia : owocnia : (rzecz.) core
owocnie : owocnie : (przysł.) fruitfully
owocnik : owocnik : (rzecz.) fructification
owocny : owocny : (przym.) fruitful
owocobranie : owocobranie : (rzecz.) gathering
owocolistek : owocolistek : (rzecz.) carpel
owoconosny : owoconośny : (przym.) fructiferous
owocowanie : owocowanie : (rzecz.) fructification | : (rzecz.) fruitage | : (rzecz.) fruit-bearing
owocowac : owocować : (czas.) fructify | : (czas.) fruit | : (czas.) result
owocowy : owocowy : (przym.) fruity
owocujacy : owocujący : (przym.) fruitful
owodnia : owodnia : (rzecz.) amnion
owodniowy : owodniowy : (przym.) amniotic
owrzodzenie : owrzodzenie : (rzecz.) sore | : (rzecz.) ulcer | : (rzecz.) ulceration
owsianka : owsianka : (rzecz.) burgoo | : (rzecz.) oatmeal | : (rzecz.) porridge
owsiany : owsiany : (przym.) oaten
owsik : owsik : (rzecz.) pinworm | : (rzecz.) threadworm | : (rzecz.) thread-worm
owulacja : owulacja : (rzecz.) ovulation
owladnac : owładnąć : (czas.) pervade
owlosienie : owłosienie : (rzecz.) coat | : (rzecz.) hair
ozdabianie : ozdabianie : (rzecz.) garnish | : (rzecz.) trim
ozdabiac : ozdabiać : (czas.) adorn | : (czas.) decorate | : (czas.) embellish
ozdoba : ozdoba : (rzecz.) adornment | : (rzecz.) apparel | : (rzecz.) attire | : (rzecz.) bullion | : (rzecz.) decoration | : (rzecz.) dingbat | : (rzecz.) finery | : (rzecz.) garnish | : (rzecz.) ornament | : (rzecz.) ornamentation | : (rzecz.) tassel | : (rzecz.) trinket
ozdobic : ozdobić : (czas.) decorate
ozdobnie : ozdobnie : (przysł.) decoratively | : (przysł.) ornamentally
ozdobnik : ozdobnik : (rzecz.) embellishment | : (rzecz.) ornament
ozdobny : ozdobny : (przym.) dashing | : (przym.) decorative | : (przym.) fancy | : (przym.) florid | : (przym.) high-wrought | : (przym.) ornamental | : (przym.) ornate
ozdrowieniec : ozdrowieniec : (rzecz.) convalescent
ozdrowiec : ozdrowieć : (czas.) cure
ozdobka : ozdóbka : (rzecz.) bauble | : (rzecz.) gewgaw | : (rzecz.) knickknack | : (rzecz.) knick-knack | : (rzecz.) trinket
oziebiacz : oziębiacz : (rzecz.) cooler
oziebianie : oziębianie : (rzecz.) refrigeration
oziebiac : oziębiać : (czas.) chill | : (czas.) cool
oziebienie : oziębienie : (rzecz.) cooling | : (rzecz.) refrigeration
oziebic : oziębić : (czas.) chill
ozieble : ozięble : (przysł.) coldly
ozieblosc : oziębłość : (rzecz.) cold | : (rzecz.) coldness | : (rzecz.) frigidity | : (rzecz.) frigidness | : (rzecz.) frostiness
oziebly : oziębły : (przym.) frigid
oznaczanie : oznaczanie : (rzecz.) assay | : (rzecz.) determination | : (rzecz.) marking | : (rzecz.) notation
oznaczac : oznaczać : (czas.) amount | : (czas.) betoken | : (czas.) connote | : (czas.) denote | : (czas.) designate | : (czas.) import | : (czas.) indicate | : (czas.) mark | : (czas.) mean | : (czas.) purport | : (czas.) signify | : (czas.) spell | : (czas.) tally | : (czas.) tick
oznaczenie : oznaczenie : (rzecz.) assay | : (rzecz.) denotation | : (rzecz.) designation | : (rzecz.) designator | : (rzecz.) determination | : (rzecz.) indication | : (rzecz.) mark | : (rzecz.) sign
oznacznik : oznacznik : (rzecz.) designator | : (rzecz.) tag
oznaczony : oznaczony : (przym.) determinate | : (przym.) marked
oznaczyc : oznaczyć : (czas.) appoint | : (czas.) assay | : (czas.) indicate | : (czas.) mark | : (czas.) signify | : (czas.) tag
oznajmiac : oznajmiać : (czas.) announce | : (czas.) betoken | : (czas.) declare | : (czas.) intimate | : (czas.) notify | : (czas.) state
oznajmienie : oznajmienie : (rzecz.) announcement | : (rzecz.) annunciation | : (rzecz.) declaration
oznajmic : oznajmić : (czas.) announce | : (czas.) intimate
oznaka : oznaka : (rzecz.) badge | : (rzecz.) emblem | : (rzecz.) evidence | : (rzecz.) hallmark | : (rzecz.) hall-mark | : (rzecz.) indication | : (rzecz.) indicator | : (rzecz.) mark | : (rzecz.) portent | : (rzecz.) sign | : (rzecz.) stamp | : (rzecz.) token
oznakowanie : oznakowanie : (rzecz.) label | : (rzecz.) marking | : (rzecz.) signpost
oznakowac : oznakować : (czas.) mark
oznakowywac : oznakowywać : (czas.) label
ozon : ozon : (rzecz.) ozone
ozonosfera : ozonosfera : (rzecz.) ozonosphere
ozorek : ozorek : (rzecz.) tongue
ozor : ozór : (rzecz.) tongue
olowiany : ołowiany : (przym.) leaded | : (przym.) leaden | : (przym.) leady
olowiowanie : ołowiowanie : (rzecz.) lead | : (rzecz.) leading
olowiowany : ołowiowany : (przym.) lead-coated
olowiowy : ołowiowy : (przym.) leaded | : (przym.) saturnine
oltarz : ołtarz : (rzecz.) altar
oltarzyk : ołtarzyk : (rzecz.) ohm
olow : ołów : (rzecz.) lead | : (rzecz.) leash | : (rzecz.) plumb
olowek : ołówek : (rzecz.) pencil
os : oś : (rzecz.) axis | : (rzecz.) axle | : (rzecz.) pivot | : (rzecz.) staff
oscienny : ościenny : (przym.) conterminous | : (przym.) neighbouring
oscien : oścień : (rzecz.) goad | : (rzecz.) prod
oscieze : ościeże : (rzecz.) jamb
oscieznica : ościeżnica : (rzecz.) frame | : (rzecz.) jamb
oscisty : ościsty : (przym.) bony
oska : ośka : (rzecz.) axle
oslepiac : oślepiać : (czas.) bedazzle | : (czas.) blind | : (czas.) dazzle
oslepic : oślepić : (czas.) blind
oslepniecie : oślepnięcie : (rzecz.) blindness
osli : ośli : (przym.) asinine
osliniac : ośliniać : (czas.) salivate | : (czas.) slobber
oslinic : oślinić : (czas.) salivate | : (czas.) slobber
osmielac : ośmielać : (czas.) dare | : (czas.) embolden | : (czas.) encourage | : (czas.) nerve | : (czas.) presume
osmielic : ośmielić : (czas.) dare | : (czas.) presume
osmieszac : ośmieszać : (czas.) lampoon | : (czas.) ridicule | : (czas.) stultify
osmiobok : ośmiobok : (rzecz.) octagon
osmiokrotnie : ośmiokrotnie : (przysł.) eightfold
osmiokrotny : ośmiokrotny : (przym.) eightfold
osmiokat : ośmiokąt : (rzecz.) octagon | : (rzecz.) octahedron
osmiokatny : ośmiokątny : (przym.) octagonal
osmiornica : ośmiornica : (rzecz.) octopus
osmiowiersz : ośmiowiersz : (rzecz.) octave
osmioscian : ośmiościan : (rzecz.) octahedron
osmioscienny : ośmiościenny : (przym.) octahedral
osnik : ośnik : (rzecz.) drawknife | : (rzecz.) shave
osrodek : ośrodek : (rzecz.) centre | : (rzecz.) media | : (rzecz.) site
osrodkowy : ośrodkowy : (przym.) central
oswiadczac : oświadczać : (czas.) avow | : (czas.) declare | : (czas.) profess | : (czas.) pronounce | : (czas.) propose | : (czas.) state | : (czas.) vouch
oswiadczenie : oświadczenie : (rzecz.) affirmation | : (rzecz.) announcement | : (rzecz.) asseveration | : (rzecz.) axis | : (rzecz.) declaration | : (rzecz.) lodge | : (rzecz.) pleading | : (rzecz.) presentment | : (rzecz.) profession | : (rzecz.) protestation | : (rzecz.) statement | : (rzecz.) testimony
oswiadczyny : oświadczyny : (rzecz.) declaration | : (rzecz.) marriage | : (rzecz.) proposal
oswiadczyc : oświadczyć : (czas.) asseverate | : (czas.) declare | : (czas.) enunciate | : (czas.) propose | : (czas.) state
oswiata : oświata : (rzecz.) education
oswiatowy : oświatowy : (przym.) educational
oswiecac : oświecać : (czas.) enlighten | : (czas.) illuminate | : (czas.) illumine | : (czas.) irradiate | : (czas.) lighten
oswiecenie : oświecenie : (rzecz.) enlightenment | : (rzecz.) illumination
oswiecic : oświecić : (czas.) enlighten | : (czas.) lighten
oswietlacz : oświetlacz : (rzecz.) illuminator
oswietlac : oświetlać : (czas.) illuminate | : (czas.) light | : (czas.) lighten
oswietlenie : oświetlenie : (rzecz.) illumination | : (rzecz.) irradiation | : (rzecz.) lighting
oswietlic : oświetlić : (czas.) light
osc : ość : (rzecz.) bone | : (rzecz.) fishbone | : (rzecz.) fish-bone
ozrebic : oźrebić : (czas.) foal
ozaglowanie : ożaglowanie : (rzecz.) rig | : (rzecz.) sail
ozebrowanie : ożebrowanie : (rzecz.) ribbing
ozenek : ożenek : (rzecz.) match
ozenic : ożenić : (czas.) marry
ozyna : ożyna : (rzecz.) blackberry
ozywczy : ożywczy : (przym.) crisp | : (przym.) crispy | : (przym.) invigorating | : (przym.) resuscitative
ozywiac : ożywiać : (czas.) activate | : (czas.) animate | : (czas.) awaken | : (czas.) brighten | : (czas.) enliven | : (czas.) exhilarate | : (czas.) inspirit | : (czas.) invigorate | : (czas.) liven | : (czas.) perk | : (czas.) prompt | : (czas.) quicken | : (czas.) raise | : (czas.) reanimate | : (czas.) recall | : (czas.) rekindle | : (czas.) resuscitate | : (czas.) revitalize | : (czas.) revive | : (czas.) rouse | : (czas.) smarten | : (czas.) vitalize | : (czas.) waken
ozywienie : ożywienie : (rzecz.) activity | : (rzecz.) agitation | : (rzecz.) animation | : (rzecz.) boom | : (rzecz.) boost | : (rzecz.) briskness | : (rzecz.) effervescence | : (rzecz.) liveliness | : (rzecz.) recovery | : (rzecz.) revitalization | : (rzecz.) revival | : (rzecz.) revivification | : (rzecz.) vivacity
ozywiony : ożywiony : (przym.) animate | : (przym.) heated | : (przym.) spirited
ozywic : ożywić : (czas.) activate | : (czas.) boost | : (czas.) brighten | : (czas.) inspirit | : (czas.) liven | : (czas.) prompt | : (czas.) quicken | : (czas.) reanimate | : (czas.) revitalize | : (czas.) waken
ozyc : ożyć : (czas.) rally | : (czas.) resuscitate
ozog : ożóg : (rzecz.) brand
osemkowo-dwojkowy : ósemkowo-dwójkowy : (przym.) octal-to-binary
osemkowo-szesnastkowy : ósemkowo-szesnastkowy : (przym.) octal-to-hexadecimal
osemkowy : ósemkowy : (przym.) octal
osmy : ósmy : (przym.) eighth
owczesny : ówczesny : (przym.) contemporary | : (przym.) onetime
