t-bar : T-bar : (rzecz.) teownik
taoism : Taoism : (rzecz.) taoizm
taurus : Taurus : (rzecz.) byk
theodore : Theodore : (rzecz.) Teodor
theresa : Theresa : (rzecz.) Teresa
thursday : Thursday : (rzecz.) czwartek
tom : Tom : (rzecz.) Tomasz
tommy : Tommy : (rzecz.) Tomek
tony : Tony : (rzecz.) Antoni
tory : Tory : (rzecz.) torys
tuesday : Tuesday : (rzecz.) wtorek
t-shirt : t-shirt : (rzecz.) koszulka
t-square : t-square : (rzecz.) przykładnica | : (rzecz.) węgielnica
tab : tab : (rzecz.) etykieta | : (rzecz.) naszywka | : (rzecz.) patka | : (rzecz.) pętelka | : (rzecz.) tabulacja | : (rzecz.) tabulator | : (rzecz.) ucho | : (rzecz.) wieszak | : (rzecz.) zakładka
tabard : tabard : (rzecz.) płaszczyk
tabernacle : tabernacle : (rzecz.) przybytek | : (rzecz.) tabernakulum
tablature : tablature : (rzecz.) tabulatura
table : table : (rzecz.) stół | : (rzecz.) stolik | : (rzecz.) stołowy | : (rzecz.) tabela | : (rzecz.) tabelka | : (rzecz.) wykaz
table-cloth : table-cloth : (rzecz.) obrus
table-land : table-land : (rzecz.) płaskowyż | : (rzecz.) płaskowzgórze
tablecloth : tablecloth : (rzecz.) obrus | : (rzecz.) serweta
tableland : tableland : (rzecz.) płaskowyż | : (rzecz.) płaskowzgórze | : (rzecz.) płaszczyzna
tablet : tablet : (rzecz.) pastylka | : (rzecz.) rysownica | : (rzecz.) tabletka | : (rzecz.) tablica | : (rzecz.) tabliczka
tabletop : tabletop : (rzecz.) blat
tableware : tableware : (rzecz.) nakrycie
tabloid : tabloid : (rzecz.) brukowiec
taboo : taboo : (przym.) nietykalny | : (rzecz.) nakaz | : (rzecz.) tabu | : (rzecz.) zakaz
taboos : taboos : (rzecz.) tabu
tabor : tabor : (rzecz.) bębenek
tabs : tabs : (rzecz.) tabulator
tabular : tabular : (przym.) płytkowy | : (przym.) płytowy | : (przym.) tabelaryczny | : (przym.) tabliczkowy
tabulate : tabulate : (czas.) tablicować | : (czas.) tabulować
tabulation : tabulation : (rzecz.) tabela | : (rzecz.) tabulacja | : (rzecz.) tabulowanie
tabulations : tabulations : (rzecz.) tabulogram
tabulator : tabulator : (rzecz.) tabulator
tabulators : tabulators : (rzecz.) tabulator
tachometer : tachometer : (rzecz.) obrotomierz | : (rzecz.) prędkościomierz | : (rzecz.) tachometr
tachycardia : tachycardia : (rzecz.) częstoskurcz | : (rzecz.) tachykardia
tachymeter : tachymeter : (rzecz.) tachymetr
tacit : tacit : (przym.) cichy | : (przym.) milczący | : (przym.) niemy
tacitly : tacitly : (przysł.) milcząco
taciturn : taciturn : (przym.) małomówny | : (przym.) milkliwy | : (przym.) mrukliwy
taciturnity : taciturnity : (rzecz.) małomówność
tack : tack : (czas.) fastrygować | : (czas.) halsować | : (czas.) lawirować | : (czas.) przybić | : (czas.) przybijać | : (czas.) przymocować | : (czas.) przypinać | : (czas.) sfastrygować | : (rzecz.) ćwiek | : (rzecz.) fastryga | : (rzecz.) hals | : (rzecz.) kierunek | : (rzecz.) pinezka | : (rzecz.) pluskiewka | : (rzecz.) sztyft
tackle : tackle : (czas.) obchodzić | : (czas.) przymocować | : (czas.) przystępować | : (czas.) uporać | : (czas.) wziąć | : (czas.) zabierać | : (czas.) zabrać | : (czas.) zająć | : (czas.) zmagać | : (rzecz.) przybory | : (rzecz.) sprzęt | : (rzecz.) takielunek
tackling : tackling : (rzecz.) sprzęt | : (rzecz.) takielunek | : (rzecz.) uporanie | : (rzecz.) uprząż
tacky : tacky : (przym.) kleisty | : (przym.) lepki | : (przym.) tandetny
tact : tact : (rzecz.) delikatność | : (rzecz.) takt | : (rzecz.) taktowność
tactful : tactful : (przym.) taktowny
tactfully : tactfully : (przysł.) taktownie
tactic : tactic : (przym.) taktyczny | : (rzecz.) taktyka
tactical : tactical : (przym.) taktyczny
tactically : tactically : (przysł.) taktycznie
tactician : tactician : (rzecz.) taktyk | : (rzecz.) taktyka
tactics : tactics : (rzecz.) taktyk | : (rzecz.) taktyka
tactile : tactile : (przym.) dotykowy | : (przym.) namacalny
tactless : tactless : (przym.) niedelikatny | : (przym.) nietaktowny
tactlessly : tactlessly : (przysł.) nietaktownie
tactlessness : tactlessness : (rzecz.) niedelikatność | : (rzecz.) nietakt
tactual : tactual : (przym.) dotykowy | : (przym.) namacalny
tad : tad : (rzecz.) berbeć
tadpole : tadpole : (rzecz.) kijanka | : (rzecz.) kijek
taffeta : taffeta : (rzecz.) tafta
tag : tag : (czas.) etykietować | : (czas.) łączyć | : (czas.) oznaczyć | : (czas.) przymocować | : (czas.) przywiązać | : (czas.) złączyć | : (czas.) związać | : (rzecz.) banał | : (rzecz.) cecha | : (rzecz.) druty | : (rzecz.) etykieta | : (rzecz.) etykietka | : (rzecz.) frazes | : (rzecz.) metka | : (rzecz.) nalepka | : (rzecz.) oznacznik | : (rzecz.) pętelka | : (rzecz.) powiedzonko | : (rzecz.) przyczepka | : (rzecz.) przywieszka | : (rzecz.) refren | : (rzecz.) skuwka | : (rzecz.) uchwyt | : (rzecz.) znacznik
tagged : tagged : (przym.) zaznaczony
tags : tags : (rzecz.) cech | : (rzecz.) metek
taiga : taiga : (rzecz.) tajga
tail : tail : (rzecz.) koniec | : (rzecz.) ogon | : (rzecz.) ogonek | : (rzecz.) poła | : (rzecz.) stopka | : (rzecz.) usterzenie | : (rzecz.) warkocz
tail-coat : tail-coat : (rzecz.) frak | : (rzecz.) żakiet
tail-spin : tail-spin : (rzecz.) korkociąg
tailcoat : tailcoat : (rzecz.) frak | : (rzecz.) żakiet
tailgate : tailgate : (rzecz.) klapa
tailings : tailings : (rzecz.) odpadki | : (rzecz.) poślad
tailless : tailless : (przym.) bezogonowy
tailor : tailor : (rzecz.) krawiec
tailoring : tailoring : (rzecz.) krawiectwo | : (rzecz.) szycie
tails : tails : (rzecz.) odpadki | : (rzecz.) pogoń | : (rzecz.) reszka | : (rzecz.) szlam
tailspin : tailspin : (rzecz.) korkociąg
taint : taint : (czas.) plamić | : (czas.) poplamić | : (czas.) psuć | : (czas.) splugawić | : (czas.) zarażać | : (czas.) zepsuć | : (rzecz.) plama | : (rzecz.) skaza | : (rzecz.) zepsucie
take : take : (czas.) brać | : (czas.) kupić | : (czas.) nabierać | : (czas.) odnosić | : (czas.) podejmować | : (czas.) podjąć | : (czas.) ponosić | : (czas.) przyjmować | : (czas.) przypatrzeć | : (czas.) robić | : (czas.) sadowić | : (czas.) ujmować | : (czas.) wymagać | : (czas.) wziąć | : (czas.) zabierać | : (czas.) zabrać | : (czas.) zajmować | : (czas.) zażyć | : (czas.) zażywać | : (czas.) znosić | : (czas.) zrobić
take-in : take-in : (rzecz.) naciąganie | : (rzecz.) okpienie | : (rzecz.) oszustwo | : (rzecz.) wydrwigrosz
take-off : take-off : (rzecz.) karykatura | : (rzecz.) naśladownictwo | : (rzecz.) odlot | : (rzecz.) parodia | : (rzecz.) skocznia | : (rzecz.) starcie | : (rzecz.) start | : (rzecz.) zdjęcie
take-up : take-up : (rzecz.) popyt | : (rzecz.) zainteresowanie
taken : taken : (czas.) podejmować | : (czas.) podjąć | : (czas.) potraktować | : (czas.) powziąć | : (czas.) przedsięwziąć | : (czas.) wziąć
takeoff : takeoff : (czas.) startować | : (rzecz.) karykatura | : (rzecz.) naśladownictwo | : (rzecz.) odlot | : (rzecz.) parodia | : (rzecz.) uruchomienie | : (rzecz.) zdjęcie
takeover : takeover : (rzecz.) przejmowanie
taking : taking : (rzecz.) dochód | : (rzecz.) pobieranie | : (rzecz.) poprowadzenie | : (rzecz.) utarg | : (rzecz.) wpływ | : (rzecz.) zabranie | : (rzecz.) zawiezienie
takings : takings : (rzecz.) utarg
talc : talc : (rzecz.) talk
tale : tale : (rzecz.) bajka | : (rzecz.) opowiadanie | : (rzecz.) opowiastka | : (rzecz.) opowieść | : (rzecz.) powiastka | : (rzecz.) przypowieść | : (rzecz.) talk
talent : talent : (rzecz.) talent | : (rzecz.) uzdolnienie
talented : talented : (przym.) utalentowany | : (przym.) zdolny
talisman : talisman : (rzecz.) talizman
talk : talk : (czas.) gadać | : (czas.) komunikować | : (czas.) mówić | : (czas.) rozmawiać | : (rzecz.) gadanie | : (rzecz.) pogadanka | : (rzecz.) pogłoska | : (rzecz.) rozmowa | : (rzecz.) wykład
talkative : talkative : (przym.) gadatliwy | : (przym.) rozmowny | : (przym.) wielomówny
talkatively : talkatively : (przysł.) rozmownie
talkativeness : talkativeness : (rzecz.) gadatliwość | : (rzecz.) gadulstwo | : (rzecz.) rozmowność
talker : talker : (rzecz.) gaduła | : (rzecz.) mówca
talkfest : talkfest : (rzecz.) gadanina
talking-to : talking-to : (rzecz.) bura | : (rzecz.) zbesztanie
talky : talky : (przym.) gadatliwy
tall : tall : (przym.) rosły | : (przym.) strzelisty | : (przym.) wysoki
tallboy : tallboy : (rzecz.) komoda | : (rzecz.) strażak
tallow : tallow : (czas.) nałoić | : (czas.) wyłoić | : (rzecz.) łój | : (rzecz.) maź | : (rzecz.) tłuszcz
tally : tally : (czas.) liczyć | : (czas.) obliczać | : (czas.) oznaczać | : (czas.) wyliczać | : (czas.) zgadzać | : (rzecz.) etykietka | : (rzecz.) rejestr
tallyman : tallyman : (rzecz.) liczman | : (rzecz.) rachmistrz | : (rzecz.) znaczkarz
talon : talon : (rzecz.) pazur | : (rzecz.) szpon | : (rzecz.) szpona
talus : talus : (rzecz.) osypisko | : (rzecz.) piarg
tam : tam : (rzecz.) wikariat
tama : tama : (przym.) taśmowy
tamarind : tamarind : (rzecz.) tamaryndowiec
tamarisk : tamarisk : (rzecz.) tamaryszek
tambour : tambour : (rzecz.) kolcobrzuch | : (rzecz.) tamborek
tambourine : tambourine : (rzecz.) tamburyn | : (rzecz.) tamburyno
tame : tame : (czas.) obłaskawiać | : (czas.) oswajać | : (czas.) oswoić | : (czas.) poskramiać | : (czas.) poskromić | : (czas.) ugłaskać | : (przym.) łagodny | : (przym.) oswojony | : (przym.) swojski | : (przym.) uległy
tameable : tameable : (przym.) oswajalny
tamely : tamely : (przysł.) potulnie
tameness : tameness : (rzecz.) uległość
tamer : tamer : (rzecz.) pogromca | : (rzecz.) poskramiacz | : (rzecz.) poskromiciel | : (rzecz.) treser
tamp : tamp : (czas.) ubić | : (czas.) ubijać | : (czas.) utykać
tamper : tamper : (czas.) babrać | : (czas.) manipulować | : (czas.) ruszać | : (czas.) sfałszować | : (czas.) wtrącać
tampon : tampon : (rzecz.) podkładka | : (rzecz.) tampon
tampons : tampons : (rzecz.) tamponowanie
tan : tan : (czas.) garbować | : (czas.) opalać | : (rzecz.) garbowanie | : (rzecz.) opalenizna
tandem : tandem : (rzecz.) tandem
tang : tang : (rzecz.) brzdęk | : (rzecz.) chwyt | : (rzecz.) posmak | : (rzecz.) trzpień
tangency : tangency : (rzecz.) styczność
tangent : tangent : (rzecz.) styczna | : (rzecz.) tangens
tangential : tangential : (przym.) styczny | : (przym.) tangensowy
tangentially : tangentially : (przysł.) stycznie
tangerine : tangerine : (rzecz.) mandaryn | : (rzecz.) mandarynka
tangibility : tangibility : (rzecz.) dotykalność | : (rzecz.) namacalność
tangible : tangible : (przym.) dotykalny | : (przym.) faktyczny | : (przym.) namacalny | : (przym.) rzeczywisty | : (przym.) uchwytny
tangibly : tangibly : (przysł.) namacalnie
tangle : tangle : (czas.) gmatwać | : (czas.) kołtunić | : (czas.) motać | : (czas.) plątać | : (czas.) poplątać | : (czas.) powikłać | : (czas.) splątać | : (czas.) wikłać | : (czas.) wplątać | : (czas.) zagmatwać | : (czas.) zaplątać | : (czas.) zawikłać | : (rzecz.) gmatwanina | : (rzecz.) krętanina | : (rzecz.) plątanina | : (rzecz.) pokrzyżowanie | : (rzecz.) splot | : (rzecz.) supeł | : (rzecz.) zagmatwanie
tango : tango : (rzecz.) tango
tangy : tangy : (przym.) aromatyczny | : (przym.) cierpki
tank : tank : (rzecz.) bak | : (rzecz.) basen | : (rzecz.) cysterna | : (rzecz.) czołg | : (rzecz.) zbiornik
tankard : tankard : (rzecz.) kufel
tanker : tanker : (rzecz.) cysterna | : (rzecz.) tankowiec | : (rzecz.) zbiornikowiec
tanner : tanner : (rzecz.) garbarz | : (rzecz.) garbowanie | : (rzecz.) skórnik | : (rzecz.) sześciopensówka
tannery : tannery : (rzecz.) garbarnia
tannin : tannin : (rzecz.) garbnik | : (rzecz.) tanina
tantalite : tantalite : (rzecz.) kolumbit | : (rzecz.) tantalit
tantalize : tantalize : (czas.) drażnić | : (czas.) dręczyć | : (czas.) kusić | : (czas.) zwodzić
tantalum : tantalum : (rzecz.) tantal
tantamount : tantamount : (przym.) równowartościowy | : (przym.) równoznaczny | : (przym.) równy
tantrum : tantrum : (rzecz.) furia | : (rzecz.) histeria
tap : tap : (czas.) czerpać | : (czas.) klepać | : (czas.) odszpuntować | : (czas.) opukać | : (czas.) pukać | : (czas.) stukać | : (rzecz.) gwintownik | : (rzecz.) kran | : (rzecz.) kurek | : (rzecz.) podsłuch | : (rzecz.) zawór
tap-dance : tap-dance : (rzecz.) stepowanie
tap-dancing : tap-dancing : (rzecz.) stepowanie
tape : tape : (czas.) nagrywać | : (rzecz.) kaseta | : (rzecz.) magnetofon | : (rzecz.) sznurek | : (rzecz.) tasiemka | : (rzecz.) taśma | : (rzecz.) wstążka
tape-measure : tape-measure : (rzecz.) centymetr
tape-recorder : tape-recorder : (rzecz.) magnetofon
tape-recording : tape-recording : (rzecz.) nagranie | : (rzecz.) nagrywanie
taper : taper : (czas.) stożkować | : (czas.) zastrugać | : (rzecz.) kończenie | : (rzecz.) koniec | : (rzecz.) skos | : (rzecz.) stożek | : (rzecz.) stożkowatość | : (rzecz.) świeca | : (rzecz.) zbieganie | : (rzecz.) zbieżność | : (rzecz.) zmniejszanie | : (rzecz.) zwężanie
tapestry : tapestry : (rzecz.) gobelin | : (rzecz.) makata | : (rzecz.) obicie | : (rzecz.) tapeta | : (rzecz.) tkanina
tapeworm : tapeworm : (rzecz.) soliter | : (rzecz.) tasiemiec
tapioca : tapioca : (rzecz.) tapioka
tapir : tapir : (rzecz.) tapir
tappet : tappet : (rzecz.) popychacz
taproom : taproom : (rzecz.) szynk
tar : tar : (czas.) nasmołować | : (czas.) smołować | : (rzecz.) dziegieć | : (rzecz.) lepik | : (rzecz.) smoła | : (rzecz.) smołowanie | : (rzecz.) smołowiec
tarantella : tarantella : (rzecz.) tarantela
tarantula : tarantula : (rzecz.) tarantula
tardily : tardily : (przysł.) powoli
tardiness : tardiness : (rzecz.) opieszałość | : (rzecz.) powolność
tardy : tardy : (przym.) nierychliwy | : (przym.) ociężały | : (przym.) powolny
tare : tare : (rzecz.) tara
target : target : (rzecz.) cel | : (rzecz.) kierowanie | : (rzecz.) obiekt | : (rzecz.) tarcza
targeting : targeting : (czas.) celować | : (czas.) mierzyć | : (rzecz.) cel | : (rzecz.) celowanie | : (rzecz.) tarcza
tariff : tariff : (rzecz.) cło | : (rzecz.) taryfa | : (rzecz.) taryfikator | : (rzecz.) taryfowanie
tarlatan : tarlatan : (rzecz.) tarlatan
tarmac : tarmac : (rzecz.) asfalt
tarn : tarn : (rzecz.) tarń
tarnish : tarnish : (czas.) matowieć | : (czas.) plamić | : (czas.) przyćmić | : (czas.) ściemnić | : (czas.) ściemnieć | : (czas.) śniedzieć | : (czas.) zmaterializować | : (czas.) zmatowieć | : (rzecz.) bombardowanie | : (rzecz.) śniedź | : (rzecz.) zmatowienie
tarp : tarp : (rzecz.) brezent
tarpaulin : tarpaulin : (rzecz.) brezent | : (rzecz.) plandeka | : (rzecz.) tkanina
tarragon : tarragon : (rzecz.) estragon
tarry : tarry : (czas.) ociągać | : (czas.) pozostać | : (czas.) pozostawać | : (czas.) zwlekać
tarsal : tarsal : (przym.) stepowy
tarsus : tarsus : (rzecz.) stęp | : (rzecz.) tarczka
tart : tart : (przym.) cierpki | : (przym.) uszczypliwy | : (przym.) zgorzkniały | : (rzecz.) ciastko | : (rzecz.) kokota | : (rzecz.) lafirynda | : (rzecz.) tort
tartan : tartan : (rzecz.) tartan
tartar : tartar : (rzecz.) winnik
tartaric : tartaric : (przym.) winowy
tartness : tartness : (rzecz.) cierpkość | : (rzecz.) kwaśność | : (rzecz.) zgryźliwość
task : task : (rzecz.) praca | : (rzecz.) robótka | : (rzecz.) sprawa | : (rzecz.) zadanie | : (rzecz.) zajęcie
taskmaster : taskmaster : (rzecz.) ciemięzca | : (rzecz.) ciemiężca | : (rzecz.) gnębiciel | : (rzecz.) tyran
tassel : tassel : (rzecz.) frędzel | : (rzecz.) kitka | : (rzecz.) ozdoba | : (rzecz.) pompon
taste : taste : (czas.) degustować | : (czas.) kosztować | : (czas.) pokosztować | : (czas.) popróbować | : (czas.) posmakować | : (czas.) próbować | : (czas.) skosztować | : (czas.) smakować | : (czas.) spróbować | : (czas.) zakosztować | : (czas.) zaznać | : (rzecz.) gust | : (rzecz.) smak | : (rzecz.) sympatia | : (rzecz.) zamiłowanie
tasteful : tasteful : (przym.) gustowny
tastefully : tastefully : (przysł.) gustownie | : (przysł.) smakowicie
tasteless : tasteless : (przym.) bezsmakowy | : (przym.) niegustowny | : (przym.) nieprzyjemny | : (przym.) niesmaczny
tastelessly : tastelessly : (przysł.) niegustownie
taster : taster : (rzecz.) degustator
tasting : tasting : (rzecz.) degustacja | : (rzecz.) próbowanie | : (rzecz.) smakowanie
tasty : tasty : (przym.) apetyczny | : (przym.) smaczny
tater : tater : (rzecz.) ziemniak
tatter : tatter : (rzecz.) gaduła | : (rzecz.) łachman | : (rzecz.) szmata
tatterdemalion : tatterdemalion : (rzecz.) golectat | : (rzecz.) obdartus | : (rzecz.) oberwaniec | : (rzecz.) obszarpaniec
tattered : tattered : (przym.) obdarty | : (przym.) obszarpany
tattle : tattle : (czas.) gawędzić | : (czas.) plotkować | : (rzecz.) gadanina
tattler : tattler : (rzecz.) gaduła | : (rzecz.) plotkarz | : (rzecz.) skarżypyta
tattletale : tattletale : (rzecz.) skarżypyta
tattoo : tattoo : (czas.) tatuować | : (czas.) wykluć | : (czas.) wykłuć | : (czas.) wytatuować | : (rzecz.) capstrzyk | : (rzecz.) tatuaż
taught : taught : (czas.) uczyć | : (czas.) wpoić
taunt : taunt : (czas.) docinać | : (czas.) dokuczać | : (czas.) wyśmiewać | : (rzecz.) drwina | : (rzecz.) przycinek | : (rzecz.) wyśmiewanie | : (rzecz.) zaczepka
taut : taut : (przym.) napięty | : (przym.) naprężony
tauten : tauten : (czas.) napinać
tautness : tautness : (rzecz.) napięcie
tautological : tautological : (przym.) tautologiczny
tautologically : tautologically : (przysł.) tautologicznie
tautology : tautology : (rzecz.) tautologia
tavern : tavern : (rzecz.) karczma | : (rzecz.) knajpa | : (rzecz.) oberża | : (rzecz.) tawerna | : (rzecz.) wyszynk
tawdriness : tawdriness : (rzecz.) niegustowność
tawdry : tawdry : (przym.) krzykliwy
tawny : tawny : (przym.) brązowy | : (przym.) płowy | : (przym.) śniady | : (przym.) żółtobrązowy
taws : taws : (rzecz.) pasek
tax : tax : (czas.) opodatkować | : (czas.) opodatkowywać | : (czas.) szacować | : (rzecz.) celnik | : (rzecz.) ciężar | : (rzecz.) cło | : (rzecz.) fiskus | : (rzecz.) opodatkowanie | : (rzecz.) podatek | : (rzecz.) taksa
tax-collector : tax-collector : (rzecz.) poborca
tax-free : tax-free : (przym.) bezcłowy
tax-payer : tax-payer : (rzecz.) podatnik
taxation : taxation : (rzecz.) opodatkowanie
taxi : taxi : (czas.) kołować | : (rzecz.) dorożka | : (rzecz.) kołowanie | : (rzecz.) taksówka
taxi-cab : taxi-cab : (rzecz.) taksówka
taxi-driver : taxi-driver : (rzecz.) taksówkarz
taxicab : taxicab : (rzecz.) taksówka
taxidermist : taxidermist : (rzecz.) wypychacz
taxidermy : taxidermy : (rzecz.) wypychanie
taximeter : taximeter : (rzecz.) taksometr
taxing : taxing : (rzecz.) opodatkowywanie
taxis : taxis : (rzecz.) taksja
taxman : taxman : (rzecz.) taksówkarz
taxonomic : taxonomic : (przym.) taksonomiczny
taxonomy : taxonomy : (rzecz.) systematyka | : (rzecz.) taksonomia
taxpayer : taxpayer : (rzecz.) podatnik
tea : tea : (rzecz.) herbaciarnia | : (rzecz.) herbata | : (rzecz.) herbatka | : (rzecz.) podwieczorek
tea-cake : tea-cake : (rzecz.) keks
tea-cup : tea-cup : (rzecz.) filiżanka
tea-house : tea-house : (rzecz.) herbaciarnia
tea-pot : tea-pot : (rzecz.) imbryk
tea-room : tea-room : (rzecz.) herbaciarnia | : (rzecz.) kawiarnia
tea-shop : tea-shop : (rzecz.) herbaciarnia
teacake : teacake : (rzecz.) keks
teach : teach : (czas.) nauczać | : (czas.) uczyć
teachable : teachable : (przym.) pojętny
teacher : teacher : (rzecz.) bakałarz | : (rzecz.) belfer | : (rzecz.) docent | : (rzecz.) nauczyciel | : (rzecz.) wychowawca
teacher's : teacher's : (przym.) nauczycielski
teachers : teachers : (rzecz.) nauczycielstwo
teaching : teaching : (rzecz.) dydaktyka | : (rzecz.) habilitacja | : (rzecz.) nauczanie | : (rzecz.) nauczycielstwo | : (rzecz.) nauka
teacup : teacup : (rzecz.) filiżanka | : (rzecz.) kubek
teahouse : teahouse : (rzecz.) herbaciarnia
teak : teak : (rzecz.) tik
teakettle : teakettle : (rzecz.) czajnik | : (rzecz.) imbryk | : (rzecz.) sagan
teal : teal : (rzecz.) cyranka
team : team : (czas.) zaprzęgać | : (czas.) zespalać | : (rzecz.) brygada | : (rzecz.) drużyna | : (rzecz.) ekipa | : (rzecz.) grono | : (rzecz.) reprezentacja | : (rzecz.) sztab | : (rzecz.) zaprzęg | : (rzecz.) zespół
team-work : team-work : (rzecz.) zgranie
teamwork : teamwork : (rzecz.) współpraca
teapot : teapot : (rzecz.) dzbanek | : (rzecz.) imbryk | : (rzecz.) kałamarz | : (rzecz.) kociołek
tear : tear : (czas.) drzeć | : (czas.) nadedrzeć | : (czas.) obrywać | : (czas.) oderwać | : (czas.) podrzeć | : (czas.) przedzierać | : (czas.) rozedrzeć | : (czas.) rozerwać | : (czas.) rwać | : (czas.) szarpać | : (czas.) ukręcić | : (rzecz.) łza | : (rzecz.) łzawienie | : (rzecz.) podarcie | : (rzecz.) rozdarcie | : (rzecz.) rozerwanie
tearaway : tearaway : (przym.) gwałtowny
teardrop : teardrop : (rzecz.) łza
tearful : tearful : (przym.) płaczliwy | : (przym.) smutny
tearoom : tearoom : (rzecz.) herbaciarnia | : (rzecz.) kawiarnia
teary : teary : (przym.) łzawy
tease : tease : (czas.) docinać | : (czas.) dokuczać | : (czas.) drażnić | : (czas.) droczyć | : (rzecz.) kpiarz | : (rzecz.) złośliwiec
teaser : teaser : (rzecz.) kpiarz | : (rzecz.) topiarz | : (rzecz.) zagadka
teasing : teasing : (rzecz.) dokuczanie
teaspoon : teaspoon : (rzecz.) łyżeczka | : (rzecz.) łyżka
teaspoonful : teaspoonful : (rzecz.) treść | : (rzecz.) zawartość
teat : teat : (rzecz.) cycek | : (rzecz.) dójka | : (rzecz.) smoczek | : (rzecz.) sutek | : (rzecz.) sutka
tech : tech : (rzecz.) technikum
technetium : technetium : (rzecz.) technet
technical : technical : (przym.) techniczny
technicality : technicality : (rzecz.) osobliwość | : (rzecz.) szczegół
technically : technically : (przysł.) technicznie
technician : technician : (rzecz.) technik | : (rzecz.) technika
technique : technique : (rzecz.) metoda | : (rzecz.) sprawność | : (rzecz.) technika | : (rzecz.) technologia | : (rzecz.) umiejętność
techno : techno : (rzecz.) techno
techno-economic : techno-economic : (przym.) techniczno-ekonomiczny
technocracy : technocracy : (rzecz.) technokracja
technocrat : technocrat : (rzecz.) technokrata
technological : technological : (przym.) techniczny | : (przym.) technologiczny
technologically : technologically : (przysł.) technologicznie
technologist : technologist : (rzecz.) technolog
technology : technology : (rzecz.) technika | : (rzecz.) technologia
tectonic : tectonic : (przym.) górotwórczy | : (przym.) tektoniczny
tectonics : tectonics : (rzecz.) architektonika | : (rzecz.) tektonika
teddy : teddy : (rzecz.) miś
tedious : tedious : (przym.) męczący | : (przym.) mętny | : (przym.) nudny
tediously : tediously : (przysł.) nudno | : (przysł.) nużąco
tediousness : tediousness : (rzecz.) banalność | : (rzecz.) nuda
tedium : tedium : (rzecz.) nuda | : (rzecz.) nudność | : (rzecz.) wstręt
tee : tee : (rzecz.) cel | : (rzecz.) podstawka | : (rzecz.) tarcza | : (rzecz.) teownik | : (rzecz.) znak
teem : teem : (czas.) obfitować | : (czas.) roić
teen : teen : (rzecz.) nastolatek
teen-ager : teen-ager : (rzecz.) podlotek | : (rzecz.) wyrostek
teenage : teenage : (przym.) młodzieżowy | : (przym.) nastoletni
teenager : teenager : (rzecz.) małolat | : (rzecz.) nastolatek | : (rzecz.) podfruwajka | : (rzecz.) podlotek | : (rzecz.) wyrostek
teensy : teensy : (przym.) nieduży
teeter : teeter : (czas.) chwiać | : (czas.) zataczać | : (rzecz.) huśtawka
teeth : teeth : (rzecz.) uzębienie | : (rzecz.) zęby
teethe : teethe : (czas.) ząbkować
teething : teething : (rzecz.) ząbkowanie
teetotal : teetotal : (przym.) antyalkoholowy
teetotalism : teetotalism : (rzecz.) abstynencja
teetotaller : teetotaller : (rzecz.) abstynent
tegument : tegument : (rzecz.) pokrywa
telecast : telecast : (rzecz.) teletransmisja
telecommunication : telecommunication : (rzecz.) łączność | : (rzecz.) telekomunikacja
telecommunications : telecommunications : (rzecz.) telekomunikacja
telecommuting : telecommuting : (rzecz.) telekomutacja | : (rzecz.) telepraca
teleconference : teleconference : (rzecz.) telekonferencja
teleconferencing : teleconferencing : (rzecz.) telekonferencja | : (rzecz.) telekonferencje
telegram : telegram : (rzecz.) depesza | : (rzecz.) przesyłka | : (rzecz.) telegram
telegraph : telegraph : (czas.) depeszować | : (czas.) telegrafować | : (rzecz.) telegraf
telegrapher : telegrapher : (rzecz.) telegrafista
telegraphic : telegraphic : (przym.) telegraficzny
telegraphically : telegraphically : (przysł.) telegraficznie
telegraphs : telegraphs : (rzecz.) telegrafowanie
telegraphy : telegraphy : (rzecz.) telegraf | : (rzecz.) telegrafia
telekinesis : telekinesis : (rzecz.) telekineza
telekinetic : telekinetic : (przym.) telekinetyczny
telemeter : telemeter : (rzecz.) dalekomierz | : (rzecz.) dalmierz | : (rzecz.) telemetr
telemetric : telemetric : (przym.) telemetryczny
telemetry : telemetry : (rzecz.) telemetria
teleological : teleological : (przym.) teleologiczny
teleology : teleology : (rzecz.) teleologia
telepathic : telepathic : (przym.) telepatyczny
telepathy : telepathy : (rzecz.) telepatia
telephone : telephone : (czas.) telefonować | : (rzecz.) łącznica | : (rzecz.) telefon | : (rzecz.) zegarynka
telephonic : telephonic : (przym.) telefoniczny
telephonist : telephonist : (rzecz.) telefonista
telephony : telephony : (rzecz.) telefonia
telephoto : telephoto : (rzecz.) teleobiektyw | : (rzecz.) teleskopowa
telephotograph : telephotograph : (rzecz.) fototelegram | : (rzecz.) telefotografia
telephotography : telephotography : (rzecz.) symilografia | : (rzecz.) telefotografia
teleprocessing : teleprocessing : (rzecz.) teleprzetwarzanie
telescope : telescope : (rzecz.) luneta | : (rzecz.) teleskop
telescopic : telescopic : (przym.) teleskopowy
telescopically : telescopically : (przysł.) teleskopowo
teletype : teletype : (rzecz.) dalekopis
teletypewriter : teletypewriter : (rzecz.) dalekopis
televise : televise : (czas.) nadawać | : (czas.) transmitować
television : television : (rzecz.) telewizja | : (rzecz.) telewizor
television-set : television-set : (rzecz.) telewizor
telex : telex : (rzecz.) teleks
tell : tell : (czas.) dyktować | : (czas.) kazać | : (czas.) mówić | : (czas.) napleść | : (czas.) opowiadać | : (czas.) opowiedzieć | : (czas.) poinformować | : (czas.) poinstruować | : (czas.) powiadać | : (czas.) powiadomić | : (czas.) powiedzieć | : (czas.) wskazać
teller : teller : (rzecz.) kasjer
telling : telling : (przym.) wymowny | : (rzecz.) mówienie
telling-off : telling-off : (rzecz.) bura | : (rzecz.) połajanie | : (rzecz.) zbesztanie
telltale : telltale : (przym.) plotkarski | : (przym.) wrażliwy | : (przym.) zdradziecki | : (rzecz.) denuncjant | : (rzecz.) plotkarz | : (rzecz.) skarżypyta
telluride : telluride : (rzecz.) tellurek
tellurium : tellurium : (rzecz.) tellur
telly : telly : (rzecz.) telewizja
temerity : temerity : (rzecz.) śmiałość | : (rzecz.) zuchwałość | : (rzecz.) zuchwalstwo
temper : temper : (czas.) hartować | : (czas.) narozrabiać | : (czas.) odpuszczać | : (rzecz.) charakter | : (rzecz.) hartowanie | : (rzecz.) humor | : (rzecz.) łagodzenie | : (rzecz.) nastrój | : (rzecz.) natura | : (rzecz.) temperament | : (rzecz.) usposobienie
tempera : tempera : (rzecz.) tempera
temperament : temperament : (rzecz.) temperament
temperamental : temperamental : (przym.) kapryśny | : (przym.) wybuchowy
temperance : temperance : (rzecz.) abstynencja | : (rzecz.) powściągliwość | : (rzecz.) trzeźwość | : (rzecz.) umiar | : (rzecz.) wstrzemięźliwość
temperate : temperate : (przym.) powściągliwy | : (przym.) trzeźwy | : (przym.) umiarkowany | : (przym.) wstrzemięźliwy
temperately : temperately : (przysł.) umiarkowanie
temperature : temperature : (rzecz.) ciepłota | : (rzecz.) gorączka | : (rzecz.) tempera | : (rzecz.) temperatura
tempest : tempest : (rzecz.) burza | : (rzecz.) nawałnica
tempestuous : tempestuous : (przym.) burzliwy | : (przym.) nawalny
tempestuousness : tempestuousness : (rzecz.) wzburzenie
templar : templar : (rzecz.) templariusz
template : template : (rzecz.) szablon
temple : temple : (rzecz.) rozciągacz | : (rzecz.) skroń | : (rzecz.) świątynia
tempo : tempo : (rzecz.) tempo
temporal : temporal : (przym.) czasowy | : (przym.) doczesny | : (przym.) skroniowy | : (przym.) świecki | : (przym.) tymczasowy | : (przym.) ziemski
temporality : temporality : (rzecz.) doczesność | : (rzecz.) tymczasowość
temporally : temporally : (przysł.) docześnie
temporarily : temporarily : (przysł.) chwilowo | : (przysł.) czasowo | : (przysł.) przejściowo | : (przysł.) tymczasowo
temporary : temporary : (przym.) chwilowy | : (przym.) czasowy | : (przym.) doraźny | : (przym.) okresowy | : (przym.) pobytowy | : (przym.) przejściowy | : (przym.) tymczasowy
temporize : temporize : (czas.) starać | : (czas.) zwlekać
tempt : tempt : (czas.) kusić | : (czas.) mamić | : (czas.) namawiać | : (czas.) nęcić | : (czas.) skusić | : (czas.) wabić
temptation : temptation : (rzecz.) kuszenie | : (rzecz.) pokusa | : (rzecz.) pokuszenie
tempter : tempter : (rzecz.) kusiciel
tempting : tempting : (przym.) kusicielski
ten : ten : (rzecz.) dziesiąta
tenacious : tenacious : (przym.) nieustępliwy | : (przym.) spoisty | : (przym.) trwały | : (przym.) uporczywy | : (przym.) wierny | : (przym.) wytrzymały
tenacity : tenacity : (rzecz.) adhezyjność | : (rzecz.) dzierżawa | : (rzecz.) nieustępliwość | : (rzecz.) przyczepność | : (rzecz.) trwałość | : (rzecz.) upór | : (rzecz.) wytrzymałość
tenancy : tenancy : (rzecz.) dzierżawa | : (rzecz.) najem
tenant : tenant : (czas.) dzierżawić | : (rzecz.) dzierżawca | : (rzecz.) lokator | : (rzecz.) najemca | : (rzecz.) wynajemca
tend : tend : (czas.) dążyć | : (czas.) doglądać | : (czas.) dozorować | : (czas.) kłaniać | : (czas.) obsługiwać | : (czas.) opiekować | : (czas.) pilnować | : (czas.) skłaniać | : (czas.) zmierzać
tendency : tendency : (rzecz.) dążność | : (rzecz.) kierunek | : (rzecz.) skłonność | : (rzecz.) tendencja | : (rzecz.) zwyczaj
tendentious : tendentious : (przym.) tendencyjny
tendentiousness : tendentiousness : (rzecz.) tendencyjność
tender : tender : (czas.) podawać | : (czas.) przekazywać | : (czas.) wręczać | : (przym.) czuły | : (przym.) delikatny | : (przym.) kruchy | : (rzecz.) delikatność | : (rzecz.) miękkość | : (rzecz.) oferowanie | : (rzecz.) oferta | : (rzecz.) pieszczotliwość | : (rzecz.) podawanie | : (rzecz.) podaż | : (rzecz.) przekazywanie | : (rzecz.) przetarg | : (rzecz.) wrażliwość | : (rzecz.) wręczanie
tender-hearted : tender-hearted : (przym.) czuły | : (przym.) wrażliwy
tenderfoot : tenderfoot : (rzecz.) nowicjusz
tenderize : tenderize : (czas.) zmiękczać
tenderloin : tenderloin : (rzecz.) polędwica
tenderly : tenderly : (przysł.) czule | : (przysł.) delikatnie | : (przysł.) miękko
tenderness : tenderness : (rzecz.) czułość | : (rzecz.) delikatność | : (rzecz.) kruchość | : (rzecz.) tkliwość
tendon : tendon : (rzecz.) ścięgno
tendril : tendril : (rzecz.) wąs
tenement : tenement : (rzecz.) kamienica | : (rzecz.) posiadłość
tenement-house : tenement-house : (rzecz.) dom
tenet : tenet : (rzecz.) dogmat | : (rzecz.) doktryna | : (rzecz.) zasada
tenfold : tenfold : (przym.) dziesięciokrotny | : (przysł.) dziesięciokrotnie
tennis : tennis : (rzecz.) tenis | : (rzecz.) tenisista
tennis-court : tennis-court : (rzecz.) kort
tennis-player : tennis-player : (rzecz.) tenisista
tenor : tenor : (rzecz.) bieg | : (rzecz.) brzmienie | : (rzecz.) istota | : (rzecz.) przebieg | : (rzecz.) śpiewak | : (rzecz.) tenor | : (rzecz.) treść
tenpin : tenpin : (rzecz.) kręgiel
tense : tense : (czas.) napinać | : (przym.) napięty | : (przym.) spięty | : (rzecz.) czas
tenseness : tenseness : (rzecz.) napięcie
tensile : tensile : (przym.) rozciągliwy
tension : tension : (rzecz.) dwubiegunowość | : (rzecz.) naciąg | : (rzecz.) napicie | : (rzecz.) napięcie | : (rzecz.) naprężenie | : (rzecz.) natężenie | : (rzecz.) rozciąganie
tensioning : tensioning : (rzecz.) naciąganie | : (rzecz.) napinanie
tensor : tensor : (rzecz.) napinacz | : (rzecz.) tensor
tent : tent : (rzecz.) namiot
tentacle : tentacle : (rzecz.) czułek | : (rzecz.) macka | : (rzecz.) wąs
tentative : tentative : (przym.) niepewny | : (przym.) próbny | : (przym.) taki
tentatively : tentatively : (przysł.) niepewnie | : (przysł.) wstępnie
tenth : tenth : (przym.) dziesiąty
tenuous : tenuous : (przym.) cienki | : (przym.) delikatny | : (przym.) drobny | : (przym.) subtelny | : (przym.) wiotki
tenure : tenure : (rzecz.) dzierżawa | : (rzecz.) kadencja | : (rzecz.) posiadanie | : (rzecz.) urzędowanie
tepid : tepid : (przym.) chłodny
tepidity : tepidity : (rzecz.) letniość
terabyte : terabyte : (rzecz.) terabajt
teratology : teratology : (rzecz.) teratologia
terbium : terbium : (rzecz.) terb
terdemalion : terdemalion : (rzecz.) łapserdak
tergiversation : tergiversation : (rzecz.) wykręt
term : term : (czas.) nazywać | : (rzecz.) człon | : (rzecz.) kadencja | : (rzecz.) kategoria | : (rzecz.) kwartał | : (rzecz.) okres | : (rzecz.) określenie | : (rzecz.) pojęcie | : (rzecz.) semestr | : (rzecz.) stosunek | : (rzecz.) term | : (rzecz.) termin | : (rzecz.) trymestr | : (rzecz.) warunek | : (rzecz.) wyraz | : (rzecz.) wyrażenie
termagant : termagant : (rzecz.) jędza | : (rzecz.) piekielnica | : (rzecz.) sekutnica | : (rzecz.) szczekaczka
terminable : terminable : (przym.) graniczny | : (przym.) końcowy | : (przym.) kwartalny | : (przym.) ostateczny
terminal : terminal : (przym.) końcowy | : (przym.) późny | : (przym.) śmiertelny | : (rzecz.) dworzec | : (rzecz.) końcówka | : (rzecz.) koniec | : (rzecz.) kres | : (rzecz.) przyłącze | : (rzecz.) terminal | : (rzecz.) zacisk | : (rzecz.) zakończenie
terminally : terminally : (przysł.) nieuleczalnie | : (przysł.) śmiertelnie
terminate : terminate : (czas.) kończyć | : (czas.) ograniczać | : (czas.) określać | : (czas.) przerywać | : (czas.) wypowiedzieć | : (czas.) zakańczać | : (czas.) zakończyć
termination : termination : (rzecz.) ciężar | : (rzecz.) końcówka | : (rzecz.) koniec | : (rzecz.) obciążenie | : (rzecz.) przeszkoda | : (rzecz.) wypowiedzenie | : (rzecz.) zakończenie
terminator : terminator : (rzecz.) zakończenie
terminological : terminological : (przym.) terminologiczny
terminologically : terminologically : (przysł.) terminologicznie
terminology : terminology : (rzecz.) nazewnictwo | : (rzecz.) terminologia
terminus : terminus : (rzecz.) autobus | : (rzecz.) koniec
termite : termite : (rzecz.) mrówka | : (rzecz.) termit
tern : tern : (rzecz.) mewa | : (rzecz.) rybitwa
ternary : ternary : (przym.) potrójny
terra : terra : (rzecz.) tera
terrace : terrace : (rzecz.) taras | : (rzecz.) terasa
terraced : terraced : (przym.) szeregowy | : (przym.) tarasowy
terracotta : terracotta : (przym.) terakotowy | : (rzecz.) terakota
terrain : terrain : (rzecz.) teren
terrarium : terrarium : (rzecz.) terrarium
terrazzo : terrazzo : (rzecz.) lastryko
terrene : terrene : (rzecz.) kraj | : (rzecz.) obszar | : (rzecz.) ziemia
terrestrial : terrestrial : (przym.) doczesny | : (przym.) lądowy | : (przym.) naziemny | : (przym.) wokółziemski | : (przym.) ziemny | : (przym.) ziemski
terrible : terrible : (przym.) okropny | : (przym.) straszliwy | : (przym.) straszny | : (przym.) tragiczny
terribly : terribly : (przysł.) brzydko | : (przysł.) nieudolnie | : (przysł.) okropnie | : (przysł.) strasznie
terrier : terrier : (rzecz.) kataster | : (rzecz.) terier
terrific : terrific : (przym.) fantastyczny | : (przym.) niesamowity | : (przym.) okropny | : (przym.) potworny | : (przym.) straszliwy | : (przym.) straszny | : (przym.) wspaniały | : (przym.) zawrotny
terrified : terrified : (czas.) truchleć
terrify : terrify : (czas.) przerażać | : (czas.) przerazić | : (czas.) przestraszyć | : (czas.) terroryzować | : (czas.) zastraszać
territorial : territorial : (przym.) okręgowy | : (przym.) terytorialny | : (przym.) ziemiański
territoriality : territoriality : (rzecz.) terytorialność
territory : territory : (rzecz.) obszar | : (rzecz.) teren | : (rzecz.) terytorium
terror : terror : (rzecz.) bojaźń | : (rzecz.) groza | : (rzecz.) postrach | : (rzecz.) przerażenie | : (rzecz.) strach | : (rzecz.) terror
terrorism : terrorism : (rzecz.) terroryzm
terrorist : terrorist : (rzecz.) terrorysta
terrorization : terrorization : (rzecz.) terroryzowanie
terrorize : terrorize : (czas.) sterroryzować | : (czas.) terroryzować | : (czas.) zastraszyć
terse : terse : (przym.) lakoniczny | : (przym.) lapidarny | : (przym.) zwięzły
tersely : tersely : (przysł.) treściwie | : (przysł.) zwięźle
tertiary : tertiary : (przym.) trzeciorzędny | : (przym.) trzeciorzędowy
tessellated : tessellated : (przym.) mozaikowy
test : test : (czas.) badać | : (czas.) próbować | : (czas.) sprawdzać | : (czas.) sprawdzić | : (czas.) testować | : (rzecz.) egzamin | : (rzecz.) klasówka | : (rzecz.) kolokwium | : (rzecz.) miernik | : (rzecz.) pancerz | : (rzecz.) próba | : (rzecz.) sprawdzian | : (rzecz.) test | : (przym.) precedensowy
test-glass : test-glass : (rzecz.) probówka
test-tube : test-tube : (rzecz.) epruwetka | : (rzecz.) probówka
testament : testament : (rzecz.) świadectwo | : (rzecz.) testament
testamentary : testamentary : (przym.) testamentowy
testator : testator : (rzecz.) testator
tester : tester : (rzecz.) kontroler | : (rzecz.) próbnik | : (rzecz.) rzeczoznawca | : (rzecz.) tester
testicle : testicle : (rzecz.) jądro
testicular : testicular : (przym.) jądrowy
testify : testify : (czas.) deklarować | : (czas.) poświadczać | : (czas.) stwierdzać | : (czas.) świadczyć | : (czas.) zeznawać
testimonial : testimonial : (przym.) poświadczający | : (rzecz.) poświadczenie | : (rzecz.) świadectwo | : (rzecz.) upominek | : (rzecz.) zaświadczenie
testimony : testimony : (rzecz.) deklaracja | : (rzecz.) oświadczenie | : (rzecz.) poświadczenie | : (rzecz.) świadczenie | : (rzecz.) świadectwo | : (rzecz.) zeznanie
testiness : testiness : (rzecz.) irytacja
testing : testing : (przym.) kontrolny | : (przym.) probierczy | : (rzecz.) próbkowanie | : (rzecz.) testowanie
testis : testis : (rzecz.) jądro
testosterone : testosterone : (rzecz.) testosteron
testy : testy : (przym.) gniewny | : (przym.) złośliwy
tetanus : tetanus : (rzecz.) tężec
tetchy : tetchy : (przym.) drażliwy | : (przym.) pobudliwy
tether : tether : (czas.) przywiązywać | : (czas.) spętać | : (rzecz.) łańcuch | : (rzecz.) lina | : (rzecz.) pęta | : (rzecz.) pętla | : (rzecz.) przywiązanie | : (rzecz.) uwięź
tetrachloride : tetrachloride : (rzecz.) czterochlorek
tetracycline : tetracycline : (rzecz.) tetracyklina
tetrad : tetrad : (przym.) czterowartościowy | : (rzecz.) tetrada
tetragonal : tetragonal : (przym.) czworokątny
tetrahedral : tetrahedral : (przym.) czworościenny
tetrahedron : tetrahedron : (rzecz.) czworościan | : (rzecz.) tetraedr
tetrameter : tetrameter : (rzecz.) tetrametr
tetrarch : tetrarch : (rzecz.) tetrarcha
tetravalent : tetravalent : (przym.) czterowartościowy
text : text : (rzecz.) czytanka | : (rzecz.) tekst
text-book : text-book : (rzecz.) podręcznik
textbook : textbook : (rzecz.) podręcznik
textile : textile : (przym.) tekstylny | : (przym.) włókienniczy | : (rzecz.) tekstylia | : (rzecz.) tkanina
textiles : textiles : (rzecz.) tekstylia | : (rzecz.) włókiennictwo
textual : textual : (przym.) tekstowy
textually : textually : (przysł.) dosłownie
texture : texture : (rzecz.) błam | : (rzecz.) budowa | : (rzecz.) budowla | : (rzecz.) faktura | : (rzecz.) konsystencja | : (rzecz.) struktura | : (rzecz.) tekstura | : (rzecz.) tkanie | : (rzecz.) tkanina
texturing : texturing : (rzecz.) postaciowanie
thalamus : thalamus : (rzecz.) kielich
thalassic : thalassic : (przym.) morski
thallium : thallium : (rzecz.) tal
than : than : (spójnik) aniżeli
thank : thank : (czas.) dziękować | : (czas.) podziękować
thankful : thankful : (przym.) dziękczynny | : (przym.) wdzięczny
thankfully : thankfully : (przysł.) szczęśliwie
thankfulness : thankfulness : (rzecz.) dziękczynienie | : (rzecz.) wdzięczność
thankless : thankless : (przym.) niewdzięczny
thanks : thanks : (rzecz.) dziękczynienie | : (rzecz.) dziękowanie | : (rzecz.) podziękowanie
thanksgiving : thanksgiving : (rzecz.) dziękczynienie
that : that : (przym.) jaki | : (przym.) siaki | : (spójnik) aby | : (spójnik) ażeby | : (spójnik) iż | : (spójnik) że | : (spójnik) żeby
thatch : thatch : (rzecz.) poszycie | : (rzecz.) strzecha
thaumaturgy : thaumaturgy : (rzecz.) cudotwórstwo | : (rzecz.) magia
thaw : thaw : (czas.) odmarzać | : (czas.) odtajać | : (czas.) rozmrażać | : (czas.) rozpuszczać | : (czas.) roztajać | : (czas.) roztapiać | : (czas.) roztopić | : (czas.) tajać | : (czas.) topić | : (czas.) topnieć | : (rzecz.) odwilż | : (rzecz.) roztop
the : the : (przym.) przedmiotowy
theatre : theatre : (rzecz.) kino | : (rzecz.) teatr
theatregoer : theatregoer : (rzecz.) teatroman
theatrical : theatrical : (przym.) teatralny
theatrically : theatrically : (przysł.) teatralnie
theft : theft : (rzecz.) kradzież | : (rzecz.) złodziejstwo
theism : theism : (rzecz.) teizm
thematic : thematic : (przym.) tematowy | : (przym.) tematyczny
thematically : thematically : (przysł.) tematycznie
theme : theme : (rzecz.) kompozycja | : (rzecz.) motyw | : (rzecz.) przedmiot | : (rzecz.) temat | : (rzecz.) wypracowanie | : (rzecz.) wystrój
then : then : (przysł.) następnie | : (przysł.) potem | : (przysł.) stamtąd | : (przysł.) wówczas | : (przysł.) wtedy | : (przysł.) wtenczas
thence : thence : (przysł.) stamtąd
thenceforth : thenceforth : (przysł.) odtąd
thenceforward : thenceforward : (przysł.) odtąd
theocracy : theocracy : (rzecz.) teokracja
theocrat : theocrat : (rzecz.) teokrata
theocratic : theocratic : (przym.) teokratyczny
theodicy : theodicy : (rzecz.) teodycea
theologian : theologian : (rzecz.) teolog
theological : theological : (przym.) teologiczny
theologically : theologically : (przysł.) teologicznie
theology : theology : (rzecz.) teologia
theorem : theorem : (rzecz.) teoremat | : (rzecz.) twierdzenie
theoretic : theoretic : (przym.) akademicki | : (przym.) teoretyczny
theoretical : theoretical : (przym.) akademicki | : (przym.) teoretyczny
theoretically : theoretically : (przysł.) teoretycznie
theoretician : theoretician : (rzecz.) teoretyk
theorist : theorist : (rzecz.) teoretyk
theorize : theorize : (czas.) teoretyzować
theorizing : theorizing : (rzecz.) teoretyzowanie
theory : theory : (rzecz.) teoria
theosophy : theosophy : (rzecz.) teozofia
therapeutic : therapeutic : (przym.) kuracyjny | : (przym.) leczniczy | : (przym.) terapeutyczny
therapeutically : therapeutically : (przysł.) terapeutycznie
therapeutics : therapeutics : (rzecz.) lecznictwo | : (rzecz.) terapeutyka | : (rzecz.) terapia
therapist : therapist : (rzecz.) terapeuta
therapy : therapy : (rzecz.) leczenie | : (rzecz.) terapeutyka | : (rzecz.) terapia
there : there : (przysł.) tam | : (przysł.) tamże
thereabout : thereabout : (przysł.) niedaleko
thereabouts : thereabouts : (przysł.) niedaleko
thereafter : thereafter : (przysł.) następnie | : (przysł.) potem
therefore : therefore : (przysł.) dlatego
therein : therein : (przysł.) tamże
thereof : thereof : (przysł.) tamże
thereupon : thereupon : (przysł.) dlatego | : (przysł.) następnie | : (przysł.) potem
therewith : therewith : (przysł.) natychmiast
thermal : thermal : (przym.) cieplicowy | : (przym.) cieplny | : (przym.) ciepły | : (przym.) termalny | : (przym.) termiczny
thermally : thermally : (przysł.) termicznie
thermocouple : thermocouple : (rzecz.) termoelement | : (rzecz.) termoogniwo | : (rzecz.) termopara
thermodynamic : thermodynamic : (przym.) termodynamiczny
thermodynamics : thermodynamics : (rzecz.) termodynamika
thermoelectric : thermoelectric : (przym.) termoelektryczny
thermoelectricity : thermoelectricity : (rzecz.) termoelektryczność
thermograph : thermograph : (rzecz.) termograf
thermometer : thermometer : (rzecz.) termograf | : (rzecz.) termometr
thermometric : thermometric : (przym.) termometryczny
thermometry : thermometry : (rzecz.) termometria
thermonuclear : thermonuclear : (przym.) termojądrowy | : (przym.) termonuklearny
thermopile : thermopile : (rzecz.) termostos
thermoplastic : thermoplastic : (przym.) termoplastyczny
thermoregulation : thermoregulation : (rzecz.) termoregulacja
thermos : thermos : (rzecz.) termos
thermosetting : thermosetting : (przym.) termoutwardzalny
thermosphere : thermosphere : (rzecz.) termosfera
thermostat : thermostat : (rzecz.) termostat
thermostatic : thermostatic : (przym.) termostatyczny
thermostatically : thermostatically : (przysł.) termostatycznie
thermotherapy : thermotherapy : (rzecz.) termoterapia
thesaurus : thesaurus : (rzecz.) tezaurus
thesis : thesis : (rzecz.) dysertacja | : (rzecz.) rozprawa | : (rzecz.) teza
thiamine : thiamine : (rzecz.) aneuryna | : (rzecz.) tiamina
thick : thick : (przym.) gęsty | : (przym.) gruby | : (przym.) tłusty | : (przym.) zawiesisty | : (przysł.) ciężko | : (przysł.) gęsto | : (przysł.) grubo | : (rzecz.) gąszcz | : (rzecz.) zarośla | : (rzecz.) zgęstnienie
thick-headed : thick-headed : (przym.) bałwański | : (przym.) tępy
thick-skinned : thick-skinned : (przym.) gruboskórny
thick-walled : thick-walled : (przym.) grubościenny
thicken : thicken : (czas.) gęstnieć | : (czas.) grubieć | : (czas.) pogrubiać | : (czas.) pogrubić | : (czas.) zagęścić | : (czas.) zagęszczać | : (czas.) zgęstnieć
thickener : thickener : (rzecz.) zagęszczacz
thicker : thicker : (przym.) gruby
thicket : thicket : (rzecz.) chaszcze | : (rzecz.) gąszcz | : (rzecz.) gęstwina | : (rzecz.) zarośla
thickets : thickets : (rzecz.) chaszcze
thickhead : thickhead : (rzecz.) tępota
thickly : thickly : (przysł.) gęsto | : (przysł.) grubo
thickness : thickness : (rzecz.) częstość | : (rzecz.) gęstość | : (rzecz.) grubość | : (rzecz.) miąższość | : (rzecz.) warstwa
thickset : thickset : (przym.) gęsty | : (przym.) krępy | : (przym.) przysadkowaty | : (przym.) przysadzisty | : (przym.) zwalisty
thief : thief : (rzecz.) łotr | : (rzecz.) rzezimieszek | : (rzecz.) szabrownik | : (rzecz.) złodziej
thieve : thieve : (czas.) kraść | : (czas.) podkradać | : (czas.) ukraść
thievery : thievery : (rzecz.) kradzież
thieving : thieving : (przym.) złodziejski | : (rzecz.) kradzież | : (rzecz.) złodziejstwo
thievish : thievish : (przym.) złodziejski
thigh : thigh : (rzecz.) udo
thimble : thimble : (rzecz.) chomątko | : (rzecz.) gilza | : (rzecz.) naparstek | : (rzecz.) nasadka | : (rzecz.) podpórka
thin : thin : (czas.) przerzedzać | : (czas.) rozcieńczyć | : (czas.) rozrzedzać | : (czas.) rozrzedzić | : (czas.) rzednąć | : (czas.) ścieniać | : (przym.) chudy | : (przym.) cienki | : (przym.) patykowaty | : (przym.) rzadki | : (przym.) słaby | : (przym.) szczupły
thin-layer : thin-layer : (przym.) cienkowarstwowy
thin-skinned : thin-skinned : (przym.) delikatny | : (przym.) nadwrażliwy | : (przym.) wrażliwy
thin-walled : thin-walled : (przym.) cienkościenny
thing : thing : (rzecz.) bestyjka | : (rzecz.) istota | : (rzecz.) przedmiot | : (rzecz.) rzecz | : (rzecz.) sprawa | : (rzecz.) ubranie
think : think : (czas.) mniemać | : (czas.) myśleć | : (czas.) pomyśleć | : (czas.) sądzić | : (czas.) uważać | : (czas.) zastanawiać
thinkable : thinkable : (przym.) ewentualny
thinker : thinker : (rzecz.) myśliciel
thinking : thinking : (przym.) myślący | : (przym.) myślowy | : (przym.) rozumny | : (rzecz.) myślenie | : (rzecz.) rozmyślanie
thinly : thinly : (przysł.) cienko
thinner : thinner : (przym.) chudy
thinness : thinness : (rzecz.) chudość | : (rzecz.) cienkość
thinnest : thinnest : (przym.) chudy | : (przym.) cienki
thinning : thinning : (rzecz.) chudnięcie | : (rzecz.) przerywka | : (rzecz.) przerzedzenie | : (rzecz.) rębnia | : (rzecz.) rozcieńczanie | : (rzecz.) rozrzedzanie | : (rzecz.) ścienianie | : (rzecz.) trzebienie | : (rzecz.) trzebież
third : third : (przym.) trzeci
third-rate : third-rate : (przym.) trzeciorzędny
thirst : thirst : (czas.) pragnąć | : (rzecz.) pragnienie | : (rzecz.) suchość | : (rzecz.) żądza
thirsty : thirsty : (przym.) spragniony | : (przym.) żądny
thirteenth : thirteenth : (przym.) trzynasty
thirtieth : thirtieth : (przym.) trzydziesty
this : this : (przysł.) tęgo
thistle : thistle : (rzecz.) oset | : (rzecz.) ostrożeń
thither : thither : (przysł.) tam
thong : thong : (rzecz.) bizun | : (rzecz.) kańczug | : (rzecz.) pasek | : (rzecz.) rzemień | : (rzecz.) rzemyk
thoracic : thoracic : (przym.) piersiowy
thorax : thorax : (rzecz.) tors | : (rzecz.) tułów
thorium : thorium : (rzecz.) tor
thorn : thorn : (rzecz.) cierń | : (rzecz.) kolec
thorny : thorny : (przym.) cierniowaty | : (przym.) cierniowy | : (przym.) ciernisty | : (przym.) drażliwy | : (przym.) kolący | : (przym.) kolczasty
thorough : thorough : (przym.) całkowity | : (przym.) dogłębny | : (przym.) dokładny | : (przym.) doszczętny | : (przym.) drobiazgowy | : (przym.) gruntowny | : (przym.) skrupulatny | : (przym.) wnikliwy
thoroughbred : thoroughbred : (przym.) pełnokrwisty | : (przym.) rasowy | : (przym.) szlachetny
thoroughfare : thoroughfare : (rzecz.) arteria | : (rzecz.) ciąg | : (rzecz.) magistrala | : (rzecz.) przejazd | : (rzecz.) przejście | : (rzecz.) ulica
thoroughgoing : thoroughgoing : (przym.) bezkompromisowy | : (przym.) gruntowny | : (przym.) stanowczy
thoroughly : thoroughly : (przysł.) dokładnie | : (przysł.) gruntownie | : (przysł.) starannie | : (przysł.) właśnie | : (przysł.) zupełnie
thoroughness : thoroughness : (rzecz.) gruntowność
thorp : thorp : (rzecz.) wieś
though : though : (przysł.) jakkolwiek | : (spójnik) acz | : (spójnik) chociaż | : (spójnik) jednak
thought : thought : (czas.) myśleć | : (rzecz.) mniemanie | : (rzecz.) myśl | : (rzecz.) namysł | : (rzecz.) rozważanie | : (rzecz.) zastanowienie | : (rzecz.) zwornik
thoughtful : thoughtful : (przym.) głęboki | : (przym.) roztropny | : (przym.) rozważny | : (przym.) troskliwy
thoughtfulness : thoughtfulness : (rzecz.) zadumanie | : (rzecz.) zamyślenie
thoughtless : thoughtless : (przym.) bezmyślny | : (przym.) beztroski | : (przym.) lekkomyślny | : (przym.) nierozważny
thoughtlessly : thoughtlessly : (przysł.) bezmyślnie | : (przysł.) lekkomyślnie
thoughtlessness : thoughtlessness : (rzecz.) bezmyślność
thousand : thousand : (przym.) tysięczny | : (rzecz.) tysiąc
thousandth : thousandth : (przym.) tysiączny | : (przym.) tysięczny
thraldom : thraldom : (rzecz.) niewolnictwo | : (rzecz.) pańszczyzna
thrall : thrall : (rzecz.) niewola | : (rzecz.) niewolnik
thrash : thrash : (czas.) bić | : (czas.) chłostać | : (czas.) lać | : (czas.) młócić | : (czas.) prać | : (czas.) zbić | : (rzecz.) balanga
thrashing : thrashing : (rzecz.) cięgi | : (rzecz.) lanie | : (rzecz.) zbijanie
thread : thread : (czas.) gwintować | : (czas.) nawlekać | : (czas.) nizać | : (czas.) przeciskać | : (rzecz.) gwint | : (rzecz.) nić | : (rzecz.) nitka | : (rzecz.) pasmo | : (rzecz.) wątek
thread-worm : thread-worm : (rzecz.) owsik
threadbare : threadbare : (przym.) przeświecający | : (przym.) wytarty
threadlike : threadlike : (przym.) nitkowaty
threadworm : threadworm : (rzecz.) owsik
threat : threat : (rzecz.) groźba | : (rzecz.) pogróżka | : (rzecz.) zagrożenie
threaten : threaten : (czas.) grozić | : (czas.) odgrażać | : (czas.) zagrażać | : (czas.) zagrozić
threatening : threatening : (przym.) groźny
three : three : (przym.) trojaki | : (rzecz.) trójka
three-decker : three-decker : (rzecz.) trójpokładowiec
three-dimensional : three-dimensional : (przym.) przestrzenny | : (przym.) trójwymiarowy
three-master : three-master : (rzecz.) trójmasztowiec
three-ply : three-ply : (przym.) potrójny
threefold : threefold : (przym.) potrójny | : (przym.) trojaki | : (przym.) trzykrotny | : (przysł.) potrójnie | : (przysł.) trzykrotnie
threescore : threescore : (rzecz.) kopa
threesome : threesome : (rzecz.) trójka
threnody : threnody : (rzecz.) tren
thresh : thresh : (czas.) bić | : (czas.) chłostać | : (czas.) młócić | : (czas.) namłócić
thresher : thresher : (rzecz.) młocarnia | : (rzecz.) młockarnia | : (rzecz.) papierń
threshing : threshing : (rzecz.) gumno | : (rzecz.) młócenie | : (rzecz.) młocka | : (rzecz.) młócka | : (rzecz.) omłot
threshing-floor : threshing-floor : (rzecz.) klepisko
threshold : threshold : (rzecz.) próg | : (rzecz.) przedsionek | : (rzecz.) pułap
threw : threw : (czas.) rzucać | : (czas.) spadać | : (czas.) zrzucać
thrice : thrice : (przysł.) trzykrotnie
thrift : thrift : (rzecz.) gospodarność | : (rzecz.) oszczędność | : (rzecz.) zapobiegliwość
thriftiness : thriftiness : (rzecz.) gospodarność | : (rzecz.) oszczędność
thriftless : thriftless : (przym.) marnotrawny | : (przym.) nieekonomiczny | : (przym.) nieoszczędny
thrifty : thrifty : (przym.) gospodarny | : (przym.) oszczędny | : (przym.) skrzętny
thrill : thrill : (czas.) drżeć | : (czas.) ekscytować | : (czas.) wstrząsać | : (czas.) wzruszać | : (rzecz.) dreszcz | : (rzecz.) dreszczyk | : (rzecz.) drżenie | : (rzecz.) wzruszenie
thrilled : thrilled : (przym.) podekscytowany | : (przym.) wstrząśnięty
thriller : thriller : (rzecz.) dreszczowiec | : (rzecz.) sztuka
thrilling : thrilling : (przym.) dreszczowy | : (przym.) ekscytujący
thrillingly : thrillingly : (przysł.) ekscytująco
thrive : thrive : (czas.) kwitnąć | : (czas.) prosperować | : (czas.) udawać
throat : throat : (rzecz.) gardło | : (rzecz.) gardziel | : (rzecz.) przełyk
throaty : throaty : (przym.) chrapliwy | : (przym.) gardłowy
throb : throb : (czas.) bić | : (czas.) drgać | : (czas.) pukać | : (czas.) pulsować | : (czas.) tętnić | : (rzecz.) bicie | : (rzecz.) dreszcz | : (rzecz.) drganie | : (rzecz.) puls | : (rzecz.) warkot
thrombin : thrombin : (rzecz.) trombina
thrombosis : thrombosis : (rzecz.) zakrzepica
thrombus : thrombus : (rzecz.) zakrzep
throne : throne : (rzecz.) tron | : (rzecz.) władza
throng : throng : (czas.) tłoczyć | : (rzecz.) chmara | : (rzecz.) ciżba | : (rzecz.) tłok | : (rzecz.) tłum
throttle : throttle : (czas.) dławić | : (czas.) dusić | : (czas.) podusić | : (czas.) tłumić | : (czas.) udusić | : (czas.) zadławić | : (czas.) zadusić | : (rzecz.) przepustnica
through : through : (przyim.) przez | : (przysł.) całkowicie | : (przysł.) poprzez
throughout : throughout : (przyim.) przez | : (przysł.) całkowicie | : (przysł.) kompletnie | : (przysł.) poprzez | : (przysł.) wszędzie
throughput : throughput : (rzecz.) przepływność | : (rzecz.) przerób | : (rzecz.) szybkość | : (rzecz.) wydajność
throughway : throughway : (rzecz.) autostrada | : (rzecz.) magistrala
throve : throve : (czas.) rzucać | : (czas.) spadać | : (czas.) zrzucać
throw : throw : (czas.) dorzucać | : (czas.) miotać | : (czas.) nitkować | : (czas.) rzucać | : (czas.) spadać | : (czas.) wrzucać | : (czas.) zrzucać | : (rzecz.) rzucenie | : (rzecz.) rzut | : (rzecz.) wyrzut
throwback : throwback : (rzecz.) odrzucenie | : (rzecz.) relikt
thrower : thrower : (rzecz.) dyskobol | : (rzecz.) miotacz | : (rzecz.) odrzutnik
thrown : thrown : (czas.) rzucać | : (czas.) spadać | : (czas.) zrzucać
thrum : thrum : (czas.) bębnić | : (czas.) rzępolić
thrush : thrush : (rzecz.) drozd | : (rzecz.) pleśniawka
thrust : thrust : (czas.) naciskać | : (czas.) nasuwać | : (czas.) popychać | : (czas.) przeć | : (czas.) szturchać | : (czas.) wierzyć | : (czas.) wpraszać | : (czas.) wścibiać | : (czas.) zapuszczać | : (czas.) zrzucać | : (rzecz.) ciąg | : (rzecz.) dźgnięcie | : (rzecz.) napór | : (rzecz.) odrzut | : (rzecz.) ofensywa | : (rzecz.) parcie | : (rzecz.) pchnięcie | : (rzecz.) szturchnięcie | : (rzecz.) sztych | : (rzecz.) zrzut
thud : thud : (rzecz.) łomot | : (rzecz.) łoskot
thug : thug : (rzecz.) bandyta | : (rzecz.) chuligan | : (rzecz.) skrytobójca | : (rzecz.) zbir | : (rzecz.) zbój
thulium : thulium : (rzecz.) tul
thumb : thumb : (rzecz.) kciuk
thumb-lack : thumb-lack : (rzecz.) pinezka | : (rzecz.) pluskiewka
thumb-lock : thumb-lock : (rzecz.) zatrzask
thumbnail : thumbnail : (przym.) miniaturowy | : (rzecz.) miniatura | : (rzecz.) miniaturka
thumbtack : thumbtack : (rzecz.) pinezka | : (rzecz.) pluskiewka
thump : thump : (czas.) buchać | : (czas.) dudnić | : (czas.) walić | : (rzecz.) uderzenie
thumper : thumper : (rzecz.) kolos
thumping : thumping : (przym.) ogromny | : (przym.) straszliwy
thunder : thunder : (czas.) grzmieć | : (rzecz.) grom | : (rzecz.) grzmot | : (rzecz.) huk | : (rzecz.) piorun | : (rzecz.) szlag
thunderbolt : thunderbolt : (rzecz.) piorun
thundercloud : thundercloud : (rzecz.) chmura
thunderhead : thunderhead : (przym.) burzowy
thundering : thundering : (przym.) gromowy | : (przym.) olbrzymi | : (przym.) piorunowy | : (przym.) straszliwy
thunderous : thunderous : (przym.) grzmiący | : (przym.) rzęsisty
thunderstorm : thunderstorm : (rzecz.) burza
thus : thus : (przysł.) stąd | : (przysł.) tak | : (przysł.) walnie
thwack : thwack : (rzecz.) trzaśnięcie
thwart : thwart : (czas.) krzyżować | : (czas.) niweczyć | : (czas.) pokrzyżować | : (czas.) udaremniać
thyme : thyme : (rzecz.) macierzanka | : (rzecz.) tymianek
thymine : thymine : (rzecz.) tymina
thymus : thymus : (rzecz.) grasica | : (rzecz.) tymianek
thyroid : thyroid : (przym.) tarczycowy | : (rzecz.) tarczyca
thyroidal : thyroidal : (przym.) tarczycowy
tiara : tiara : (rzecz.) diadem | : (rzecz.) tiara
tibia : tibia : (rzecz.) piszczel
tic : tic : (rzecz.) tik
tick : tick : (czas.) cykać | : (czas.) odfajkować | : (czas.) oznaczać | : (czas.) tykać | : (czas.) zakreślić | : (czas.) zaznaczyć | : (rzecz.) kleszcz | : (rzecz.) kleszcze | : (rzecz.) kredyt | : (rzecz.) takt | : (rzecz.) tykanie | : (rzecz.) tyknięcie
tick-tack : tick-tack : (rzecz.) cykanie
ticker : ticker : (rzecz.) pompa | : (rzecz.) telegraf | : (rzecz.) wychwyt | : (rzecz.) zegarek
ticket : ticket : (rzecz.) bilet | : (rzecz.) bon | : (rzecz.) etykieta | : (rzecz.) karnet | : (rzecz.) kupon | : (rzecz.) mandat | : (rzecz.) metka | : (rzecz.) numerek
ticket-collector : ticket-collector : (rzecz.) bileter
ticket-inspector : ticket-inspector : (rzecz.) kontroler
ticking : ticking : (rzecz.) cykanie | : (rzecz.) inlet
tickle : tickle : (czas.) łaskotać | : (czas.) łechtać | : (czas.) połaskotać | : (czas.) postrzępić | : (czas.) rozbawiać | : (czas.) zabawiać | : (czas.) załaskotać | : (rzecz.) łaskotanie
tickler : tickler : (rzecz.) dylemat
tickling : tickling : (rzecz.) łaskotanie
ticklish : ticklish : (przym.) delikatny | : (przym.) drażliwy | : (przym.) łaskotliwy | : (przym.) łechtliwy | : (przym.) wrażliwy
tidal : tidal : (przym.) pływowy
tiddlywinks : tiddlywinks : (rzecz.) pchełki
tide : tide : (rzecz.) bieg | : (rzecz.) czas | : (rzecz.) odpływ | : (rzecz.) pływ | : (rzecz.) pora | : (rzecz.) prąd | : (rzecz.) przypływ
tide-gauge : tide-gauge : (rzecz.) mareograf
tidily : tidily : (przysł.) schludnie | : (przysł.) starannie
tidiness : tidiness : (rzecz.) czystość | : (rzecz.) schludność
tidings : tidings : (rzecz.) wiadomości | : (rzecz.) wieść
tidy : tidy : (czas.) czyścić | : (czas.) oprzątać | : (czas.) porządkować | : (czas.) posprzątać | : (czas.) sprzątać | : (czas.) uprzątać | : (przym.) chędogi | : (przym.) czysty | : (przym.) ładny | : (przym.) porządny | : (przym.) schludny
tidy, : tidy, : (przym.) schludny | : (przym.) spory
tie : tie : (czas.) łączyć | : (czas.) obwiązywać | : (czas.) przewiązać | : (czas.) przywiesić | : (czas.) uwiązać | : (czas.) wiązać | : (czas.) zawiązać | : (czas.) zremisować | : (rzecz.) cięgno | : (rzecz.) krawat | : (rzecz.) krawatka | : (rzecz.) ligatura | : (rzecz.) remis | : (rzecz.) węzeł | : (rzecz.) wiązadło | : (rzecz.) wiązanie | : (rzecz.) więź
tier : tier : (rzecz.) kondygnacja | : (rzecz.) rząd | : (rzecz.) wiązacz
tierce : tierce : (rzecz.) tercja
tiff : tiff : (rzecz.) baryt | : (rzecz.) kłótnia
tiffany : tiffany : (rzecz.) muślin
tiger : tiger : (rzecz.) tygrys
tiger-eye : tiger-eye : (rzecz.) miner
tight : tight : (przym.) ciasny | : (przym.) kurczowy | : (przym.) nieprzepuszczalny | : (przym.) obcisły | : (przym.) rychły | : (przym.) skąpy | : (przym.) spoisty | : (przym.) szczelny
tight-fisted : tight-fisted : (przym.) niezręczny | : (przym.) skąpy
tight-fitting : tight-fitting : (przym.) obcisły
tight-rope : tight-rope : (rzecz.) lina
tighten : tighten : (czas.) dociskać | : (czas.) dokręcać | : (czas.) dokręcić | : (czas.) napiąć | : (czas.) napinać | : (czas.) ściągnąć | : (czas.) ścieśniać | : (czas.) ścieśnić | : (czas.) ściskać | : (czas.) uszczelniać | : (czas.) zacieśniać | : (czas.) zacieśnić | : (czas.) zaciskać
tightly : tightly : (przysł.) ciasno | : (przysł.) kurczowo | : (przysł.) mocno | : (przysł.) szczelnie
tightness : tightness : (rzecz.) ciasnota | : (rzecz.) obcisłość | : (rzecz.) szczelność | : (rzecz.) zwartość
tightrope : tightrope : (rzecz.) lina
tights : tights : (rzecz.) rajstopy | : (rzecz.) rajtuzy | : (rzecz.) trykoty
tightwad : tightwad : (rzecz.) dusigrosz | : (rzecz.) skąpiec | : (rzecz.) sknera
tilde : tilde : (rzecz.) tylda
tile : tile : (czas.) taflować | : (rzecz.) dachówka | : (rzecz.) kafel | : (rzecz.) płytka | : (rzecz.) tafelka | : (rzecz.) tafla
tiles : tiles : (rzecz.) kafelki
tiling : tiling : (rzecz.) dekarstwo | : (rzecz.) mozaikowanie | : (rzecz.) układanie
till : till : (czas.) orać | : (czas.) uprawiać | : (rzecz.) kasa | : (spójnik) aż | : (spójnik) dopóki | : (spójnik) dopóty
tillage : tillage : (rzecz.) dekowanie | : (rzecz.) orka | : (rzecz.) uprawa
tiller : tiller : (rzecz.) rolnik | : (rzecz.) rumpel | : (rzecz.) sterownica
tilt : tilt : (czas.) atakować | : (czas.) nachylać | : (czas.) napadać | : (czas.) padać | : (czas.) pochylić | : (czas.) przechylać | : (czas.) przechylić | : (czas.) przychylać | : (czas.) przychylić | : (czas.) rzucać | : (czas.) rzucić | : (rzecz.) nachylenie | : (rzecz.) osłona | : (rzecz.) przechył | : (rzecz.) przechylanie | : (rzecz.) przechylenie
tilts : tilts : (rzecz.) turniej
timber : timber : (czas.) cembrować | : (czas.) ocembrować | : (czas.) szalować | : (rzecz.) belka | : (rzecz.) budulec | : (rzecz.) drewno | : (rzecz.) drzewo | : (rzecz.) las | : (rzecz.) wręga
timbered : timbered : (przym.) drewniany
timbering : timbering : (rzecz.) ocembrowanie | : (rzecz.) odeskowanie | : (rzecz.) oszalowanie | : (rzecz.) szalowanie
timberwork : timberwork : (rzecz.) ciesielstwo
timbre : timbre : (rzecz.) barwa | : (rzecz.) brzmienie | : (rzecz.) tembr
time : time : (czas.) potrwać | : (przym.) czasochłonny | : (przym.) terminowy | : (rzecz.) chwila | : (rzecz.) czas | : (rzecz.) czasochłonność | : (rzecz.) etat | : (rzecz.) godzina | : (rzecz.) moment | : (rzecz.) okres | : (rzecz.) pora | : (rzecz.) raz | : (rzecz.) takt | : (rzecz.) termin | : (rzecz.) terminowanie
time-consuming : time-consuming : (przym.) czasochłonny
time-honoured : time-honoured : (przym.) tradycyjny
time-limit : time-limit : (rzecz.) termin
time-out : time-out : (rzecz.) przeterminowanie
time-server : time-server : (rzecz.) koniunkturalista | : (rzecz.) oportunista
time-table : time-table : (rzecz.) harmonogram | : (rzecz.) terminarz
timeframe : timeframe : (rzecz.) rama
timekeeper : timekeeper : (rzecz.) chronometr | : (rzecz.) chronometrażysta | : (rzecz.) czasomierz | : (rzecz.) zegar
timekeeping : timekeeping : (rzecz.) chronometraż
timeless : timeless : (przym.) bezczasowy | : (przym.) ponadczasowy | : (przym.) wieczny
timelessly : timelessly : (przysł.) wiecznie
timelessness : timelessness : (przym.) ponadczasowy | : (rzecz.) bezczasowość | : (rzecz.) wieczność
timeliness : timeliness : (rzecz.) aktualność | : (rzecz.) punktualność
timely : timely : (przym.) aktualny | : (przym.) odpowiedni | : (przym.) pomyślny | : (przym.) wczesny
timeout : timeout : (czas.) kończyć | : (czas.) skończyć | : (rzecz.) przerwa
timepiece : timepiece : (rzecz.) czasomierz
timer : timer : (rzecz.) chronometrażysta | : (rzecz.) czasomierz | : (rzecz.) czasoster | : (rzecz.) minutnik | : (rzecz.) sekundomierz | : (rzecz.) stoper | : (rzecz.) zegar
times : times : (rzecz.) krotność | : (rzecz.) razy
timescale : timescale : (rzecz.) harmonogram
timeserver : timeserver : (rzecz.) koniunkturalista | : (rzecz.) oportunista
timestamp : timestamp : (rzecz.) datownik
timetable : timetable : (rzecz.) harmonogram | : (rzecz.) rozkład
timid : timid : (przym.) bojaźliwy | : (przym.) lękliwy | : (przym.) pierzchliwy | : (przym.) płochliwy
timidity : timidity : (rzecz.) bojaźliwość | : (rzecz.) nieśmiałość
timidly : timidly : (przysł.) bojaźliwie | : (przysł.) nieśmiało
timing : timing : (rzecz.) chronometraż | : (rzecz.) synchronizacja | : (rzecz.) wyczucie
timorous : timorous : (przym.) bojaźliwy | : (przym.) lękliwy
timothy : timothy : (rzecz.) brzanka
tin : tin : (czas.) bielić | : (czas.) cynować | : (czas.) konserwować | : (czas.) pobielać | : (czas.) puszkować | : (rzecz.) blacha | : (rzecz.) blaszanka | : (rzecz.) cyna | : (rzecz.) puszka
tin-opener : tin-opener : (rzecz.) otwieracz
tin-plate : tin-plate : (czas.) ocynować
tin-stone : tin-stone : (rzecz.) kasyteryt
tincture : tincture : (rzecz.) domieszka | : (rzecz.) nalewka | : (rzecz.) odcień | : (rzecz.) odrobina | : (rzecz.) roztwór | : (rzecz.) tynktura | : (rzecz.) wyciąg | : (rzecz.) zabarwienie
tinder : tinder : (rzecz.) hubka | : (rzecz.) podpałka
tine : tine : (rzecz.) ząb
tinfoil : tinfoil : (rzecz.) cynfolia | : (rzecz.) staniol
ting : ting : (czas.) brzęczeć | : (czas.) dzwonić | : (czas.) wić | : (rzecz.) brzęczenie
tinge : tinge : (czas.) cieniować | : (czas.) zabarwiać | : (rzecz.) domieszka | : (rzecz.) odcień | : (rzecz.) posmak | : (rzecz.) zabarwienie
tingle : tingle : (czas.) brzęczeć | : (czas.) dźwięczeć | : (czas.) kłuć | : (czas.) mrowić | : (czas.) swędzić | : (czas.) świerzbić | : (rzecz.) brzęk | : (rzecz.) dźwięczenie | : (rzecz.) kłucie | : (rzecz.) mrowienie | : (rzecz.) swędzenie
tingled : tingled : (przym.) dźwięczny
tingling : tingling : (rzecz.) dźwięczenie | : (rzecz.) mrowienie
tinker : tinker : (czas.) dłubać | : (czas.) majsterkować | : (czas.) majstrować | : (czas.) podłubać | : (rzecz.) dłubanie | : (rzecz.) druciarz | : (rzecz.) majstrowanie | : (rzecz.) naprawiacz
tinkle : tinkle : (czas.) brzęczeć | : (czas.) dźwięczeć | : (czas.) dzwonić | : (rzecz.) brzęczenie | : (rzecz.) brzęk | : (rzecz.) dźwięczenie | : (rzecz.) dzwonienie
tinned : tinned : (przym.) cynowany | : (przym.) konserwowy
tinny : tinny : (przym.) blaszany | : (przym.) bublowaty | : (przym.) cynowy | : (przym.) marny | : (przym.) partacki
tinsel : tinsel : (rzecz.) błyskotka | : (rzecz.) błyskotki | : (rzecz.) lameta | : (rzecz.) świecidełko | : (rzecz.) szych
tinsmith : tinsmith : (rzecz.) blacharz
tint : tint : (czas.) cieniować | : (czas.) podbarwiać | : (czas.) zabarwiać | : (czas.) zabarwić | : (rzecz.) barwa | : (rzecz.) farbowanie | : (rzecz.) odcień | : (rzecz.) zabarwienie
tinwork : tinwork : (rzecz.) blacharstwo
tiny : tiny : (przym.) drobny
tip : tip : (czas.) dać | : (czas.) przechylać | : (czas.) przechylić | : (czas.) skinąć | : (czas.) tknąć | : (czas.) trącać | : (czas.) wysypać | : (czas.) zganić | : (rzecz.) aluzja | : (rzecz.) czubek | : (rzecz.) grot | : (rzecz.) koniec | : (rzecz.) napiwek | : (rzecz.) porada | : (rzecz.) rada | : (rzecz.) szpic | : (rzecz.) wskazówka
tip-car : tip-car : (rzecz.) wywrotka
tip-lorry : tip-lorry : (rzecz.) wywrotka
tip-top : tip-top : (przym.) pierwszorzędny | : (przym.) znakomity
tip-truck : tip-truck : (rzecz.) wagonetka
tipi : tipi : (rzecz.) koniec | : (rzecz.) okucie | : (rzecz.) skuwka | : (rzecz.) szczyt
tipper : tipper : (rzecz.) wywrót | : (rzecz.) wywrotka | : (rzecz.) wywrotnica
tippet : tippet : (rzecz.) kołnierz | : (rzecz.) pelerynka
tipple : tipple : (czas.) popić
tippler : tippler : (rzecz.) wywrót | : (rzecz.) wywrotnica
tipsy : tipsy : (przym.) oszołomiony | : (przym.) pijany
tiptop : tiptop : (przym.) doskonały | : (przym.) pierwszorzędny | : (przym.) znakomity | : (rzecz.) szczyt
tirade : tirade : (rzecz.) tyrada
tire : tire : (czas.) męczyć | : (czas.) nużyć | : (czas.) wyczerpać | : (czas.) zagnać | : (czas.) zmęczyć | : (czas.) zmitrężyć | : (czas.) zmordować | : (rzecz.) nużyca | : (rzecz.) obręcz | : (rzecz.) opona | : (rzecz.) zmęczenie
tired : tired : (przym.) zmęczony
tiredness : tiredness : (rzecz.) zmęczenie | : (rzecz.) znudzenie
tireless : tireless : (przym.) niezmordowany
tiresome : tiresome : (przym.) dokuczliwy | : (przym.) męczący | : (przym.) nieznośny | : (przym.) nudny
tiresomely : tiresomely : (przysł.) mozolnie
tiring : tiring : (przym.) męczący
tissue : tissue : (rzecz.) bibułka | : (rzecz.) siatka | : (rzecz.) tkanina | : (rzecz.) tkanka
tissue-paper : tissue-paper : (rzecz.) bibułka
tit : tit : (rzecz.) cycek | : (rzecz.) dureń | : (rzecz.) inkrustacja | : (rzecz.) maleństwo | : (rzecz.) sikora | : (rzecz.) sikorka | : (rzecz.) sutek
titan : titan : (rzecz.) gigant | : (rzecz.) olbrzym | : (rzecz.) tytan
titanic : titanic : (przym.) monumentalny | : (przym.) tytaniczny | : (przym.) tytanowy
titanium : titanium : (rzecz.) tytan
titbit : titbit : (rzecz.) przysmak | : (rzecz.) smakołyk
tithe : tithe : (rzecz.) dziesięcina
titillate : titillate : (czas.) łaskotać | : (czas.) łechtać
titillation : titillation : (rzecz.) łechtanie | : (rzecz.) podniecenie
titivation : titivation : (rzecz.) upiększenie
title : title : (czas.) tytułować | : (rzecz.) krzta | : (rzecz.) napis | : (rzecz.) prawo | : (rzecz.) przywilej | : (rzecz.) tytuł | : (rzecz.) tytułowanie | : (rzecz.) uprawnienie
titled : titled : (przym.) zatytułowany
titling : titling : (rzecz.) tytułowanie
titmouse : titmouse : (rzecz.) sikora | : (rzecz.) sikorka
titrate : titrate : (czas.) miareczkować
titration : titration : (rzecz.) miareczkowanie
titre : titre : (rzecz.) miano | : (rzecz.) titr
titter : titter : (czas.) chichotać | : (rzecz.) chichot | : (rzecz.) chichotanie
tittle-tattle : tittle-tattle : (rzecz.) gadanina | : (rzecz.) plotkowanie
titular : titular : (przym.) tytularny
tizzy : tizzy : (rzecz.) drżączka | : (rzecz.) zdenerwowanie | : (rzecz.) zmartwienie
to : to : (przyim.) do | : (przyim.) ku | : (przyim.) po | : (przyim.) przy | : (przyim.) w | : (przyim.) według | : (przyim.) wobec | : (przyim.) za
to-do : to-do : (rzecz.) hałas | : (rzecz.) krzątanina | : (rzecz.) zamieszanie
to-fall : to-fall : (rzecz.) schyłek
to-name : to-name : (rzecz.) przydomek
toad : toad : (rzecz.) ropucha
toadstool : toadstool : (rzecz.) muchomor
toady : toady : (czas.) pochlebiać | : (rzecz.) lizus | : (rzecz.) pochlebca
toadyism : toadyism : (rzecz.) podlizywanie | : (rzecz.) przypochlebianie
toast : toast : (czas.) opiekać | : (czas.) przypiekać | : (rzecz.) grzanka | : (rzecz.) toast | : (rzecz.) tost
toaster : toaster : (rzecz.) opiekacz | : (rzecz.) przyrząd | : (rzecz.) toster
toasty : toasty : (przym.) ciepły
tobacco : tobacco : (rzecz.) tytoń
tobacco-plant : tobacco-plant : (rzecz.) tytoń
tobacco-pouch : tobacco-pouch : (rzecz.) kapciuch
toboggan : toboggan : (rzecz.) saneczki | : (rzecz.) tobogan
tocsin : tocsin : (rzecz.) alarm
today : today : (przysł.) dziś | : (przysł.) dzisiaj
toddle : toddle : (czas.) chwiać | : (czas.) dreptać | : (czas.) drobić | : (czas.) przechadzać | : (rzecz.) dreptanie
toddler : toddler : (rzecz.) berbeć | : (rzecz.) dziecko | : (rzecz.) kajtek | : (rzecz.) maluch | : (rzecz.) szkrab
toe : toe : (rzecz.) czop | : (rzecz.) palec | : (rzecz.) paluch
toe-cap : toe-cap : (rzecz.) kapka
toecap : toecap : (rzecz.) kapka
toehold : toehold : (rzecz.) odskocznia
toenail : toenail : (rzecz.) paznokieć
toffee : toffee : (rzecz.) irys
tog : tog : (czas.) wystrajać | : (czas.) wystroić
toga : toga : (rzecz.) toga
together : together : (przysł.) łącznie | : (przysł.) pospołu | : (przysł.) razem | : (przysł.) wespół | : (przysł.) wspólnie
togetherness : togetherness : (rzecz.) więź | : (rzecz.) wspólnota
toggle : toggle : (rzecz.) kołek | : (rzecz.) przerzutnik | : (rzecz.) przetyczka
toil : toil : (czas.) harować | : (czas.) męczyć | : (czas.) natrudzić | : (czas.) trudzić | : (rzecz.) harówka | : (rzecz.) krwawica | : (rzecz.) mordęga | : (rzecz.) mozół | : (rzecz.) myto | : (rzecz.) trud | : (rzecz.) znój
toile : toile : (przym.) toaletowy
toilet : toilet : (rzecz.) klozet | : (rzecz.) sedes | : (rzecz.) toaleta | : (rzecz.) ubikacja | : (rzecz.) ustęp | : (rzecz.) wygódka
toilette : toilette : (rzecz.) toaleta
toiling : toiling : (rzecz.) harowanie
toilsome : toilsome : (przym.) mozolny | : (przym.) pracochłonny
tokay : tokay : (rzecz.) tokaj
token : token : (rzecz.) leksem | : (rzecz.) oznaka | : (rzecz.) pamiątka | : (rzecz.) żeton | : (rzecz.) znak | : (rzecz.) znamię
tolerable : tolerable : (przym.) możliwy | : (przym.) znośny
tolerably : tolerably : (przysł.) możliwie | : (przysł.) znośnie
tolerance : tolerance : (rzecz.) odporność | : (rzecz.) pobłażanie | : (rzecz.) pobłażliwość | : (rzecz.) tolerancja | : (rzecz.) tolerowanie
tolerant : tolerant : (przym.) odporny | : (przym.) pobłażliwy | : (przym.) tolerancyjny
tolerantly : tolerantly : (przysł.) pobłażliwie | : (przysł.) tolerancyjnie
tolerate : tolerate : (czas.) cierpieć | : (czas.) tolerować | : (czas.) znosić
toleration : toleration : (rzecz.) tolerancja
toll : toll : (czas.) bić | : (czas.) dzwonić | : (rzecz.) cło | : (rzecz.) dzwonienie | : (rzecz.) mycie | : (rzecz.) myto | : (rzecz.) opłata | : (rzecz.) przyznanie
toll-bar : toll-bar : (rzecz.) rogatka | : (rzecz.) szlaban
tollgate : tollgate : (rzecz.) bramka | : (rzecz.) szlaban
tollhouse : tollhouse : (rzecz.) rogatka
toluene : toluene : (rzecz.) metylobenzen | : (rzecz.) toluen
tom : tom : (rzecz.) samiec
tom-cat : tom-cat : (rzecz.) kocur
tomahawk : tomahawk : (czas.) uderzyć | : (czas.) zabić | : (czas.) zabijać | : (rzecz.) tomahawk | : (rzecz.) toporek
tomato : tomato : (rzecz.) pomidor
tomb : tomb : (rzecz.) grób | : (rzecz.) grobowiec | : (rzecz.) mogiła | : (rzecz.) nagrobek
tomboy : tomboy : (rzecz.) chłopczyca | : (rzecz.) urwis
tombstone : tombstone : (rzecz.) nagrobek
tomcat : tomcat : (rzecz.) kocur
tome : tome : (rzecz.) księga | : (rzecz.) wolumin
tomfool : tomfool : (rzecz.) błazen
tomfoolery : tomfoolery : (rzecz.) błazeństwo | : (rzecz.) wygłup
tomography : tomography : (rzecz.) tomografia
tomorrow : tomorrow : (rzecz.) jutro
tomtit : tomtit : (rzecz.) sikora | : (rzecz.) strzyżyk
ton : ton : (rzecz.) kupa | : (rzecz.) tona
ton-force : ton-force : (rzecz.) tona-siła
tonal : tonal : (przym.) tonalny | : (przym.) toniczny | : (przym.) tonowy
tonality : tonality : (rzecz.) tonalność
tone : tone : (czas.) nastrajać | : (czas.) stroić | : (czas.) tonować | : (rzecz.) barwa | : (rzecz.) brzmienie | : (rzecz.) dźwięk | : (rzecz.) odcień | : (rzecz.) sygnał | : (rzecz.) ton | : (rzecz.) tonacja | : (rzecz.) zabarwienie
tone-arm : tone-arm : (rzecz.) ramię
toneless : toneless : (przym.) bezbarwny | : (przym.) bezduszny | : (przym.) mdły
tonelessly : tonelessly : (przysł.) bezbarwnie
toner : toner : (rzecz.) toner
tong : tong : (czas.) chwytać | : (rzecz.) kleszcze | : (rzecz.) obcęgi
tongs : tongs : (rzecz.) cęgi | : (rzecz.) kleszcze | : (rzecz.) obcążki | : (rzecz.) obcęgi | : (rzecz.) szczypce
tongue : tongue : (rzecz.) jęzor | : (rzecz.) język | : (rzecz.) mowa | : (rzecz.) ozór | : (rzecz.) ozorek | : (rzecz.) pióro | : (rzecz.) wymowa | : (rzecz.) wypust | : (rzecz.) występ
tonic : tonic : (przym.) toniczny | : (przym.) wzmacniający | : (rzecz.) tonik | : (rzecz.) tonika
tonics : tonics : (rzecz.) tonika
toning : toning : (rzecz.) tonowanie | : (rzecz.) zabarwianie
tonnage : tonnage : (rzecz.) pojemność | : (rzecz.) tonaż
tonne : tonne : (rzecz.) tona
tonnes : tonnes : (rzecz.) ton | : (rzecz.) toń
tonsil : tonsil : (rzecz.) migdał | : (rzecz.) migdałek
tonsure : tonsure : (rzecz.) tonsura
too : too : (przysł.) bardzo | : (przysł.) doprawdy | : (przysł.) nadto | : (przysł.) nazbyt | : (przysł.) także | : (przysł.) też | : (przysł.) wielce | : (przysł.) zanadto
too-too : too-too : (przym.) wylewny
took : took : (czas.) podejmować
tool : tool : (rzecz.) instrument | : (rzecz.) narzędzie | : (rzecz.) narzędziownia
tool-room : tool-room : (rzecz.) narzędziownia
toolbox : toolbox : (rzecz.) narzędzia | : (rzecz.) przybornik
tooled : tooled : (przym.) narzędziowy
tooling : tooling : (rzecz.) oprzyrządowania
toolmaker : toolmaker : (rzecz.) narzędziowiec
toot : toot : (czas.) tokować | : (czas.) trąbić | : (czas.) zagwizdać | : (czas.) zatrąbić | : (rzecz.) klaksonu | : (rzecz.) trąbienie
tooth : tooth : (rzecz.) kieł | : (rzecz.) ząb
toothless : toothless : (przym.) bezsilny
toothpick : toothpick : (rzecz.) wykałaczka
toothsome : toothsome : (przym.) apetyczny | : (przym.) smaczny
top : top : (czas.) przewyższać | : (przym.) górny | : (przym.) szczytowy | : (rzecz.) bąk | : (rzecz.) czubek | : (rzecz.) góra | : (rzecz.) nakrętka | : (rzecz.) powierzchnia | : (rzecz.) punkt | : (rzecz.) szczyt | : (rzecz.) top | : (rzecz.) wieczko | : (rzecz.) wierzch | : (rzecz.) wierzchołek | : (rzecz.) zabawka
top-down : top-down : (przym.) odgórny | : (przym.) wsteczny | : (przym.) zstępujący
top-heavy : top-heavy : (przym.) wywrotny
top-league : top-league : (rzecz.) ekstraklasa
top-notch : top-notch : (przym.) pierwszorzędny
topaz : topaz : (rzecz.) topaz
topcoat : topcoat : (rzecz.) palto | : (rzecz.) płaszcz
tope : tope : (czas.) pić
toper : toper : (rzecz.) pijak
topgallant : topgallant : (rzecz.) bramsel | : (rzecz.) bramżagiel
topiary : topiary : (rzecz.) sztuka
topic : topic : (rzecz.) problematyka | : (rzecz.) przedmiot | : (rzecz.) temat | : (rzecz.) tematyka | : (rzecz.) wątek
topical : topical : (przym.) aktualny | : (przym.) miejscowy | : (przym.) przedmiotowy
topicality : topicality : (rzecz.) aktualność | : (rzecz.) tematyczność
topically : topically : (przysł.) aktualnie | : (przysł.) tematycznie
topknot : topknot : (rzecz.) kok | : (rzecz.) kokardka
topmast : topmast : (rzecz.) stenga
topmost : topmost : (przym.) najwyższy
topographer : topographer : (rzecz.) topograf
topographic : topographic : (przym.) topograficzny
topographical : topographical : (przym.) topograficzny
topographically : topographically : (przysł.) topograficznie
topography : topography : (rzecz.) terenoznawstwo | : (rzecz.) topografia
topological : topological : (przym.) topologiczny
topology : topology : (rzecz.) konfiguracja | : (rzecz.) topologia
topper : topper : (rzecz.) cylinder
topping : topping : (przym.) wdechowy | : (przym.) wybitny | : (przym.) wytworny
topping-up : topping-up : (rzecz.) casting | : (rzecz.) uzupełnianie
topple : topple : (czas.) powalać | : (czas.) powalić | : (czas.) przewalać | : (czas.) przewracać | : (czas.) zwalać | : (czas.) zwalić
topsail : topsail : (rzecz.) marsel | : (rzecz.) topsel | : (rzecz.) żagiel
toque : toque : (rzecz.) toczek
torch : torch : (rzecz.) latarka | : (rzecz.) palnik | : (rzecz.) pochodnia | : (rzecz.) znicz
toreador : toreador : (rzecz.) toreador
torment : torment : (czas.) dręczyć | : (czas.) katować | : (czas.) męczyć | : (czas.) namęczyć | : (czas.) nękać | : (czas.) pastwić | : (czas.) srożyć | : (czas.) udręczyć | : (czas.) zadręczać | : (rzecz.) kaźń | : (rzecz.) męczarnia | : (rzecz.) męczenie | : (rzecz.) męka | : (rzecz.) udręczenie | : (rzecz.) udręka
tormentor : tormentor : (rzecz.) dręczyciel | : (rzecz.) okrutnik | : (rzecz.) stręczyciel
tornado : tornado : (rzecz.) cyklon | : (rzecz.) tornado
torpedo : torpedo : (czas.) torpedować | : (czas.) wysadzać | : (rzecz.) mina | : (rzecz.) torpeda
torpedo-boat : torpedo-boat : (rzecz.) torpedowiec
torpid : torpid : (przym.) apatyczny | : (przym.) skamieniały | : (przym.) zesztywniały
torpidity : torpidity : (rzecz.) bezwład | : (rzecz.) bezwolność | : (rzecz.) niemrawość | : (rzecz.) odrętwienie | : (rzecz.) zesztywnienie
torpor : torpor : (rzecz.) marazm | : (rzecz.) odrętwienie | : (rzecz.) zesztywnienie
torque : torque : (rzecz.) naszyjnik
torrent : torrent : (rzecz.) potok | : (rzecz.) ulewa
torrential : torrential : (przym.) rzęsisty | : (przym.) ulewny | : (przym.) wartki
torrid : torrid : (przym.) palący | : (przym.) skwarny | : (przym.) suchy | : (przym.) upalny | : (przym.) wypalony
torsion : torsion : (rzecz.) skręcanie | : (rzecz.) skręcenie | : (rzecz.) skręt
torso : torso : (rzecz.) tors | : (rzecz.) tułów
tort : tort : (rzecz.) delikt
tortoise : tortoise : (rzecz.) żółw
tortoiseshell : tortoiseshell : (rzecz.) szylkret
tortuous : tortuous : (przym.) kręty | : (przym.) pokrętny | : (przym.) wężykowaty | : (przym.) wijący | : (przym.) wykrętny | : (przym.) zawiły
torture : torture : (czas.) katować | : (czas.) męczyć | : (czas.) pomęczyć | : (czas.) torturować | : (rzecz.) katusza | : (rzecz.) kaźń | : (rzecz.) męczarnia | : (rzecz.) męka | : (rzecz.) tortura | : (rzecz.) torturowanie | : (rzecz.) męczarnia
torturer : torturer : (rzecz.) dręczyciel | : (rzecz.) oprawca
toss : toss : (czas.) bałwanić | : (czas.) chwiać | : (czas.) kołysać | : (czas.) miotać | : (czas.) obracać | : (czas.) odrzucać | : (czas.) podrzucać | : (czas.) podrzucić | : (czas.) potrząsać | : (czas.) przewracać | : (czas.) rozkołysać | : (czas.) rzucać | : (czas.) trząść | : (czas.) wiercić | : (rzecz.) podrzucanie | : (rzecz.) podrzucenie | : (rzecz.) podrzut | : (rzecz.) rzut | : (rzecz.) wstrząs | : (rzecz.) zaniepokojenie
tot : tot : (rzecz.) brzdąc | : (rzecz.) dziecko | : (rzecz.) kropelka | : (rzecz.) szkrab
total : total : (czas.) sumować | : (czas.) zsumować | : (przym.) całkowity | : (przym.) całościowy | : (przym.) kompletny | : (przym.) łączny | : (przym.) ogólny | : (przym.) sumaryczny | : (przym.) totalny | : (przym.) zupełny | : (rzecz.) całość | : (rzecz.) suma | : (rzecz.) sumarycznie
totalitarian : totalitarian : (przym.) totalitarny
totalitarianism : totalitarianism : (rzecz.) totalitaryzm | : (rzecz.) totalizm
totality : totality : (rzecz.) całkowitość | : (rzecz.) całość | : (rzecz.) ogół | : (rzecz.) suma | : (rzecz.) totalność
totalize : totalize : (czas.) sumować | : (czas.) zsumować
totally : totally : (przysł.) całkowicie | : (przysł.) totalnie
tote : tote : (czas.) taszczyć
totter : totter : (czas.) chwiać | : (czas.) trząść | : (czas.) zataczać
tottering : tottering : (przym.) chwiejny
tottery : tottery : (przym.) niepewny
toucan : toucan : (rzecz.) tukan
touch : touch : (czas.) dotknąć | : (czas.) dotykać | : (czas.) otrzymać | : (czas.) pomacać | : (czas.) poruszyć | : (czas.) ruszać | : (czas.) tykać | : (czas.) wzruszać | : (czas.) wzruszyć | : (czas.) zarysować | : (rzecz.) dotknięcie | : (rzecz.) dotyk | : (rzecz.) kontakt | : (rzecz.) zmysł
touchable : touchable : (przym.) osiągalny
touchdown : touchdown : (rzecz.) przyłożenie | : (rzecz.) przyziemie
touched : touched : (przym.) wzruszony
touchiness : touchiness : (rzecz.) drażliwość | : (rzecz.) obraźliwość | : (rzecz.) przewrażliwienie
touching : touching : (przym.) wzruszający
touchstone : touchstone : (rzecz.) probierz
touchwood : touchwood : (rzecz.) hubka | : (rzecz.) próchno
touchy : touchy : (przym.) drażliwy
tough : tough : (przym.) bezwzględny | : (przym.) łykowaty | : (przym.) mocny | : (przym.) oporny | : (przym.) surowy | : (przym.) tęgi | : (przym.) trudny | : (przym.) twardy
toughen : toughen : (czas.) hartować | : (czas.) utwardzać | : (czas.) utwardzić
toughie : toughie : (rzecz.) twardziel
toughly : toughly : (przysł.) mocno | : (przysł.) twardo
toughness : toughness : (rzecz.) bezwzględność | : (rzecz.) hart | : (rzecz.) twardość
toupee : toupee : (rzecz.) peruka
tour : tour : (czas.) jeździć | : (czas.) objeżdżać | : (czas.) zwiedzać | : (rzecz.) kolejność | : (rzecz.) objazd | : (rzecz.) podróż | : (rzecz.) przesunięcie | : (rzecz.) tura | : (rzecz.) wycieczka | : (rzecz.) zwiedzanie
touring : touring : (rzecz.) objazd | : (rzecz.) zwiedzanie
tourism : tourism : (rzecz.) turystyka
tourist : tourist : (rzecz.) turysta
tourmaline : tourmaline : (rzecz.) turmalin
tournament : tournament : (rzecz.) turniej | : (rzecz.) zawody
tourney : tourney : (rzecz.) turniej
tourniquet : tourniquet : (rzecz.) krępulec
tousle : tousle : (czas.) czochrać | : (czas.) pokudłać | : (czas.) potargać | : (czas.) tarmosić | : (czas.) zmierzwić
tout : tout : (czas.) kaptować | : (czas.) nagabywać | : (czas.) skaptować | : (rzecz.) naganiacz
tow : tow : (czas.) holować | : (czas.) przyholować | : (rzecz.) hol | : (rzecz.) holownik | : (rzecz.) pakuły
tow-boat : tow-boat : (rzecz.) holownik
tow-net : tow-net : (rzecz.) włok | : (rzecz.) włók
towage : towage : (rzecz.) holowanie
toward : toward : (przyim.) ku | : (przyim.) wobec | : (przysł.) około
towards : towards : (przyim.) ku | : (przyim.) względem
towboat : towboat : (rzecz.) holownik | : (rzecz.) pchacz
towel : towel : (rzecz.) ręcznik
towelling : towelling : (rzecz.) lanie
tower : tower : (czas.) wznosić | : (rzecz.) baszta | : (rzecz.) kolumna | : (rzecz.) piętrzenie | : (rzecz.) twierdza | : (rzecz.) wieża | : (rzecz.) wzniesienie
towering : towering : (przym.) niebotyczny | : (przym.) wysoki
town : town : (rzecz.) gród | : (rzecz.) miasteczko | : (rzecz.) miasto
town-planner : town-planner : (rzecz.) urbanista
town-planning : town-planning : (rzecz.) urbanistyka
township : township : (rzecz.) okrąg | : (rzecz.) okręg
townsman : townsman : (rzecz.) mieszczanin | : (rzecz.) mieszczuch | : (rzecz.) radca
townswoman : townswoman : (rzecz.) mieszczka
towrope : towrope : (rzecz.) hol
toxic : toxic : (przym.) toksyczny | : (przym.) trujący
toxicity : toxicity : (rzecz.) toksyczność
toxicological : toxicological : (przym.) toksykologiczny
toxicologist : toxicologist : (rzecz.) toksykolog
toxicology : toxicology : (rzecz.) toksykologia
toxin : toxin : (rzecz.) toksyna
toy : toy : (czas.) bawić | : (czas.) igrać | : (przym.) zabawkarski | : (przym.) zabawkowy | : (rzecz.) zabawka
trace : trace : (czas.) kalkować | : (czas.) kreślić | : (czas.) naznaczyć | : (czas.) odnaleźć | : (czas.) odszukać | : (czas.) śledzić | : (czas.) szkicować | : (czas.) trasować | : (rzecz.) naleciałość | : (rzecz.) odciśnięcie | : (rzecz.) odrobina | : (rzecz.) poszlaka | : (rzecz.) pozostałość | : (rzecz.) ślad | : (rzecz.) trop
traceability : traceability : (rzecz.) identyfikacja
traceable : traceable : (przym.) wykrywalny
tracer : tracer : (rzecz.) kreślarz | : (rzecz.) smugacz | : (rzecz.) tropiciel | : (rzecz.) wskaźnik
tracery : tracery : (rzecz.) maswerk
trachea : trachea : (rzecz.) przetchlinka | : (rzecz.) tchawica
tracheotomy : tracheotomy : (rzecz.) tracheotomia
trachoma : trachoma : (rzecz.) jaglica
tracing : tracing : (rzecz.) kalka | : (rzecz.) kalkowanie | : (rzecz.) śledzenie | : (rzecz.) trasowanie | : (rzecz.) tropienie
track : track : (czas.) namierzać | : (czas.) namierzyć | : (czas.) prześledzić | : (czas.) śledzić | : (czas.) tropić | : (czas.) wyśledzić | : (czas.) wytropić | : (rzecz.) bieżnia | : (rzecz.) droga | : (rzecz.) jazda | : (rzecz.) ścieżka | : (rzecz.) ślad | : (rzecz.) śledź | : (rzecz.) śledzenie | : (rzecz.) szlak | : (rzecz.) tor | : (rzecz.) torowisko | : (rzecz.) trakt | : (rzecz.) trop | : (rzecz.) utwór | : (rzecz.) wielobój | : (rzecz.) wyśledzenie
track-athletics : track-athletics : (rzecz.) trójbój
track-suit : track-suit : (rzecz.) dres
track-way : track-way : (rzecz.) torowisko
trackball : trackball : (rzecz.) trackball
tracker : tracker : (rzecz.) abstrakt | : (rzecz.) szperacz | : (rzecz.) tropiciel
trackless : trackless : (przym.) bezdrożny | : (przym.) bezszynowy
tracks : tracks : (rzecz.) tory | : (rzecz.) trop
tracksuit : tracksuit : (rzecz.) dres
tract : tract : (rzecz.) obszar | : (rzecz.) połać | : (rzecz.) przebieg | : (rzecz.) przestrzeń | : (rzecz.) rozprawa | : (rzecz.) trakt | : (rzecz.) traktat
tractability : tractability : (rzecz.) ustępliwość
tractable : tractable : (przym.) łatwy | : (przym.) pojednawczy | : (przym.) posłuszny
tractate : tractate : (rzecz.) traktat
traction : traction : (rzecz.) trakcja
traction-engine : traction-engine : (rzecz.) ciągnik | : (rzecz.) traktor
tractor : tractor : (rzecz.) ciągnik | : (rzecz.) traktor
trade : trade : (czas.) frymarczyć | : (czas.) handlować | : (czas.) sprzedawać | : (rzecz.) branża | : (rzecz.) fach | : (rzecz.) handel | : (rzecz.) handlarstwo | : (rzecz.) interes | : (rzecz.) proceder | : (rzecz.) rzemiosło | : (rzecz.) sektor | : (rzecz.) wymiana | : (rzecz.) zajęcie | : (rzecz.) zawód
trade-off : trade-off : (rzecz.) kompromis
trade-unionist : trade-unionist : (rzecz.) związkowiec
trader : trader : (rzecz.) handlarz | : (rzecz.) handlowiec | : (rzecz.) kupiec | : (rzecz.) przedsiębiorca
tradesman : tradesman : (rzecz.) dostawca | : (rzecz.) handlowiec | : (rzecz.) kupiec
trading : trading : (przym.) handlarski | : (rzecz.) handel | : (rzecz.) handlowanie
tradition : tradition : (rzecz.) tradycja
traditional : traditional : (przym.) tradycyjny
traditionalism : traditionalism : (rzecz.) tradycjonalizm
traditionalist : traditionalist : (rzecz.) tradycjonalista
traditionally : traditionally : (przysł.) tradycyjnie
traduce : traduce : (czas.) oczerniać
traffic : traffic : (czas.) handlować | : (czas.) kupczyć | : (czas.) przeszachrować | : (rzecz.) handel | : (rzecz.) komunikacja | : (rzecz.) ruch
trafficker : trafficker : (rzecz.) handlarz
tragedian : tragedian : (rzecz.) tragediopisarz | : (rzecz.) tragik
tragedy : tragedy : (rzecz.) tragedia | : (rzecz.) tragizm
tragic : tragic : (przym.) tragiczny
tragically : tragically : (przysł.) tragicznie
tragicomedy : tragicomedy : (rzecz.) tragikomedia
tragicomic : tragicomic : (przym.) tragikomiczny
trail : trail : (czas.) tropić | : (rzecz.) droga | : (rzecz.) podstawa | : (rzecz.) ścieżka | : (rzecz.) ślad | : (rzecz.) smuga | : (rzecz.) szlak | : (rzecz.) trop
trailer : trailer : (rzecz.) doczepka | : (rzecz.) jaszcz | : (rzecz.) naczepa | : (rzecz.) przyczepa | : (rzecz.) przyczepka | : (rzecz.) tropiciel | : (rzecz.) zwiastun
train : train : (czas.) ćwiczyć | : (czas.) doskonalić | : (czas.) kształcić | : (czas.) przeszkolić | : (czas.) szkolić | : (czas.) trenować | : (czas.) tresować | : (czas.) uczyć | : (czas.) wyćwiczyć | : (czas.) wyszkolić | : (czas.) wytrenować | : (rzecz.) kolejka | : (rzecz.) orszak | : (rzecz.) pociąg | : (rzecz.) sznur | : (rzecz.) tren | : (rzecz.) wątek
trainee : trainee : (rzecz.) aplikant | : (rzecz.) kursant | : (rzecz.) nowicjusz | : (rzecz.) praktykant | : (rzecz.) stażysta
trainer : trainer : (rzecz.) instruktor | : (rzecz.) szkoleniowiec | : (rzecz.) trener | : (rzecz.) treser | : (rzecz.) ujeżdżacz
training : training : (rzecz.) ćwiczenie | : (rzecz.) instruktaż | : (rzecz.) kształcenie | : (rzecz.) praktyka | : (rzecz.) przeszkolenie | : (rzecz.) staż | : (rzecz.) szkolenie | : (rzecz.) trening | : (rzecz.) trenowanie | : (rzecz.) tresowanie | : (rzecz.) tresura | : (rzecz.) wyszkolenie | : (rzecz.) wytrenowanie
traipse : traipse : (czas.) łazić | : (czas.) włóczyć
trait : trait : (rzecz.) cecha | : (rzecz.) przymiot | : (rzecz.) rys | : (rzecz.) ryś | : (rzecz.) rysa
traitor : traitor : (rzecz.) odstępca | : (rzecz.) wiarołomca | : (rzecz.) zdrajca
traitorous : traitorous : (przym.) wiarołomny | : (przym.) zdradziecki
trajectory : trajectory : (rzecz.) tor | : (rzecz.) trajektoria | : (rzecz.) trasa
tram : tram : (rzecz.) tramwaj
tram-car : tram-car : (rzecz.) tramwaj
tramcar : tramcar : (rzecz.) tramwaj
trammel : trammel : (czas.) łapać | : (czas.) nastawiać | : (czas.) pętać | : (czas.) plątać | : (czas.) tamować | : (rzecz.) pęta | : (rzecz.) przeszkoda | : (rzecz.) sieć
tramp : tramp : (czas.) deptać | : (czas.) przemierzać | : (czas.) stąpać | : (czas.) wędrować | : (czas.) włóczyć | : (rzecz.) łazik | : (rzecz.) tramp | : (rzecz.) wędrowiec | : (rzecz.) wędrówka | : (rzecz.) włóczęga
trample : trample : (czas.) deptać | : (czas.) podeptać | : (czas.) rozdeptać | : (czas.) stratować | : (czas.) wygnieść | : (czas.) zdeptać | : (czas.) zgnieść
trampoline : trampoline : (rzecz.) batut | : (rzecz.) trampolina
tramway : tramway : (rzecz.) tramwaj
tramway-worker : tramway-worker : (rzecz.) tramwajarz
trance : trance : (rzecz.) hipnoza | : (rzecz.) trans | : (rzecz.) zachwyt
tranquil : tranquil : (przym.) cichy | : (przym.) spokojny
tranquilizer : tranquilizer : (rzecz.) flegmatyzator
tranquillity : tranquillity : (rzecz.) cisza | : (rzecz.) spokój
tranquillize : tranquillize : (czas.) uspokajać
trans-national : trans-national : (przym.) ponadnarodowy
trans-shipment : trans-shipment : (rzecz.) przeładunek
transact : transact : (czas.) doprowadzić | : (czas.) przeprowadzać | : (czas.) przeprowadzić | : (czas.) rokować | : (czas.) układać | : (czas.) ułożyć
transaction : transaction : (rzecz.) transakcja
transatlantic : transatlantic : (przym.) transatlantycki
transceiver : transceiver : (rzecz.) nadajnik-odbiornik
transcend : transcend : (czas.) przekraczać | : (czas.) wykraczać
transcendence : transcendence : (rzecz.) przestępność | : (rzecz.) transcendencja
transcendent : transcendent : (przym.) transcendentalny | : (przym.) transcendentny
transcendental : transcendental : (przym.) nadzmysłowy | : (przym.) przestępny | : (przym.) transcendentalny
transcendentalism : transcendentalism : (rzecz.) nadzmysłowość | : (rzecz.) transcendentalizm
transcendentalist : transcendentalist : (rzecz.) transcendentalista
transcontinental : transcontinental : (przym.) transkontynentalny
transcribe : transcribe : (czas.) kopiować | : (czas.) przepisywać | : (czas.) rozpisać | : (czas.) transkrybować
transcript : transcript : (rzecz.) kopia | : (rzecz.) odpis | : (rzecz.) transkrypcja | : (rzecz.) zapis
transcription : transcription : (rzecz.) kopia | : (rzecz.) nagranie | : (rzecz.) przepisanie | : (rzecz.) transkrypcja
transcripts : transcripts : (rzecz.) stenogram
transducer : transducer : (rzecz.) przetwornik
transept : transept : (rzecz.) transept
transfer : transfer : (czas.) odstąpić | : (czas.) przekazać | : (czas.) przełączać | : (czas.) przelewać | : (czas.) przenieść | : (czas.) przenosić | : (rzecz.) cesja | : (rzecz.) odstąpienie | : (rzecz.) przekaz | : (rzecz.) przekazanie | : (rzecz.) przekazywanie | : (rzecz.) przelew | : (rzecz.) przenieś | : (rzecz.) przeniesienie | : (rzecz.) przenoszenie | : (rzecz.) przewiezienie | : (rzecz.) transfer | : (rzecz.) uzgadnianie
transferability : transferability : (rzecz.) przenaszalność | : (rzecz.) przenośność
transferable : transferable : (przym.) przenośny | : (przym.) zbywalny
transferee : transferee : (rzecz.) cesjonariusz
transference : transference : (rzecz.) zrzucenie
transferor : transferor : (rzecz.) cedent
transfiguration : transfiguration : (rzecz.) konwersja | : (rzecz.) transfiguracja
transfigure : transfigure : (czas.) przekształcać | : (czas.) przekształcić
transfix : transfix : (czas.) przebić | : (czas.) przeszyć | : (czas.) sparaliżować | : (czas.) unieruchamiać | : (czas.) unieruchomić
transform : transform : (czas.) odmieniać | : (czas.) odmienić | : (czas.) przeistaczać | : (czas.) przekształcać | : (czas.) przekształcić | : (czas.) przemieniać | : (czas.) przemienić | : (czas.) przeobrazić | : (czas.) przerobić | : (czas.) przetransformować | : (czas.) przetwarzać | : (czas.) transformować
transformation : transformation : (rzecz.) przekształcenie | : (rzecz.) przemiana | : (rzecz.) przeobrażanie | : (rzecz.) przeobrażenie | : (rzecz.) przerodzenie | : (rzecz.) transformacja | : (rzecz.) zmiana
transformational : transformational : (przym.) przekształcalny
transformer : transformer : (rzecz.) transformator
transfuse : transfuse : (czas.) przelewać | : (czas.) przepacać | : (czas.) przepoić | : (czas.) przetaczać
transfusion : transfusion : (rzecz.) przetaczanie | : (rzecz.) przetoczenie | : (rzecz.) transfuzja
transgenic : transgenic : (przym.) transgeniczny
transgress : transgress : (czas.) naruszać | : (czas.) pogwałcić | : (czas.) przekraczać
transgression : transgression : (rzecz.) naruszenie | : (rzecz.) transgresja | : (rzecz.) uchybienie | : (rzecz.) wykroczenie
tranship : tranship : (czas.) przeładowywać
transhipment : transhipment : (rzecz.) przeładunek
transience : transience : (rzecz.) krótkotrwałość | : (rzecz.) przemijalność
transient : transient : (przym.) chwilowy | : (przym.) przejściowy | : (przym.) przelotny | : (przym.) przemijający | : (przym.) ulotny | : (rzecz.) małżeństwo | : (rzecz.) nieokreśloność
transiently : transiently : (przysł.) krótkotrwale
transistor : transistor : (rzecz.) tranzystor
transistorized : transistorized : (przym.) tranzystorowy
transit : transit : (rzecz.) przejazd | : (rzecz.) przewóz | : (rzecz.) tranzyt
transition : transition : (rzecz.) przechodzenie | : (rzecz.) przejście | : (rzecz.) przemiana | : (rzecz.) transformacja | : (rzecz.) zmiana
transitional : transitional : (przym.) pośredni | : (przym.) przechodni | : (przym.) przejściowy
transitive : transitive : (przym.) przechodni | : (przym.) tranzytywny
transitivity : transitivity : (rzecz.) przechodniość | : (rzecz.) tranzytywność
transitory : transitory : (przym.) efemeryczny | : (przym.) przejściowy
translatable : translatable : (przym.) przetłumaczalny
translate : translate : (czas.) przekładać | : (czas.) przekuć | : (czas.) przełożyć | : (czas.) przetłumaczyć | : (czas.) tłumaczyć
translation : translation : (rzecz.) przekład | : (rzecz.) przekładanie | : (rzecz.) przełożenie | : (rzecz.) tłumacz | : (rzecz.) tłumaczenie | : (rzecz.) trans | : (rzecz.) translacja
translational : translational : (przym.) tłumaczeniowy | : (przym.) translacyjny
translator : translator : (rzecz.) konwertor | : (rzecz.) tłumacz | : (rzecz.) translator
transliterate : transliterate : (czas.) transliterować
transliteration : transliteration : (rzecz.) transliteracja
translocation : translocation : (rzecz.) przemieszczenie | : (rzecz.) przenoszenie | : (rzecz.) translokacja
translucence : translucence : (rzecz.) przejrzystość
translucent : translucent : (przym.) półprzezroczysty | : (przym.) półprzeźroczysty
transmigrate : transmigrate : (czas.) przejeździć | : (czas.) przesiedlać
transmissible : transmissible : (przym.) przenośny
transmission : transmission : (rzecz.) emisja | : (rzecz.) manipulacja | : (rzecz.) nadawanie | : (rzecz.) pędnia | : (rzecz.) przekaz | : (rzecz.) przekazanie | : (rzecz.) przekazywanie | : (rzecz.) przekładnia | : (rzecz.) przesył | : (rzecz.) przesyłanie | : (rzecz.) rozgłaszanie | : (rzecz.) transmisja
transmit : transmit : (czas.) nadawać | : (czas.) przekazywać | : (czas.) przenosić | : (czas.) przepuszczać | : (czas.) transmitować
transmit-receive : transmit-receive : (rzecz.) nadawanie-odbiór
transmittal : transmittal : (rzecz.) przekazanie
transmittance : transmittance : (rzecz.) transmitancja
transmitter : transmitter : (rzecz.) nadajnik | : (rzecz.) przekaźnik
transmitter-receiver : transmitter-receiver : (rzecz.) nadajnik-odbiornik
transmutation : transmutation : (rzecz.) transmutacja
transmute : transmute : (czas.) przemieniać | : (czas.) przeobrażać | : (czas.) zmieniać
transoceanic : transoceanic : (przym.) transoceaniczny | : (przym.) zaoceaniczny
transom : transom : (rzecz.) pawęż | : (rzecz.) poprzecznica | : (rzecz.) szczeblina
transparency : transparency : (rzecz.) jawność | : (rzecz.) przejrzystość | : (rzecz.) przezrocze | : (rzecz.) przeźrocze | : (rzecz.) przezroczystość | : (rzecz.) przeźroczystość
transparent : transparent : (przym.) jawny | : (przym.) przejrzysty | : (przym.) przezroczysty | : (przym.) przeźroczysty
transparently : transparently : (przysł.) jasno | : (przysł.) przejrzyście
transpiration : transpiration : (rzecz.) parowanie | : (rzecz.) pocenie | : (rzecz.) transpiracja
transpire : transpire : (czas.) okazywać | : (czas.) parować | : (czas.) pocić | : (czas.) spocić | : (czas.) wychodzić | : (czas.) wydychać | : (czas.) wydzielać | : (czas.) zdarzać
transplant : transplant : (czas.) przeflancować | : (czas.) przenosić | : (czas.) przesadzać | : (czas.) przeszczepiać | : (czas.) przeszczepić
transplantation : transplantation : (rzecz.) flancowanie | : (rzecz.) przesadzanie | : (rzecz.) przesadzenie | : (rzecz.) przeszczepienie | : (rzecz.) transplantacja
transponder : transponder : (rzecz.) przekaźnik
transport : transport : (czas.) dowozić | : (czas.) podniecać | : (czas.) podniecić | : (czas.) porwać | : (czas.) porywać | : (czas.) przenosić | : (czas.) przesyłać | : (czas.) przetransportować | : (czas.) przewozić | : (czas.) transportować | : (czas.) zachwycać | : (czas.) zachwycić | : (rzecz.) komunikacja | : (rzecz.) przewóz | : (rzecz.) przywóz | : (rzecz.) transport
transportable : transportable : (przym.) przenośny | : (przym.) przewoźny
transportation : transportation : (rzecz.) deportacja | : (rzecz.) przewóz | : (rzecz.) transport | : (rzecz.) wywóz | : (rzecz.) wywózka | : (rzecz.) zwózka
transpose : transpose : (czas.) przestawiać | : (czas.) przestawić | : (czas.) przetransponować | : (czas.) transponować | : (czas.) zamieniać
transposing : transposing : (rzecz.) transponowanie
transposition : transposition : (rzecz.) metatonia | : (rzecz.) przeniesienie | : (rzecz.) przestawienie | : (rzecz.) transponowanie | : (rzecz.) transpozycja
transude : transude : (czas.) przesiąkać
transversal : transversal : (przym.) poprzeczny | : (przym.) transwersalny
transverse : transverse : (przym.) poprzeczny
transvestite : transvestite : (rzecz.) transwestyta
trap : trap : (rzecz.) matnia | : (rzecz.) płuczka | : (rzecz.) podstęp | : (rzecz.) potrzask | : (rzecz.) pułapka | : (rzecz.) sidło | : (rzecz.) trapienie | : (rzecz.) zapadnia | : (rzecz.) zasadzka
trapdoor : trapdoor : (rzecz.) drzwi | : (rzecz.) klapa | : (rzecz.) spustowe | : (rzecz.) zapadnia
trapeze : trapeze : (rzecz.) trapez
trapezium : trapezium : (rzecz.) trapez
trapezoid : trapezoid : (rzecz.) czworokąt | : (rzecz.) trapez
trapezoidal : trapezoidal : (przym.) trapezowy
trapezoids : trapezoids : (rzecz.) trapezoid
trapper : trapper : (rzecz.) traper
trappings : trappings : (rzecz.) czaprak
traps : traps : (rzecz.) manele
trash : trash : (rzecz.) bubel | : (rzecz.) bzdura | : (rzecz.) chała | : (rzecz.) dziadostwo | : (rzecz.) graty | : (rzecz.) nonsens | : (rzecz.) odpadki | : (rzecz.) śmiecenie | : (rzecz.) śmieci | : (rzecz.) śmietnik | : (rzecz.) szmira | : (rzecz.) tandeta | : (rzecz.) tanizna
trashy : trashy : (przym.) bublowaty | : (przym.) dziadowski | : (przym.) jarmarczny | : (przym.) lipny | : (przym.) szmirowaty | : (przym.) tandetny
trauma : trauma : (rzecz.) obrażenie | : (rzecz.) uraz
traumatic : traumatic : (przym.) pourazowy | : (przym.) przyranny | : (przym.) traumatyczny | : (przym.) urazowy
traumatism : traumatism : (rzecz.) urazowość
travail : travail : (rzecz.) męka | : (rzecz.) mozół
travel : travel : (czas.) jechać | : (czas.) jeździć | : (czas.) podróżować | : (czas.) ujechać | : (przym.) podróżniczy | : (rzecz.) podróż | : (rzecz.) podróżowanie | : (rzecz.) przesuw | : (rzecz.) wędrówka | : (rzecz.) wojaż
traveller : traveller : (rzecz.) komiwojażer | : (rzecz.) podróżnik | : (rzecz.) ślizgacz
travelling : travelling : (przym.) objazdowy | : (przym.) wędrowny | : (przym.) wyjazdowy | : (rzecz.) jazda | : (rzecz.) podróżowanie | : (rzecz.) przesuw
traversable : traversable : (przym.) kontrowersyjny
traversal : traversal : (rzecz.) przeglądanie
traverse : traverse : (czas.) krzyżować | : (czas.) przebrnąć | : (czas.) przechodzić | : (czas.) przecinać | : (czas.) przejeżdżać | : (czas.) trawersować | : (rzecz.) dosuw | : (rzecz.) poprzecznica | : (rzecz.) przesuw | : (rzecz.) trawers
travesty : travesty : (czas.) parodiować | : (czas.) sparodiować | : (czas.) trawestować | : (rzecz.) parodia | : (rzecz.) przekręcenie | : (rzecz.) trawestacja
trawl : trawl : (czas.) trałować | : (rzecz.) niewód | : (rzecz.) włok | : (rzecz.) włók
trawler : trawler : (rzecz.) trałowiec | : (rzecz.) trawler
tray : tray : (rzecz.) podajnik | : (rzecz.) taca | : (rzecz.) tacka | : (rzecz.) zasobnik
treacherous : treacherous : (przym.) perfidny | : (przym.) skrytobójczy | : (przym.) wiarołomny | : (przym.) zawodny | : (przym.) zdradliwy | : (przym.) zdradziecki
treacherously : treacherously : (przysł.) perfidnie
treachery : treachery : (rzecz.) perfidia | : (rzecz.) zdrada | : (rzecz.) zdradliwość
treacle : treacle : (rzecz.) melasa | : (rzecz.) syrop
treacly : treacly : (przym.) cukierkowy | : (przym.) melasowy
tread : tread : (czas.) deptać | : (czas.) kroczyć | : (czas.) stąpać | : (czas.) tratować | : (czas.) udeptać | : (czas.) udeptywać | : (rzecz.) bieżnik | : (rzecz.) chód | : (rzecz.) krocz | : (rzecz.) podnóżek | : (rzecz.) stopnica
treadle : treadle : (rzecz.) pedał
treadmill : treadmill : (rzecz.) bieżnia | : (rzecz.) kierat
treason : treason : (rzecz.) przestępstwo | : (rzecz.) zdrada
treasonable : treasonable : (przym.) wywrotowy
treasure : treasure : (czas.) cenić | : (czas.) gromadzić | : (czas.) pielęgnować | : (czas.) przechowywać | : (czas.) tezauryzować | : (rzecz.) krocie | : (rzecz.) skarb | : (rzecz.) skarbnica
treasurer : treasurer : (rzecz.) kasjer | : (rzecz.) podskarbi | : (rzecz.) skarbnik
treasury : treasury : (rzecz.) finanse | : (rzecz.) skarbiec | : (rzecz.) skarbnica
treat : treat : (czas.) częstować | : (czas.) fundować | : (czas.) gościć | : (czas.) kurować | : (czas.) leczyć | : (czas.) negocjować | : (czas.) oczyszczać | : (czas.) przyjmować | : (czas.) rozpatrywać | : (czas.) rozprawiać | : (czas.) traktować | : (czas.) umawiać | : (czas.) uważać | : (czas.) zafundować | : (rzecz.) pogróżka | : (rzecz.) uczta
treatable : treatable : (przym.) uleczalny
treated : treated : (czas.) traktować | : (czas.) uzdatnić
treatise : treatise : (rzecz.) rozprawa | : (rzecz.) traktat
treatment : treatment : (rzecz.) kuracja | : (rzecz.) leczenie | : (rzecz.) obchodzenie | : (rzecz.) obróbka | : (rzecz.) oczyszczalnia | : (rzecz.) przeróbka | : (rzecz.) traktowanie | : (rzecz.) uważanie | : (rzecz.) zabieg
treaty : treaty : (rzecz.) traktat | : (rzecz.) umowa
treble : treble : (czas.) potrajać | : (czas.) potroić | : (przym.) dyszkantowy | : (przym.) potrójny | : (przym.) troisty | : (przym.) trójdzielny | : (przym.) wiolinowy | : (rzecz.) dyszkant | : (rzecz.) sopran
tree : tree : (rzecz.) drewno | : (rzecz.) drzewko | : (rzecz.) drzewo
tree-trunk : tree-trunk : (rzecz.) pień
treeless : treeless : (przym.) bezdrzewny
treelike : treelike : (przym.) drzewiasty
trefoil : trefoil : (rzecz.) koniczyna | : (rzecz.) trójliść
trek : trek : (czas.) ciągnąć | : (czas.) podróżować | : (czas.) posuwać | : (rzecz.) podróż | : (rzecz.) wyprawa
trekker : trekker : (rzecz.) wędrownik
trellis : trellis : (rzecz.) krata | : (rzecz.) szpaler
tremble : tremble : (czas.) drgać | : (czas.) drżeć | : (czas.) dygotać | : (czas.) trząść | : (czas.) zadrżeć | : (rzecz.) drżenie
trembler : trembler : (rzecz.) brzęczyk
trembling : trembling : (czas.) zadygotać | : (rzecz.) drganie | : (rzecz.) drżenie
tremendous : tremendous : (przym.) ogromny | : (przym.) okropny | : (przym.) olbrzymi | : (przym.) potężny | : (przym.) straszliwy | : (przym.) straszny
tremor : tremor : (rzecz.) dreszcz | : (rzecz.) drganie | : (rzecz.) drżenie | : (rzecz.) wstrząs
tremulous : tremulous : (przym.) drżący | : (przym.) nerwowy
trench : trench : (rzecz.) okop | : (rzecz.) rów | : (rzecz.) transzeja | : (rzecz.) wykop
trench-coat : trench-coat : (rzecz.) trencz
trencher : trencher : (rzecz.) deska | : (rzecz.) deszczułka
trencherman : trencherman : (rzecz.) żarłok
trend : trend : (czas.) dążyć | : (rzecz.) dążność | : (rzecz.) kierunek | : (rzecz.) moda | : (rzecz.) skłonność | : (rzecz.) tendencja
trendy : trendy : (przym.) modny | : (przym.) nowoczesny
trepan : trepan : (rzecz.) trepan
trepanation : trepanation : (rzecz.) trepanacja
trephine : trephine : (czas.) trepanować
trepidation : trepidation : (rzecz.) drżenie | : (rzecz.) lęk | : (rzecz.) niepokój
trespass : trespass : (czas.) grzeszyć | : (czas.) naruszać | : (czas.) naruszyć | : (czas.) przekroczyć | : (czas.) wkroczyć | : (czas.) wtargnąć | : (czas.) wykraczać | : (rzecz.) grzech | : (rzecz.) naruszenie | : (rzecz.) wykroczenie
trespasser : trespasser : (rzecz.) intruz | : (rzecz.) kłusownik | : (rzecz.) winowajca
tress : tress : (rzecz.) kok | : (rzecz.) warkocz
trestle : trestle : (rzecz.) kozioł
trey : trey : (rzecz.) trójka
tri-state : tri-state : (przym.) trójstanowy
triad : triad : (rzecz.) triada | : (rzecz.) trójdźwięk | : (rzecz.) trójka
trial : trial : (przym.) próbny | : (rzecz.) badanie | : (rzecz.) próba | : (rzecz.) proces | : (rzecz.) przesłuchanie | : (rzecz.) rozprawa
triangle : triangle : (rzecz.) trójkąt
triangles : triangles : (rzecz.) trójkątowanie
triangular : triangular : (przym.) trójkątny
triangularly : triangularly : (przysł.) trójkątnie
triangulation : triangulation : (rzecz.) triangulacja
tribal : tribal : (przym.) plemienny | : (przym.) szczepowy
tribe : tribe : (rzecz.) plemię | : (rzecz.) szczep
tribesman : tribesman : (rzecz.) współplemieniec
tribulation : tribulation : (rzecz.) cierpienie | : (rzecz.) męka | : (rzecz.) nieszczęście | : (rzecz.) smutek | : (rzecz.) zmartwienie
tribunal : tribunal : (rzecz.) sąd | : (rzecz.) trybunał
tribune : tribune : (rzecz.) trybun | : (rzecz.) trybuna
tributary : tributary : (przym.) hołdowniczy | : (przym.) pomocniczy | : (rzecz.) dopływ | : (rzecz.) hołdownik
tribute : tribute : (rzecz.) danina | : (rzecz.) haracz | : (rzecz.) hołd | : (rzecz.) należność | : (rzecz.) podatek | : (rzecz.) przyczynek | : (rzecz.) trybut
trichina : trichina : (rzecz.) trychina | : (rzecz.) włosień
trichinosis : trichinosis : (rzecz.) trychinoza | : (rzecz.) włośnica
trichloroethylene : trichloroethylene : (rzecz.) tri | : (rzecz.) trójchloroetylen
trick : trick : (czas.) oszukiwać | : (czas.) wygładzać | : (czas.) wylęgać | : (czas.) wyłudzać | : (czas.) wyłudzić | : (rzecz.) chwyt | : (rzecz.) figiel | : (rzecz.) fortel | : (rzecz.) podstęp | : (rzecz.) przyzwyczajenie | : (rzecz.) psikus | : (rzecz.) psota | : (rzecz.) sprawka | : (rzecz.) sztuczka | : (rzecz.) trik
trickery : trickery : (rzecz.) matactwo | : (rzecz.) nabieranie | : (rzecz.) oszustwo | : (rzecz.) podstęp | : (rzecz.) szwindel
trickle : trickle : (czas.) cieknąć | : (czas.) ciurkać | : (czas.) kapać | : (czas.) sączyć | : (czas.) ściekać | : (czas.) ujawniać | : (czas.) ujawnić | : (rzecz.) kapanie | : (rzecz.) sączenie | : (rzecz.) strużka
trickster : trickster : (rzecz.) macher | : (rzecz.) mistyfikator | : (rzecz.) naciągacz | : (rzecz.) oszust
tricky : tricky : (przym.) podstępny | : (przym.) skomplikowany | : (przym.) wykrętny | : (przym.) zawiły
tricolour : tricolour : (przym.) trójbarwny
tricycle : tricycle : (rzecz.) trycykl
trident : trident : (rzecz.) trójząb
tried : tried : (przym.) wierny | : (przym.) wypróbowany
triennial : triennial : (rzecz.) msza | : (rzecz.) trzylecie
trifle : trifle : (rzecz.) bagatela | : (rzecz.) bagatelka | : (rzecz.) drobiazg | : (rzecz.) drobnostka | : (rzecz.) fraszka | : (rzecz.) igraszka | : (rzecz.) małostka
trifler : trifler : (rzecz.) lekkoduch | : (rzecz.) żartowniś
trifling : trifling : (przym.) błahy | : (przym.) drobny
trig : trig : (czas.) zestroić
trigger : trigger : (czas.) rozpętać | : (czas.) wywoływać | : (czas.) wyzwalać | : (rzecz.) cyngiel | : (rzecz.) cyrkiel | : (rzecz.) hamulec | : (rzecz.) przerzutnik | : (rzecz.) przyczyna | : (rzecz.) spust | : (rzecz.) wyzwalacz
triggering : triggering : (rzecz.) cyngiel | : (rzecz.) wywoływanie
trigonometric : trigonometric : (przym.) trygonometryczny
trigonometry : trigonometry : (rzecz.) trygonometria
trihedral : trihedral : (przym.) trójścienny
trilateral : trilateral : (przym.) trójstronny
trill : trill : (czas.) trelować | : (rzecz.) trel | : (rzecz.) tryl
trilling : trilling : (rzecz.) trojak
trillion : trillion : (rzecz.) bilion | : (rzecz.) kwintylion | : (rzecz.) trylion
trilogy : trilogy : (rzecz.) trylogia
trim : trim : (czas.) czyścić | : (czas.) garnirować | : (czas.) lamować | : (czas.) obkuwać | : (czas.) oporządzać | : (czas.) podciąć | : (czas.) porządkować | : (czas.) poubierać | : (czas.) przybierać | : (czas.) przycinać | : (czas.) przystrajać | : (czas.) trymować | : (czas.) ugarnirować | : (czas.) uporządkować | : (czas.) wycinać | : (czas.) wygładzać | : (czas.) wymuskać | : (przym.) prawidłowy | : (przym.) schludny | : (rzecz.) ozdabianie | : (rzecz.) przystrzyżenie
trimester : trimester : (rzecz.) trymestr
trimmer : trimmer : (rzecz.) lawirant | : (rzecz.) okrawarka | : (rzecz.) okrojnik | : (rzecz.) przycinarka | : (rzecz.) trymer
trimming : trimming : (rzecz.) garnirowanie | : (rzecz.) lamówka | : (rzecz.) obszywka | : (rzecz.) przycinanie | : (rzecz.) uporządkowanie | : (rzecz.) wykończenie
trimmings : trimmings : (rzecz.) obrzynki | : (rzecz.) okrawki
trimness : trimness : (czas.) porządkować | : (rzecz.) schludność
trinitrotoluene : trinitrotoluene : (rzecz.) trójnitrotoluen | : (rzecz.) trotyl
trinity : trinity : (rzecz.) trójca | : (rzecz.) trójka
trinket : trinket : (rzecz.) bibelot | : (rzecz.) błyskotka | : (rzecz.) cacko | : (rzecz.) drobiazg | : (rzecz.) ozdoba | : (rzecz.) ozdóbka | : (rzecz.) świecidełko
trinkets : trinkets : (rzecz.) bibeloty
trinomial : trinomial : (przym.) potrójny | : (rzecz.) trójmian
trio : trio : (rzecz.) tercet | : (rzecz.) trójka
triode : triode : (rzecz.) trioda
trioxide : trioxide : (rzecz.) trójtlenek
trip : trip : (czas.) iść | : (rzecz.) podróż | : (rzecz.) przejażdżka | : (rzecz.) rejs | : (rzecz.) wycieczka | : (rzecz.) wyjazd | : (rzecz.) wyłącznik | : (rzecz.) wypad | : (rzecz.) wyprawa | : (rzecz.) wyzwalacz
trip-out : trip-out : (rzecz.) wyzwolenie
tripartite : tripartite : (przym.) trójdzielny
tripe : tripe : (rzecz.) bzdura | : (rzecz.) flaczki | : (rzecz.) flaki | : (rzecz.) trójka
triple : triple : (czas.) potrajać | : (czas.) troić | : (przym.) potrójny
triplet : triplet : (rzecz.) tercyna | : (rzecz.) triola | : (rzecz.) trójka | : (rzecz.) trójwiersz | : (rzecz.) tryplet
triplets : triplets : (rzecz.) trojaczki
triplex : triplex : (przym.) potrójny | : (przym.) trojaki
triplicate : triplicate : (czas.) potrajać | : (rzecz.) tryplikat
triplication : triplication : (rzecz.) potrojenie
triply : triply : (przysł.) potrójnie
tripod : tripod : (rzecz.) statyw | : (rzecz.) trójnóg
tripper : tripper : (rzecz.) podróżnik | : (rzecz.) wycieczkowicz | : (rzecz.) wyzwalacz
tripping : tripping : (rzecz.) dreptanie | : (rzecz.) potykanie | : (rzecz.) wyzwalanie
trips : trips : (rzecz.) podrożenie
triptych : triptych : (rzecz.) tryptyk
tripwire : tripwire : (rzecz.) kabel
trisection : trisection : (rzecz.) trysekcja
trite : trite : (przym.) banalny | : (przym.) oklepany | : (przym.) szablonowy | : (przym.) trywialny | : (przym.) tuzinkowy | : (przym.) zdawkowy
triteness : triteness : (rzecz.) banał | : (rzecz.) banalność | : (rzecz.) trywialność
tritium : tritium : (rzecz.) tryt
triton : triton : (rzecz.) tryton
triumph : triumph : (czas.) triumfować | : (czas.) tryumfować | : (rzecz.) sukces | : (rzecz.) triumf | : (rzecz.) tryumf
triumphal : triumphal : (przym.) triumfalny | : (przym.) tryumfalny
triumphant : triumphant : (przym.) triumfalny | : (przym.) triumfujący
triumphantly : triumphantly : (przysł.) tryumfalnie | : (przysł.) tryumfująco
triumvir : triumvir : (rzecz.) triumwir
triumvirate : triumvirate : (rzecz.) triumwirat
trivalent : trivalent : (przym.) trójwartościowy
trivet : trivet : (rzecz.) trójnóg
trivial : trivial : (przym.) bagatelny | : (przym.) banalny | : (przym.) błahy | : (przym.) codzienny | : (przym.) nieważny | : (przym.) pospolity | : (przym.) trywialny | : (przym.) tuzinkowy
trivialities : trivialities : (rzecz.) fidrygałki
triviality : triviality : (rzecz.) błahość | : (rzecz.) trywialność
trivialization : trivialization : (rzecz.) banalizacja | : (rzecz.) trywializacja
trivialize : trivialize : (czas.) banalizować | : (czas.) strywializować
trivially : trivially : (przysł.) banalnie | : (przysł.) trywialnie
trochaic : trochaic : (przym.) trocheiczny
troche : troche : (rzecz.) pastylka
trochee : trochee : (rzecz.) trochej
trod : trod : (czas.) kroczyć | : (czas.) stąpać
troglodyte : troglodyte : (rzecz.) troglodyta
troika : troika : (rzecz.) trójka
troll : troll : (czas.) śpiewać | : (rzecz.) kanon
trolley : trolley : (rzecz.) barek | : (rzecz.) ciężarówka | : (rzecz.) drezyna | : (rzecz.) trolejbus | : (rzecz.) wagonik | : (rzecz.) wózek
trolley-car : trolley-car : (rzecz.) tramwaj
trolleybus : trolleybus : (przym.) trolejbusowy | : (rzecz.) trolejbus
trollop : trollop : (rzecz.) brudas | : (rzecz.) dziwka | : (rzecz.) flądra | : (rzecz.) prostytutka
trombone : trombone : (rzecz.) puzon
trombonist : trombonist : (rzecz.) puzonista
troop : troop : (rzecz.) bateria | : (rzecz.) gromadka | : (rzecz.) grupa | : (rzecz.) oddział | : (rzecz.) trupa
troop-carrier : troop-carrier : (rzecz.) transportowiec
trooper : trooper : (rzecz.) kawalerzysta | : (rzecz.) żołnierz
troops : troops : (rzecz.) hufiec | : (rzecz.) odsiecz | : (rzecz.) wojsko | : (rzecz.) żołnierze
trophy : trophy : (rzecz.) łup | : (rzecz.) nagroda | : (rzecz.) pamiątka | : (rzecz.) trofeum | : (rzecz.) zdobycz
tropic : tropic : (przym.) tropikalny | : (przym.) zwrotnikowy | : (rzecz.) tropik | : (rzecz.) zwrotnik
tropic-proofing : tropic-proofing : (rzecz.) tropikalizacja
tropical : tropical : (przym.) podzwrotnikowy | : (przym.) tropikalny | : (przym.) zwrotnikowy
tropically : tropically : (przysł.) tropikalnie
tropics : tropics : (rzecz.) tropik
tropism : tropism : (rzecz.) tropizm
troposphere : troposphere : (rzecz.) troposfera
trot : trot : (czas.) kłusować | : (czas.) przebiegać | : (rzecz.) kłus | : (rzecz.) przechadzka | : (rzecz.) trucht
troth : troth : (rzecz.) obietnica | : (rzecz.) prawda | : (rzecz.) przysięga
trotter : trotter : (rzecz.) kłusak
troubadour : troubadour : (rzecz.) trubadur
trouble : trouble : (czas.) dolegać | : (czas.) doskwierać | : (czas.) fatygować | : (czas.) kłopotać | : (czas.) martwić | : (czas.) męczyć | : (czas.) nagabywać | : (czas.) natrudzić | : (czas.) niepokoić | : (czas.) peszyć | : (czas.) trudzić | : (czas.) turbować | : (rzecz.) choroba | : (rzecz.) dręczenie | : (rzecz.) fatyga | : (rzecz.) fatygowanie | : (rzecz.) kłopot | : (rzecz.) niedomagania | : (rzecz.) niepokój | : (rzecz.) nieprzyjemność | : (rzecz.) tarapaty | : (rzecz.) troska | : (rzecz.) trud | : (rzecz.) urządzenia | : (rzecz.) utrapienie | : (rzecz.) zaburzenie | : (rzecz.) zadyma | : (rzecz.) zakłócenie | : (rzecz.) zło | : (rzecz.) zmartwienie
trouble-free : trouble-free : (przym.) bezproblemowy | : (przym.) niezakłócony | : (przym.) niezawodny
trouble-maker : trouble-maker : (rzecz.) rozrabiacz
troublemaker : troublemaker : (rzecz.) intrygant | : (rzecz.) kozak | : (rzecz.) mąciciel | : (rzecz.) mąciwoda | : (rzecz.) podżegacz | : (rzecz.) warchoł | : (rzecz.) wichrzyciel
troubleshooting : troubleshooting : (rzecz.) diagnozowanie
troublesome : troublesome : (przym.) dokuczliwy | : (przym.) kłopotliwy | : (przym.) niepokojący | : (przym.) uciążliwy
trough : trough : (rzecz.) koryto | : (rzecz.) niecka | : (rzecz.) rynienka | : (rzecz.) rynna | : (rzecz.) żłób
trounce : trounce : (czas.) pokonywać
troupe : troupe : (rzecz.) gromada | : (rzecz.) hufiec | : (rzecz.) trupa | : (rzecz.) wojsko | : (rzecz.) zespół
trousers : trousers : (rzecz.) portki | : (rzecz.) spodnie
trousseau : trousseau : (rzecz.) wyprawa
trout : trout : (rzecz.) pstrąg
trowel : trowel : (rzecz.) kielnia | : (rzecz.) łopatka | : (rzecz.) rydel
truancies : truancies : (rzecz.) wagary
truancy : truancy : (rzecz.) absencja | : (rzecz.) wagarowanie | : (rzecz.) wagary
truant : truant : (rzecz.) wagarowicz
truce : truce : (rzecz.) rozejm
truck : truck : (czas.) frymarczyć | : (rzecz.) ciężarówka | : (rzecz.) lora | : (rzecz.) platforma | : (rzecz.) wózek | : (rzecz.) wymiana
trucker : trucker : (rzecz.) kierowca
truculence : truculence : (rzecz.) agresywność | : (rzecz.) wojowniczość
truculent : truculent : (przym.) barbarzyński | : (przym.) dziki | : (przym.) gwałtowny | : (przym.) srogi | : (przym.) wojowniczy | : (przym.) zadzierzysty
trudge : trudge : (rzecz.) wlec
true : true : (czas.) sprawdzać | : (czas.) sprawdzić | : (przym.) naturalny | : (przym.) nieodrodny | : (przym.) prawdomówny | : (przym.) prawdziwy | : (przym.) rzeczywisty | : (przym.) rzetelny | : (przym.) wierny | : (przysł.) prawdziwie | : (przysł.) wiernie
true-blue : true-blue : (przym.) lojalny | : (przym.) niezawodny | : (przym.) wierny
true-born : true-born : (przym.) prawdziwy
trueborn : trueborn : (przym.) prawdziwy
truffle : truffle : (rzecz.) trufla
truism : truism : (rzecz.) komunał | : (rzecz.) ogólnik | : (rzecz.) truizm
truly : truly : (przysł.) doprawdy | : (przysł.) lojalnie | : (przysł.) prawdziwie | : (przysł.) rzeczywiście | : (przysł.) szczerze | : (przysł.) wiernie
trump : trump : (czas.) narzucić | : (czas.) sfingować | : (czas.) wymyślać | : (czas.) wymyślić | : (rzecz.) atut
trumped-up : trumped-up : (przym.) fałszywy
trumpery : trumpery : (przym.) bezwartościowy | : (przym.) lichy | : (przym.) oszukańczy | : (przym.) tandetny | : (rzecz.) paplanina | : (rzecz.) tandeta
trumpet : trumpet : (czas.) rozgłaszać | : (czas.) trąbić | : (rzecz.) dzwonek | : (rzecz.) trąba | : (rzecz.) trąbka | : (rzecz.) tuba
trumpeter : trumpeter : (rzecz.) trębacz
truncate : truncate : (czas.) obciąć | : (czas.) obcinać | : (czas.) okaleczyć | : (czas.) skracać
truncated : truncated : (przym.) kadłubowy | : (przym.) obcięty | : (przym.) okrojony
truncation : truncation : (rzecz.) obcięcie | : (rzecz.) obcinanie | : (rzecz.) okrojenie
truncheon : truncheon : (rzecz.) buława | : (rzecz.) drzewce | : (rzecz.) pałka | : (rzecz.) pień
trundle : trundle : (czas.) toczyć
trunk : trunk : (rzecz.) bagażnik | : (rzecz.) kadłub | : (rzecz.) kora | : (rzecz.) korpus | : (rzecz.) kufer | : (rzecz.) magistrala | : (rzecz.) pień | : (rzecz.) pniak | : (rzecz.) pysk | : (rzecz.) skrzynka | : (rzecz.) tors | : (rzecz.) trąba | : (rzecz.) trzon | : (rzecz.) tułów | : (rzecz.) waliza | : (rzecz.) zrąb
trunk-line : trunk-line : (rzecz.) magistrala
trunks : trunks : (rzecz.) szorty
truss : truss : (czas.) pakować | : (czas.) wiązać | : (czas.) związywać | : (rzecz.) kratownica | : (rzecz.) pęk | : (rzecz.) tłumok | : (rzecz.) wiązar | : (rzecz.) wiązka
trust : trust : (czas.) powierzyć | : (czas.) ufać | : (czas.) wierzyć | : (rzecz.) nadzieja | : (rzecz.) powiernik | : (rzecz.) trust | : (rzecz.) ufność | : (rzecz.) wiara | : (rzecz.) zarząd | : (rzecz.) zaufanie | : (rzecz.) zwolennik
trustee : trustee : (rzecz.) dysponent | : (rzecz.) kurator | : (rzecz.) mandatariusz | : (rzecz.) opiekun | : (rzecz.) powiernictwo | : (rzecz.) powiernik
trusteeship : trusteeship : (rzecz.) powiernictwo
trustful : trustful : (przym.) ufny
trustfully : trustfully : (przysł.) ufnie
trustfulness : trustfulness : (rzecz.) ufność
trustingly : trustingly : (przysł.) ufnie
trustworthiness : trustworthiness : (rzecz.) pewność | : (rzecz.) solidność | : (rzecz.) wiarogodność
trustworthy : trustworthy : (przym.) odpowiedzialny
trusty : trusty : (przym.) pewny | : (przym.) wierny
truth : truth : (rzecz.) prawda | : (rzecz.) rzetelność | : (rzecz.) szczerość | : (rzecz.) wierność
truthful : truthful : (przym.) prawdomówny | : (przym.) prawdziwy
truthfulness : truthfulness : (rzecz.) prawdomówność | : (rzecz.) prawdziwość
try : try : (czas.) doświadczać | : (czas.) postarać | : (czas.) próbować | : (czas.) przymierzyć | : (czas.) sądzić | : (czas.) skosztować | : (czas.) spróbować | : (czas.) starać | : (czas.) wypróbować | : (czas.) wypróbowywać | : (czas.) zasmakować | : (rzecz.) próba
trying : trying : (przym.) męczący | : (przym.) przykry
trysail : trysail : (rzecz.) skośnik
tryst : tryst : (rzecz.) schadzka
tsar : tsar : (rzecz.) car | : (rzecz.) strzęp
tsarist : tsarist : (przym.) carski
tsunami : tsunami : (rzecz.) tsunami
tuatara : tuatara : (przym.) tatarczany
tub : tub : (rzecz.) balia | : (rzecz.) faska | : (rzecz.) kadź | : (rzecz.) pudełko | : (rzecz.) wanienka | : (rzecz.) wanna
tub-thumping : tub-thumping : (rzecz.) krzykactwo
tubby : tubby : (przym.) baryłkowaty | : (przym.) cichy | : (przym.) niski
tube : tube : (rzecz.) dętka | : (rzecz.) kineskop | : (rzecz.) metro | : (rzecz.) probówka | : (rzecz.) rura | : (rzecz.) rurka | : (rzecz.) szlauch | : (rzecz.) tuba | : (rzecz.) tubka | : (rzecz.) tubus
tubeless : tubeless : (przym.) bezdętkowy
tuber : tuber : (rzecz.) bulwa | : (rzecz.) guz | : (rzecz.) wytłaczarka
tubercle : tubercle : (rzecz.) bulwa | : (rzecz.) guzek
tubercular : tubercular : (przym.) gruzełkowaty | : (przym.) gruzełkowy | : (przym.) gruźliczy | : (przym.) tuberkuliczny
tuberculin : tuberculin : (rzecz.) tuberkulina
tuberculosis : tuberculosis : (rzecz.) gruźlica | : (rzecz.) tuberkuloza
tuberose : tuberose : (rzecz.) tuberoza
tuberous : tuberous : (przym.) bulwiasty
tubing : tubing : (rzecz.) rura | : (rzecz.) rurkowanie | : (rzecz.) rury | : (rzecz.) tubing | : (rzecz.) wytłaczanie
tubular : tubular : (przym.) cylindryczny | : (przym.) rurkowaty | : (przym.) rurkowy | : (przym.) rurowy | : (przym.) tubowy
tubule : tubule : (rzecz.) kanalik
tuck : tuck : (czas.) chować | : (czas.) otulać | : (czas.) podwijać | : (czas.) schować | : (czas.) składać | : (czas.) wtykać | : (czas.) zajadać | : (rzecz.) fałda | : (rzecz.) łakocie | : (rzecz.) zakładka | : (rzecz.) zbiór
tucker : tucker : (czas.) zmęczyć
tuff : tuff : (rzecz.) tuf
tuft : tuft : (rzecz.) kępka | : (rzecz.) kiść | : (rzecz.) kita | : (rzecz.) kłak | : (rzecz.) pęk
tug : tug : (czas.) holować | : (czas.) pociągać | : (czas.) pociągnąć | : (czas.) podskubać | : (czas.) szarpać | : (czas.) windować | : (czas.) wysilać | : (rzecz.) bandzior | : (rzecz.) holownik | : (rzecz.) pociągnięcie | : (rzecz.) szarpanina | : (rzecz.) szarpnięcie | : (rzecz.) wysiłek
tugboat : tugboat : (rzecz.) holownik
tuition : tuition : (rzecz.) czesne | : (rzecz.) nauczanie | : (rzecz.) nauka | : (rzecz.) szkolenie
tulip : tulip : (rzecz.) tulipan
tulle : tulle : (rzecz.) tiul
tumble : tumble : (czas.) odrdzewiać | : (czas.) potoczyć | : (czas.) przewracać | : (czas.) przewrócić | : (czas.) rozbabrać | : (czas.) rozgrzebać | : (czas.) rozkopać | : (czas.) upaść | : (czas.) walić | : (rzecz.) upadek
tumbler : tumbler : (rzecz.) aprobata | : (rzecz.) klown | : (rzecz.) kubek | : (rzecz.) kuglarz | : (rzecz.) szklanka
tumbling : tumbling : (rzecz.) bębnowanie | : (rzecz.) ekwilibrystyka
tumbrel : tumbrel : (rzecz.) jaszczyk | : (rzecz.) wózek
tumefaction : tumefaction : (rzecz.) obrzęk | : (rzecz.) obrzmienie | : (rzecz.) wydęcie
tumid : tumid : (przym.) nabrzmiały | : (przym.) obrzękowy
tummy : tummy : (rzecz.) brzuch
tumour : tumour : (rzecz.) guz | : (rzecz.) narośl | : (rzecz.) nowotwór | : (rzecz.) opuchlizna
tumult : tumult : (rzecz.) hałas | : (rzecz.) niepokój | : (rzecz.) tumult | : (rzecz.) wrzawa | : (rzecz.) wzburzenie | : (rzecz.) zgiełk
tumultuous : tumultuous : (przym.) burzliwy | : (przym.) zgiełkliwy
tumulus : tumulus : (rzecz.) kurhan
tuna : tuna : (rzecz.) tuńczyk
tundra : tundra : (rzecz.) tundra
tune : tune : (czas.) dostrajać | : (czas.) dostroić | : (czas.) nastrajać | : (czas.) nastroić | : (czas.) stroić | : (rzecz.) dostrojenie | : (rzecz.) harmonia | : (rzecz.) melodia | : (rzecz.) nastrój | : (rzecz.) nuta | : (rzecz.) pieśń | : (rzecz.) strój | : (rzecz.) ton
tuneful : tuneful : (przym.) melodyjny
tuner : tuner : (rzecz.) dostrajacz | : (rzecz.) stroiciel | : (rzecz.) strojnik
tungsten : tungsten : (rzecz.) wolfram
tunic : tunic : (rzecz.) bluza | : (rzecz.) mundur | : (rzecz.) tunika
tuning : tuning : (rzecz.) dostrajanie | : (rzecz.) nastrojenie | : (rzecz.) strojenie
tuning-fork : tuning-fork : (rzecz.) kamerton
tunnel : tunnel : (rzecz.) lejek | : (rzecz.) podkop | : (rzecz.) przewód | : (rzecz.) rura | : (rzecz.) sztolnia | : (rzecz.) tunel
turban : turban : (rzecz.) turban
turbid : turbid : (przym.) burzliwy | : (przym.) mętny
turbidity : turbidity : (rzecz.) mętność
turbine : turbine : (rzecz.) turbina
turbo-generator : turbo-generator : (rzecz.) turbogenerator
turbocharger : turbocharger : (rzecz.) turbodoładowanie | : (rzecz.) turbosprężarka
turbojet : turbojet : (przym.) turboodrzutowy | : (rzecz.) samolot
turboprop : turboprop : (przym.) turbośmigłowy | : (rzecz.) turbośmigłowiec
turbot : turbot : (rzecz.) skarp
turbulence : turbulence : (rzecz.) burzliwość | : (rzecz.) gwałtowność | : (rzecz.) niepokój | : (rzecz.) turbulencja | : (rzecz.) wrzaskliwość
turbulent : turbulent : (przym.) buntowniczy | : (przym.) burzliwy | : (przym.) gwałtowny | : (przym.) niesforny | : (przym.) niespokojny | : (przym.) turbulentny | : (przym.) zgiełkliwy
tureen : tureen : (rzecz.) waza
turf : turf : (rzecz.) darń | : (rzecz.) darnina | : (rzecz.) darniowanie | : (rzecz.) murawa | : (rzecz.) torf
turgid : turgid : (przym.) nabrzmiały | : (przym.) nadęty
turgidity : turgidity : (rzecz.) jędrność
turkey : turkey : (rzecz.) indyk
turkey-cock : turkey-cock : (rzecz.) indor
turmeric : turmeric : (rzecz.) kurkuma
turmoil : turmoil : (rzecz.) hałas | : (rzecz.) kotłowanina | : (rzecz.) niepokój | : (rzecz.) podniecenie | : (rzecz.) rwetes | : (rzecz.) wrzawa | : (rzecz.) zamieszanie
turn : turn : (czas.) kręcić | : (czas.) kwaśnieć | : (czas.) nadarzyć | : (czas.) nicować | : (czas.) obracać | : (czas.) obrócić | : (czas.) odwracać | : (czas.) podkręcać | : (czas.) przekręcać | : (czas.) przekręcić | : (czas.) przemieniać | : (czas.) przewracać | : (czas.) skręcać | : (czas.) skręcić | : (czas.) stawać | : (czas.) tłumaczyć | : (czas.) zjawiać | : (czas.) zmieniać | : (czas.) zwracać | : (rzecz.) kolej | : (rzecz.) kolejka | : (rzecz.) kolejność | : (rzecz.) następstwo | : (rzecz.) obrót | : (rzecz.) skręt | : (rzecz.) tura | : (rzecz.) zakręt | : (rzecz.) zawrót | : (rzecz.) zmiana | : (rzecz.) zwrot
turn-coat : turn-coat : (rzecz.) renegat | : (rzecz.) zdrajca
turn-out : turn-out : (rzecz.) zgromadzenie
turn-screw : turn-screw : (rzecz.) śrubokręt | : (rzecz.) wkrętak
turn-table : turn-table : (rzecz.) obrotnica
turnabout : turnabout : (rzecz.) karuzela
turnaround : turnaround : (rzecz.) obrót | : (rzecz.) przewijanie
turnbuckle : turnbuckle : (rzecz.) ściągacz
turncoat : turncoat : (rzecz.) renegat | : (rzecz.) zdrajca
turner : turner : (rzecz.) tokarz
turnery : turnery : (rzecz.) tokarnia | : (rzecz.) tokarstwo
turnip : turnip : (rzecz.) brukiew | : (rzecz.) burak | : (rzecz.) cebula | : (rzecz.) rzepa
turnkey : turnkey : (rzecz.) dozorca | : (rzecz.) klucznik
turnoff : turnoff : (rzecz.) odgałęzienie
turnout : turnout : (rzecz.) ekwipunek | : (rzecz.) frekwencja | : (rzecz.) lokaut | : (rzecz.) mijanka | : (rzecz.) rozjazd | : (rzecz.) sprzęt | : (rzecz.) wydajność | : (rzecz.) wygląd | : (rzecz.) wymarsz | : (rzecz.) zgromadzenie
turnover : turnover : (rzecz.) fluktuacja | : (rzecz.) kapotaż | : (rzecz.) obrót | : (rzecz.) przewracanie
turnpike : turnpike : (rzecz.) rogatka
turnstile : turnstile : (rzecz.) kołowrót | : (rzecz.) kołowrotek | : (rzecz.) turnikiet
turntable : turntable : (rzecz.) obrotnica
turpentine : turpentine : (rzecz.) terpentyna
turpitude : turpitude : (rzecz.) nikczemność | : (rzecz.) podłość
turquoise : turquoise : (rzecz.) turkus
turret : turret : (rzecz.) wieżyczka
turtle : turtle : (rzecz.) żółw
turtle-dove : turtle-dove : (rzecz.) gruchawka | : (rzecz.) turkawka
turtledove : turtledove : (rzecz.) gruchawka | : (rzecz.) turkawka
turtledoves : turtledoves : (rzecz.) synogarlica
tusk : tusk : (rzecz.) kieł
tussle : tussle : (czas.) bić | : (czas.) szamotać | : (rzecz.) bitka | : (rzecz.) bójka
tutelage : tutelage : (rzecz.) kuratela | : (rzecz.) opieka
tutelary : tutelary : (przym.) opiekuńczy
tutor : tutor : (rzecz.) adiunkt | : (rzecz.) guwerner | : (rzecz.) korepetytor | : (rzecz.) nauczyciel | : (rzecz.) opiekun | : (rzecz.) wychowawca
tutorial : tutorial : (przym.) guwernerski | : (przym.) wychowawczy
tuxedo : tuxedo : (rzecz.) smoking
twaddle : twaddle : (czas.) bajać | : (czas.) gadać | : (czas.) paplać | : (rzecz.) gadanie | : (rzecz.) gadanina | : (rzecz.) paplanina
twain : twain : (rzecz.) dwójka
twang : twang : (czas.) brzdąkać | : (czas.) brzęczeć | : (rzecz.) brzdęk | : (rzecz.) brzęk | : (rzecz.) nazalizacja
twat : twat : (rzecz.) cipa
tweak : tweak : (czas.) podkręcać | : (czas.) szczypać | : (czas.) wykręcać | : (rzecz.) uszczypnięcie
tweed : tweed : (rzecz.) tweed
tweet : tweet : (rzecz.) świergot
tweezers : tweezers : (rzecz.) pęseta | : (rzecz.) pinceta | : (rzecz.) szczypczyki
twelfth : twelfth : (przym.) dwunasty
twelvemonth : twelvemonth : (rzecz.) rok
twentieth : twentieth : (przym.) dwudziesty
twenty : twenty : (przym.) dwudziesty
twerp : twerp : (rzecz.) dureń | : (rzecz.) głupek | : (rzecz.) idiota
twice : twice : (przysł.) dwukrotnie
twiddle : twiddle : (czas.) kręcić | : (czas.) przebierać
twig : twig : (czas.) pokapować | : (czas.) skapować | : (czas.) zauważyć | : (czas.) zrozumieć | : (rzecz.) gałąź | : (rzecz.) gałązka | : (rzecz.) rózga | : (rzecz.) witka
twiggy : twiggy : (rzecz.) chudzielec
twilight : twilight : (rzecz.) brzask | : (rzecz.) półmrok | : (rzecz.) schyłek | : (rzecz.) zmierzch | : (rzecz.) zmrok
twill : twill : (rzecz.) diagonal | : (rzecz.) tkanina
twin : twin : (rzecz.) bliźniak
twin-barrel : twin-barrel : (przym.) dwulufowy
twine : twine : (czas.) oplatać | : (czas.) owijać | : (czas.) splatać | : (czas.) wić | : (rzecz.) dratwa | : (rzecz.) splot | : (rzecz.) sznur | : (rzecz.) szpagat
twinge : twinge : (rzecz.) ból | : (rzecz.) rwanie | : (rzecz.) szczypanie
twinkle : twinkle : (czas.) błyszczeć | : (czas.) migotać | : (czas.) mrugać | : (czas.) skrzyć | : (rzecz.) błysk | : (rzecz.) iskrzenie | : (rzecz.) mgnienie | : (rzecz.) migotanie
twinkling : twinkling : (rzecz.) chwila | : (rzecz.) iskrzenie | : (rzecz.) migotanie
twins : twins : (rzecz.) bliźniaki
twirl : twirl : (czas.) kręcić | : (czas.) wiercić | : (czas.) wirować | : (rzecz.) obrót | : (rzecz.) rogal | : (rzecz.) wirowanie
twirler : twirler : (rzecz.) zerownik
twist : twist : (czas.) kręcić | : (czas.) owijać | : (czas.) pleść | : (czas.) przekręcać | : (czas.) przekręcić | : (czas.) skręcać | : (czas.) skręcić | : (czas.) wikłać | : (czas.) wykręcać | : (czas.) wykrzywiać | : (czas.) wykrzywić | : (rzecz.) obrót | : (rzecz.) przędza | : (rzecz.) skręcenie | : (rzecz.) skręt | : (rzecz.) skrzywienie | : (rzecz.) splot | : (rzecz.) twist | : (rzecz.) zakręt | : (rzecz.) zwój | : (rzecz.) zwrot
twister : twister : (rzecz.) kłamca | : (rzecz.) skręcarka | : (rzecz.) wir
twit : twit : (czas.) wyśmiewać | : (rzecz.) bałwan | : (rzecz.) cymbał | : (rzecz.) dureń | : (rzecz.) głupek
twitch : twitch : (czas.) drgać | : (czas.) kurczyć | : (czas.) rwać | : (czas.) szarpać | : (czas.) wykrzywiać | : (czas.) wykrzywić | : (czas.) zadrgać | : (rzecz.) drganie | : (rzecz.) drgawka | : (rzecz.) skurcz | : (rzecz.) szarpnięcie
twitter : twitter : (czas.) bełkotać | : (czas.) ćwierkać | : (czas.) nucić | : (czas.) świergotać | : (czas.) zaświergotać | : (rzecz.) ćwierkanie | : (rzecz.) świergot | : (rzecz.) świergotanie
two : two : (rzecz.) dwója | : (rzecz.) dwojenie | : (rzecz.) dwójka
two-colour : two-colour : (przym.) dwubarwny
two-dimensional : two-dimensional : (przym.) dwuwymiarowy | : (przym.) płaski
two-edged : two-edged : (przym.) obosieczny
two-faced : two-faced : (przym.) nieszczery | : (przym.) obłudny
two-handed : two-handed : (przym.) oburęczny
two-horse : two-horse : (przym.) parokonny
two-hundredth : two-hundredth : (przym.) dwóchsetny
two-piece : two-piece : (rzecz.) garsonka
two-seater : two-seater : (rzecz.) pojazd
two-sided : two-sided : (przym.) dwustronny | : (przym.) obustronny
two-tier : two-tier : (przym.) dwuwarstwowy
two-tongued : two-tongued : (przym.) fałszywy | : (przym.) obłudny
twofaced : twofaced : (przym.) nieszczery | : (przym.) obłudny
twofold : twofold : (przym.) dwojaki | : (przym.) dwukrotny | : (przym.) podwójny | : (przysł.) dwójnasób | : (przysł.) dwukrotnie | : (przysł.) podwójnie
twosome : twosome : (rzecz.) para
txt : txt : (rzecz.) tekst
tycoon : tycoon : (rzecz.) magnat | : (rzecz.) potentat
tyke : tyke : (rzecz.) cham | : (rzecz.) kundel | : (rzecz.) urwis
tympanic : tympanic : (przym.) bębenkowy | : (przym.) membranowy
tympanum : tympanum : (rzecz.) tympanon
type : type : (czas.) wpisać | : (czas.) wpisywać | : (rzecz.) czcionka | : (rzecz.) druk | : (rzecz.) krój | : (rzecz.) rodzaj | : (rzecz.) typ | : (rzecz.) wpisywanie | : (rzecz.) wzór
typecast : typecast : (czas.) obsadzić | : (czas.) typować
typescript : typescript : (rzecz.) maszynopis
typeset : typeset : (czas.) złożyć
typesetter : typesetter : (rzecz.) składacz | : (rzecz.) zecer
typesetting : typesetting : (rzecz.) skład | : (rzecz.) składanie
typewriting : typewriting : (rzecz.) maszynopis
typhoid : typhoid : (przym.) durowy | : (przym.) tyfoidalny | : (przym.) tyfusowy | : (rzecz.) dur | : (rzecz.) tyfus
typhoon : typhoon : (rzecz.) tajfun
typhus : typhus : (rzecz.) tyfus
typical : typical : (przym.) charakterystyczny | : (przym.) typowy
typicality : typicality : (rzecz.) typowość
typically : typically : (przysł.) typowo
typify : typify : (czas.) charakteryzować | : (czas.) personifikować | : (czas.) uosabiać | : (czas.) wzorować
typist : typist : (rzecz.) maszynista | : (rzecz.) maszynistka
typo : typo : (rzecz.) drukarz | : (rzecz.) literówka
typographer : typographer : (rzecz.) drukarz | : (rzecz.) typograf
typographic : typographic : (przym.) typograficzny
typographical : typographical : (przym.) topograficzny | : (przym.) typograficzny | : (przym.) zecerski
typographically : typographically : (przysł.) typograficznie
typography : typography : (rzecz.) typografia
typology : typology : (rzecz.) typologia
tyrannical : tyrannical : (przym.) tyrański
tyrannically : tyrannically : (przysł.) despotycznie
tyrannize : tyrannize : (czas.) tyranizować
tyrannosaur : tyrannosaur : (rzecz.) tyranozaur
tyrannosaurus : tyrannosaurus : (rzecz.) tyranozaur
tyrannous : tyrannous : (przym.) okrutny
tyranny : tyranny : (rzecz.) despotyzm | : (rzecz.) tyrania
tyrant : tyrant : (rzecz.) despota | : (rzecz.) dzierżymorda | : (rzecz.) satrapa | : (rzecz.) tyran
tyre : tyre : (rzecz.) obręcz | : (rzecz.) opona
tyro : tyro : (rzecz.) nowicjusz
tyrosine : tyrosine : (rzecz.) tyrozyna
