kate : Kate : (rzecz.) Katarzyna
kathy : Kathy : (rzecz.) Kasia
kainite : kainite : (rzecz.) kainit
kale : kale : (rzecz.) forsa | : (rzecz.) jarmuż | : (rzecz.) kapusta
kaleidoscope : kaleidoscope : (rzecz.) kalejdoskop
kaleidoscopic : kaleidoscopic : (przym.) kalejdoskopowy
kamikaze : kamikaze : (rzecz.) kamikadze
kangaroo : kangaroo : (rzecz.) kangur
kaolin : kaolin : (rzecz.) kaolin
kapok : kapok : (rzecz.) kapok
karate : karate : (rzecz.) karate
karma : karma : (rzecz.) los
kart : kart : (rzecz.) gokart
kayak : kayak : (rzecz.) kajak
kayaker : kayaker : (rzecz.) kajakarz
kayaking : kayaking : (rzecz.) kajakarstwo
kayo : kayo : (rzecz.) nokaut
kebab : kebab : (rzecz.) kebab | : (rzecz.) szaszłyk
keel : keel : (czas.) wywracać | : (rzecz.) kil | : (rzecz.) stępka
keelboat : keelboat : (rzecz.) kuter
keelhaul : keelhaul : (czas.) besztać
keelson : keelson : (rzecz.) kilson | : (rzecz.) nadstępka
keen : keen : (przym.) chętny | : (przym.) dotkliwy | : (przym.) gorliwy | : (przym.) gwałtowny | : (przym.) namiętny | : (przym.) ostry | : (przym.) pożądający | : (przym.) przenikliwy | : (przym.) skory | : (przym.) żarliwy
keener : keener : (przym.) bystry | : (przym.) ostry
keenest : keenest : (przym.) ostry
keenly : keenly : (przysł.) ostro | : (przysł.) żywo
keep : keep : (czas.) dotrzymać | : (czas.) dotrzymywać | : (czas.) hodować | : (czas.) powstrzymywać | : (czas.) pozostać | : (czas.) pozostawać | : (czas.) przechowywać | : (czas.) przestrzegać | : (czas.) przetrzymywać | : (czas.) trzymać | : (czas.) utrzymywać | : (czas.) zachować | : (czas.) zachowywać | : (czas.) zatrzymać | : (czas.) zatrzymywać | : (rzecz.) przytrzymywacz | : (rzecz.) utrzymanie
keeper : keeper : (rzecz.) dozorca | : (rzecz.) hodowca | : (rzecz.) jarzmo | : (rzecz.) kurator | : (rzecz.) kustosz | : (rzecz.) opiekun | : (rzecz.) przytrzymywacz | : (rzecz.) strażnik | : (rzecz.) stróż
keepers : keepers : (rzecz.) stróżowanie
keeping : keeping : (rzecz.) harmonia | : (rzecz.) opieka | : (rzecz.) pozostawanie | : (rzecz.) przechowanie | : (rzecz.) przetrzymywanie | : (rzecz.) trzymanie | : (rzecz.) utrzymanie | : (rzecz.) wytrzymywanie | : (rzecz.) zachowywanie | : (rzecz.) zgoda
keepsake : keepsake : (rzecz.) pamiątka | : (rzecz.) prezent | : (rzecz.) upominek
kef : kef : (rzecz.) haszysz | : (rzecz.) narkotyk
keg : keg : (rzecz.) beczułka
kelpie : kelpie : (rzecz.) topielec
ken : ken : (rzecz.) zakres | : (rzecz.) zasięg
kennel : kennel : (rzecz.) psiarnia | : (rzecz.) rynsztok | : (rzecz.) ściek
kepi : kepi : (rzecz.) kepi
keratin : keratin : (rzecz.) keratyna
kerb : kerb : (rzecz.) krawężnik
kerbstone : kerbstone : (rzecz.) krawężnik
kerchief : kerchief : (rzecz.) chustka
kermis : kermis : (rzecz.) jarmark | : (rzecz.) kiermasz
kern : kern : (rzecz.) chłop
kernel : kernel : (rzecz.) jądro | : (rzecz.) sedno | : (rzecz.) ziarno
kerosene : kerosene : (rzecz.) kerosen | : (rzecz.) nafta
kestrel : kestrel : (rzecz.) pustułka
ketch : ketch : (rzecz.) kecz
ketchup : ketchup : (rzecz.) keczup
ketene : ketene : (rzecz.) keten
kettle : kettle : (rzecz.) czajnik | : (rzecz.) imbryk | : (rzecz.) kocioł | : (rzecz.) kociołek
kettle-drum : kettle-drum : (rzecz.) kocioł | : (rzecz.) membranofon | : (rzecz.) taraban
kettledrum : kettledrum : (rzecz.) kocioł | : (rzecz.) membranofon | : (rzecz.) taraban
key : key : (rzecz.) klawisz | : (rzecz.) klin | : (rzecz.) klucz | : (rzecz.) kluczowanie | : (rzecz.) kluczyk | : (rzecz.) legenda | : (rzecz.) tonacja | : (rzecz.) wpust | : (rzecz.) wysepka
keyboard : keyboard : (rzecz.) klawiatura | : (rzecz.) syntezator
keyboarding : keyboarding : (rzecz.) tastrowanie
keyed : keyed : (przym.) dyskretny | : (przym.) powściągliwy
keyhole : keyhole : (rzecz.) dziurka
keynote : keynote : (rzecz.) myśl | : (rzecz.) nuta | : (rzecz.) tonika | : (rzecz.) zwornik
keypad : keypad : (rzecz.) klawiatura
keystone : keystone : (rzecz.) myśl | : (rzecz.) podstawa | : (rzecz.) zwornik
keystroke : keystroke : (rzecz.) cios
keyway : keyway : (rzecz.) wrąb
keyword : keyword : (rzecz.) modyfikator
khaki : khaki : (rzecz.) khaki
khan : khan : (rzecz.) chan
khanate : khanate : (rzecz.) chanat
khedive : khedive : (rzecz.) kedyw
kibble : kibble : (czas.) śrutować | : (rzecz.) bierka | : (rzecz.) kubeł
kibbutz : kibbutz : (rzecz.) kibuc
kick : kick : (czas.) fikać | : (czas.) kopać | : (czas.) kopnąć | : (czas.) machać | : (czas.) opierać | : (czas.) pokopać | : (czas.) skopać | : (czas.) wierzgać | : (rzecz.) kopniak | : (rzecz.) kopnięcie | : (rzecz.) narzekanie | : (rzecz.) odrzut | : (rzecz.) skok
kick-out : kick-out : (rzecz.) wypychacz
kickback : kickback : (rzecz.) łapówka | : (rzecz.) reakcja
kicker : kicker : (rzecz.) docinek | : (rzecz.) przytyk | : (rzecz.) złośliwość
kicking : kicking : (rzecz.) kopanie
kickshaw : kickshaw : (rzecz.) bagatela | : (rzecz.) cacko | : (rzecz.) mecyja
kid : kid : (czas.) nabierać | : (czas.) żartować | : (rzecz.) bachor | : (rzecz.) berbeć | : (rzecz.) dzieciak | : (rzecz.) dziecię | : (rzecz.) dziecko | : (rzecz.) koźlątko | : (rzecz.) koźle | : (rzecz.) malec | : (rzecz.) maluch | : (rzecz.) młokos | : (rzecz.) śmierdziuch | : (rzecz.) smyk
kidnap : kidnap : (czas.) porwać | : (czas.) porywać | : (czas.) uprowadzać | : (czas.) uprowadzić
kidnapper : kidnapper : (rzecz.) porywacz
kidnapping : kidnapping : (rzecz.) kidnaperstwo | : (rzecz.) kidnaping | : (rzecz.) porwanie | : (rzecz.) porywanie
kidney : kidney : (rzecz.) cynaderka | : (rzecz.) cynadra | : (rzecz.) nerka | : (rzecz.) rodzaj
kidney-bean : kidney-bean : (rzecz.) fasola
kier : kier : (rzecz.) kadź | : (rzecz.) warnik
kieserite : kieserite : (rzecz.) kizeryt
kill : kill : (czas.) anulować | : (czas.) boleć | : (czas.) gasić | : (czas.) niszczyć | : (czas.) ubić | : (czas.) unicestwić | : (czas.) uśmiercać | : (czas.) uśmierzać | : (czas.) zabić | : (czas.) zabijać | : (czas.) zamordować | : (czas.) zgładzić
killed : killed : (czas.) uśmiercić
killer : killer : (rzecz.) morderca | : (rzecz.) zabójca | : (rzecz.) zatruwacz
killing : killing : (przym.) zabójczy | : (rzecz.) odstrzał | : (rzecz.) wyłącz | : (rzecz.) wyrzynanie | : (rzecz.) wytracenie | : (rzecz.) zabójstwo
killingly : killingly : (przysł.) zabójczo
kiln : kiln : (czas.) suszyć | : (czas.) wypalać | : (rzecz.) piec | : (rzecz.) piekarnik | : (rzecz.) prażenia
kilo : kilo : (rzecz.) kilo
kilobit : kilobit : (rzecz.) kilobit
kilobyte : kilobyte : (rzecz.) kilobajt
kilocalorie : kilocalorie : (rzecz.) kilokaloria
kilocycle : kilocycle : (rzecz.) kilocykl | : (rzecz.) kiloherc
kilogram : kilogram : (rzecz.) kilogram
kilogram-force : kilogram-force : (rzecz.) kilogram-siła | : (rzecz.) kilopond
kilogram-metre : kilogram-metre : (rzecz.) kilogramometr
kilogramme : kilogramme : (rzecz.) kilogram
kilogramme-meter : kilogramme-meter : (rzecz.) kilogramometr
kilohertz : kilohertz : (rzecz.) kiloherc
kilometre : kilometre : (rzecz.) kilometr
kiloton : kiloton : (rzecz.) kilotona
kilovolt : kilovolt : (rzecz.) kilowolt
kilowatt : kilowatt : (rzecz.) kilowat
kilowatt-hour : kilowatt-hour : (rzecz.) kilowatogodzina
kilt : kilt : (rzecz.) kilt
kimono : kimono : (rzecz.) kimono
kin : kin : (rzecz.) ród | : (rzecz.) rodzina
kinaesthesia : kinaesthesia : (rzecz.) kinestezja
kind : kind : (przym.) dobry | : (przym.) łagodny | : (przym.) łaskawy | : (przym.) miły | : (przym.) poczciwy | : (przym.) przychylny | : (przym.) rzeczowy | : (przym.) uprzejmy | : (przym.) życzliwy | : (rzecz.) gatunek | : (rzecz.) rodzaj | : (rzecz.) typ
kind-hearted : kind-hearted : (przym.) dobrotliwy | : (przym.) dobry | : (przym.) poczciwy | : (przym.) życzliwy
kind-heartedness : kind-heartedness : (rzecz.) dobroduszność | : (rzecz.) poczciwość | : (rzecz.) życzliwość
kindergarten : kindergarten : (rzecz.) dzieciniec | : (rzecz.) przedszkole | : (rzecz.) żłobek
kindergartener : kindergartener : (rzecz.) przedszkolak
kindle : kindle : (czas.) iskrzyć | : (czas.) podniecać | : (czas.) podniecić | : (czas.) rozniecać | : (czas.) rozniecić | : (czas.) rozpalać | : (czas.) rozpalić | : (czas.) rozżarzyć | : (czas.) zaiskrzyć | : (czas.) zapalać | : (czas.) zapalić | : (czas.) zapłonąć
kindliness : kindliness : (rzecz.) dobroć | : (rzecz.) uprzejmość | : (rzecz.) życzliwość
kindling : kindling : (rzecz.) iskrzenie | : (rzecz.) podpałka | : (rzecz.) rozniecenie | : (rzecz.) rozpałka
kindly : kindly : (przym.) dobroczynny | : (przym.) dobrotliwy | : (przym.) dobry | : (przym.) łaskawy | : (przym.) uprzejmy | : (przym.) życzliwy | : (przysł.) łaskawie | : (przysł.) serdecznie | : (przysł.) uprzejmie | : (przysł.) życzliwie
kindness : kindness : (rzecz.) dobroć | : (rzecz.) łaskawość | : (rzecz.) przysługa | : (rzecz.) uczynność | : (rzecz.) uprzejmość | : (rzecz.) życzliwość
kindred : kindred : (przym.) bratni | : (przym.) pobratymczy | : (przym.) podobny | : (przym.) pokrewny | : (rzecz.) krewni | : (rzecz.) podobieństwo | : (rzecz.) pokrewieństwo | : (rzecz.) rodzina
kinematics : kinematics : (rzecz.) kinematyka
kinescope : kinescope : (rzecz.) kineskop
kinetic : kinetic : (przym.) kinetyczny | : (przym.) ruchomy
kinetics : kinetics : (rzecz.) kinetyka
king : king : (rzecz.) damka | : (rzecz.) król
king-size : king-size : (przym.) olbrzymi | : (przym.) ponadwymiarowy | : (przym.) wielki
kingcup : kingcup : (rzecz.) kaczeniec | : (rzecz.) kaczyniec
kingdom : kingdom : (rzecz.) królestwo | : (rzecz.) królowanie
kingfisher : kingfisher : (rzecz.) zimorodek
kinglet : kinglet : (rzecz.) królewiątko | : (rzecz.) królik | : (rzecz.) mysikrólik
kingly : kingly : (przym.) królewski
kingpin : kingpin : (rzecz.) król | : (rzecz.) sworzeń
kingship : kingship : (rzecz.) królestwo | : (rzecz.) królewskość | : (rzecz.) panowanie
kink : kink : (czas.) supłać | : (rzecz.) bzik | : (rzecz.) kaprys | : (rzecz.) perwersja | : (rzecz.) przewodu | : (rzecz.) skręt | : (rzecz.) supeł | : (rzecz.) zapętlenie
kinky : kinky : (przym.) dziwaczny | : (przym.) perwersyjny
kinsfolk : kinsfolk : (rzecz.) krewni | : (rzecz.) pokrewieństwo | : (rzecz.) powinowactwo | : (rzecz.) rodzeństwo
kinship : kinship : (rzecz.) pokrewieństwo | : (rzecz.) powinowactwo | : (rzecz.) sympatia
kinswoman : kinswoman : (rzecz.) krewna | : (rzecz.) powinowata
kiosk : kiosk : (rzecz.) budka | : (rzecz.) kiosk | : (rzecz.) stoisko
kip : kip : (rzecz.) buda
kipper : kipper : (rzecz.) łosoś | : (rzecz.) pikling | : (rzecz.) suszenie
kirsch : kirsch : (rzecz.) wiśniówka
kirtle : kirtle : (rzecz.) kurtka | : (rzecz.) spódnica
kiss : kiss : (czas.) całować | : (czas.) cmokać | : (czas.) pocałować | : (czas.) ucałować | : (rzecz.) buzia | : (rzecz.) buziak | : (rzecz.) całus | : (rzecz.) pocałunek | : (rzecz.) ucałowanie
kisser : kisser : (rzecz.) buźka | : (rzecz.) gęba | : (rzecz.) japa | : (rzecz.) morda | : (rzecz.) usta
kit : kit : (rzecz.) apartament | : (rzecz.) beczka | : (rzecz.) cebrzyk | : (rzecz.) ekwipunek | : (rzecz.) komplet | : (rzecz.) kubeł | : (rzecz.) plecak | : (rzecz.) rynsztunek | : (rzecz.) skrzynka | : (rzecz.) worek | : (rzecz.) wyposażenie | : (rzecz.) zestaw
kitbag : kitbag : (rzecz.) plecak
kitchen : kitchen : (rzecz.) kuchnia
kitchenette : kitchenette : (rzecz.) kuchenka
kite : kite : (rzecz.) gryps | : (rzecz.) jastrząb | : (rzecz.) kania | : (rzecz.) latawiec
kitsch : kitsch : (rzecz.) kicz | : (rzecz.) kita
kitschy : kitschy : (przym.) kiczowaty
kitten : kitten : (czas.) kocić | : (rzecz.) kociak | : (rzecz.) kociątko | : (rzecz.) kotek | : (rzecz.) zalotnica
kittenish : kittenish : (przym.) zalotny
kitty : kitty : (rzecz.) kiciuś | : (rzecz.) kociak
kiwi : kiwi : (rzecz.) kiwi
klaxon : klaxon : (rzecz.) klakson | : (rzecz.) syrena
kleptomaniac : kleptomaniac : (rzecz.) kleptoman
klutz : klutz : (rzecz.) dupek
klystron : klystron : (rzecz.) klistron
km : km : (rzecz.) kilometr
knack : knack : (rzecz.) chwyt | : (rzecz.) dryg | : (rzecz.) spryt | : (rzecz.) sztuczka | : (rzecz.) zręczność
knag : knag : (rzecz.) kołek | : (rzecz.) sęk
knaggy : knaggy : (przym.) sękaty
knap : knap : (czas.) rozbijać
knapsack : knapsack : (rzecz.) chlebak | : (rzecz.) plecak | : (rzecz.) tornister
knar : knar : (rzecz.) narośl
knave : knave : (rzecz.) kanalia | : (rzecz.) łajdak | : (rzecz.) łotr | : (rzecz.) nikczemnik | : (rzecz.) sługa | : (rzecz.) szelma | : (rzecz.) walet
knavery : knavery : (rzecz.) łajdactwo | : (rzecz.) łotrostwo | : (rzecz.) nikczemność | : (rzecz.) służba
knavish : knavish : (przym.) łajdacki | : (przym.) nikczemny | : (przym.) służalczy
knead : knead : (czas.) gnieść | : (czas.) masować | : (czas.) miesić | : (czas.) rozczochrać | : (czas.) rozmiesić | : (czas.) ugniatać | : (czas.) urabiać | : (czas.) zgnieść
kneader : kneader : (rzecz.) ugniatacz | : (rzecz.) ugniatarka | : (rzecz.) zagniatarka
kneading : kneading : (rzecz.) masowanie | : (rzecz.) mieszanie | : (rzecz.) mieszenie | : (rzecz.) ugniatanie | : (rzecz.) zagniatanie
kneading-trough : kneading-trough : (rzecz.) dzieża | : (rzecz.) oberża
knee : knee : (rzecz.) kolanko | : (rzecz.) kolano
knee-boots : knee-boots : (rzecz.) oficerki
knee-cap : knee-cap : (rzecz.) rzepka
knee-pad : knee-pad : (rzecz.) nakolannik
kneecap : kneecap : (rzecz.) rzepka
kneed : kneed : (przym.) kolankowaty
kneel : kneel : (czas.) klęczeć | : (czas.) klękać | : (czas.) uklęknąć
kneeler : kneeler : (rzecz.) klęczenie
knell : knell : (rzecz.) dzwonienie | : (rzecz.) podzwonne
knew : knew : (czas.) poznawać
knick : knick : (rzecz.) bibelot | : (rzecz.) cacko
knick-knack : knick-knack : (rzecz.) cacko | : (rzecz.) drobiazg | : (rzecz.) ozdóbka
knickerbockers : knickerbockers : (rzecz.) pumpy | : (rzecz.) reformy
knickers : knickers : (rzecz.) majtki | : (rzecz.) reformy
knickknack : knickknack : (rzecz.) cacko | : (rzecz.) drobiazg | : (rzecz.) ozdóbka
knife : knife : (rzecz.) kozik | : (rzecz.) nóż | : (rzecz.) nożyk | : (rzecz.) składak
knife-edge : knife-edge : (rzecz.) ostrze
knifing : knifing : (rzecz.) nóż | : (rzecz.) zasztyletowanie
knight : knight : (rzecz.) kawaler | : (rzecz.) koń | : (rzecz.) konik | : (rzecz.) rycerz | : (rzecz.) skoczek | : (rzecz.) szlachcic | : (rzecz.) szlachectwo
knight's : knight's : (przym.) rycerski
knighthood : knighthood : (rzecz.) rycerstwo
knighting : knighting : (rzecz.) nobilitowanie
knightly : knightly : (przym.) rycerski | : (przysł.) rycersko
knit : knit : (czas.) dziać | : (czas.) dziergać | : (czas.) spajać | : (czas.) wrabiać | : (czas.) zrastać | : (rzecz.) kwasoryt
knitted : knitted : (przym.) trykotowy
knitter : knitter : (rzecz.) dziewiarka | : (rzecz.) dziewiarz | : (rzecz.) trykotaż
knitting : knitting : (rzecz.) dzianie | : (rzecz.) dziewiarstwo | : (rzecz.) robótka | : (rzecz.) trykotarstwo
knitwear : knitwear : (rzecz.) dzianina
knob : knob : (rzecz.) gałka | : (rzecz.) guz | : (rzecz.) guzik | : (rzecz.) kawałek | : (rzecz.) klamka | : (rzecz.) pokrętło | : (rzecz.) przycisk | : (rzecz.) sęk | : (rzecz.) wypukłość
knobbly : knobbly : (przym.) guzowaty
knock : knock : (czas.) dobijać | : (czas.) przysadzać | : (czas.) przysądzać | : (czas.) pukać | : (czas.) stukać | : (czas.) trącać | : (czas.) uderzać | : (czas.) uderzyć | : (czas.) wytracać | : (czas.) wytrącać | : (czas.) zapukać | : (czas.) zderzać | : (rzecz.) dotknięcie | : (rzecz.) kołatka | : (rzecz.) przebłysk | : (rzecz.) pukanie | : (rzecz.) stłuczka | : (rzecz.) stukanie | : (rzecz.) stuknięcie | : (rzecz.) stukot | : (rzecz.) uderzenie
knock-kneed : knock-kneed : (przym.) koślawy | : (przym.) krzywonogi
knock-out : knock-out : (rzecz.) nokaut | : (rzecz.) wypychacz | : (rzecz.) wyrzutnik
knockabout : knockabout : (przym.) błazeński | : (przym.) hałaśliwy
knocker : knocker : (rzecz.) grzechotka | : (rzecz.) kołatka
knocker-off : knocker-off : (rzecz.) odbijak
knockout : knockout : (przym.) bezkonkurencyjny | : (przym.) nokautowy | : (rzecz.) eliminacja | : (rzecz.) likwidacja | : (rzecz.) nokaut
knoll : knoll : (rzecz.) kopiec | : (rzecz.) pagórek
knot : knot : (czas.) skomplikować | : (czas.) supłać | : (czas.) wiązać | : (rzecz.) powikłanie | : (rzecz.) sęk | : (rzecz.) supeł | : (rzecz.) trudność | : (rzecz.) węzeł
knot-grass : knot-grass : (rzecz.) rdest
knotless : knotless : (przym.) bezsęczny
knotty : knotty : (przym.) kłopotliwy | : (przym.) sękaty | : (przym.) trudny | : (przym.) węzłowaty | : (przym.) zawiły
knout : knout : (rzecz.) knucie | : (rzecz.) knut
know : know : (czas.) dowiedzieć | : (czas.) poznać | : (czas.) poznawać | : (czas.) umieć | : (czas.) wiedzieć | : (czas.) znać
know-how : know-how : (rzecz.) umiejętność | : (rzecz.) wiedza | : (rzecz.) wprawa | : (rzecz.) znajomość
know-it-all : know-it-all : (rzecz.) mądrala
knowing : knowing : (przym.) chytry | : (przym.) porozumiewawczy | : (przym.) rozumny | : (przym.) zręczny | : (rzecz.) rozum | : (rzecz.) wiedza
knowingly : knowingly : (przysł.) chytrze | : (przysł.) naumyślnie | : (przysł.) rzeczowo | : (przysł.) świadomie | : (przysł.) umyślnie | : (przysł.) zręcznie
knowledge : knowledge : (rzecz.) poznanie | : (rzecz.) świadomość | : (rzecz.) wiadomość | : (rzecz.) wiedza | : (rzecz.) znajomość
known : known : (czas.) poznawać | : (przym.) wiadomy | : (rzecz.) wiadoma
knuckle : knuckle : (czas.) szturchać | : (rzecz.) golonka | : (rzecz.) kłykieć | : (rzecz.) knykieć | : (rzecz.) kostka | : (rzecz.) przegub | : (rzecz.) staw
knuckle-duster : knuckle-duster : (rzecz.) kastet
knucklehead : knucklehead : (rzecz.) ćwok
knur : knur : (rzecz.) sęk
knurl : knurl : (rzecz.) gałka | : (rzecz.) guz | : (rzecz.) guzek | : (rzecz.) molet | : (rzecz.) radełko
knurling : knurling : (rzecz.) moletowanie | : (rzecz.) radełkowanie
kobold : kobold : (rzecz.) chochlik
kohlrabi : kohlrabi : (rzecz.) kalarepa
kolkhoz : kolkhoz : (rzecz.) kołchoz
kook : kook : (rzecz.) dziwak | : (rzecz.) ekscentryk | : (rzecz.) oryginał
kopeck : kopeck : (rzecz.) kopiejka
kopek : kopek : (rzecz.) kopiejka
kopje : kopje : (rzecz.) pagórek | : (rzecz.) wzgórze
kosher : kosher : (przym.) autentyczny | : (przym.) koszerny
kowtow : kowtow : (czas.) chylić | : (czas.) płaszczyć
kraal : kraal : (rzecz.) ogrodzenie | : (rzecz.) wieś
krill : krill : (rzecz.) kryl
krypton : krypton : (rzecz.) krypton
kudos : kudos : (rzecz.) prestiż | : (rzecz.) sława
kulak : kulak : (rzecz.) kułak
kymograph : kymograph : (rzecz.) kimograf
