a : a : (spójnik) and
adam : Adam : (rzecz.) Adam
agnieszka : Agnieszka : (rzecz.) Agnes
aleksander : Aleksander : (rzecz.) Alexander
aleksandra : Aleksandra : (rzecz.) Alexandra
alicja : Alicja : (rzecz.) Alice
amadeusz : Amadeusz : (rzecz.) Amadeus
amelia : Amelia : (rzecz.) Amelia
ameryka : Ameryka : (rzecz.) America
andrzej : Andrzej : (rzecz.) Andrew | : (rzecz.) Andy
anna : Anna : (rzecz.) Anne
antoni : Antoni : (rzecz.) Anthony | : (rzecz.) Tony
artur : Artur : (rzecz.) Arthur
australia : Australia : (rzecz.) Australia
a-buforowanie : a-buforowanie : (rzecz.) a-buffering
abakus : abakus : (rzecz.) abacus
abandon : abandon : (rzecz.) abandonment
abazur : abażur : (rzecz.) lampshade | : (rzecz.) lamp-shade | : (rzecz.) shade
abdykacja : abdykacja : (rzecz.) abdication | : (rzecz.) demission
abdykowac : abdykować : (czas.) abdicate
abecadlo : abecadło : (rzecz.) alphabet
aberracja : aberracja : (rzecz.) aberration
abiogeneza : abiogeneza : (rzecz.) autogenesis
abiturient : abiturient : (rzecz.) graduate
ablacja : ablacja : (rzecz.) ablation | : (rzecz.) washout
ablacyjny : ablacyjny : (przym.) ablative
ablucja : ablucja : (rzecz.) ablution
abnegacja : abnegacja : (rzecz.) abnegation | : (rzecz.) self-denial
abolicja : abolicja : (rzecz.) abolition | : (rzecz.) invalidation
abolicjonista : abolicjonista : (rzecz.) abolitionist
abolicjonizm : abolicjonizm : (rzecz.) abolitionism
abominacja : abominacja : (rzecz.) abomination
abonament : abonament : (rzecz.) buy | : (rzecz.) subscription
abonent : abonent : (rzecz.) subscriber
abonowac : abonować : (czas.) subscribe
aborcja : aborcja : (rzecz.) abortion
aborygeni : aborygeni : (rzecz.) Aborigines
abrakadabra : abrakadabra : (rzecz.) abracadabra
abrazja : abrazja : (rzecz.) abrasion | : (rzecz.) attrition
abrazyjny : abrazyjny : (przym.) wave-cut
abrewiacja : abrewiacja : (rzecz.) abbreviation
absencja : absencja : (rzecz.) absence | : (rzecz.) absenteeism | : (rzecz.) truancy
absolucja : absolucja : (rzecz.) absolution
absolut : absolut : (rzecz.) absolute
absolutnie : absolutnie : (przysł.) absolutely
absolutnosc : absolutność : (rzecz.) absoluteness
absolutny : absolutny : (przym.) absolute | : (przym.) bare | : (przym.) despotic | : (przym.) illimitable | : (przym.) out-and-out | : (przym.) unmitigated
absolutorium : absolutorium : (rzecz.) discharge | : (rzecz.) graduate | : (rzecz.) graduation
absolutysta : absolutysta : (rzecz.) absolutist
absolutystyczny : absolutystyczny : (przym.) absolutistic
absolutyzacja : absolutyzacja : (rzecz.) absolute
absolutyzm : absolutyzm : (rzecz.) absolutism
absolwent : absolwent : (rzecz.) alumnus | : (rzecz.) graduate
absorbowanie : absorbowanie : (rzecz.) intromission
absorbowac : absorbować : (czas.) absorb | : (czas.) preoccupy
absorpcja : absorpcja : (rzecz.) absorbency | : (rzecz.) absorption
absorpcyjny : absorpcyjny : (przym.) absorptive
abstrahowanie : abstrahowanie : (rzecz.) abstraction
abstrahowac : abstrahować : (czas.) disregard | : (czas.) pass
abstrakcja : abstrakcja : (rzecz.) abstract | : (rzecz.) abstraction
abstrakcjonizm : abstrakcjonizm : (rzecz.) abstractionism
abstrakcyjnie : abstrakcyjnie : (przysł.) abstractly
abstrakcyjny : abstrakcyjny : (przym.) abstract
abstrakt : abstrakt : (rzecz.) abstract | : (rzecz.) tracker
abstynencja : abstynencja : (rzecz.) abstinence | : (rzecz.) teetotalism | : (rzecz.) temperance
abstynencki : abstynencki : (przym.) abstinent
abstynent : abstynent : (rzecz.) abstainer | : (rzecz.) teetotaller
absurd : absurd : (rzecz.) absurdity
absurdalnie : absurdalnie : (przysł.) absurdly | : (przysł.) ludicrously | : (przysł.) nonsensically | : (przysł.) ridiculously
absurdalnosc : absurdalność : (rzecz.) absurdity
absurdalny : absurdalny : (przym.) absurd | : (przym.) laughable | : (przym.) ludicrous | : (przym.) preposterous
absyda : absyda : (rzecz.) apse
absynt : absynt : (rzecz.) absinth | : (rzecz.) absinthe
aby : aby : (spójnik) for | : (spójnik) that
acetaldehyd : acetaldehyd : (rzecz.) acetaldehyde
aceton : aceton : (rzecz.) acetone
acetylen : acetylen : (rzecz.) acetylene
acetylocholina : acetylocholina : (rzecz.) acetylcholine
acetylosalicylowy : acetylosalicylowy : (przym.) acetylsalicylic
ach : ach : (wykrzyknik) ah | : (wykrzyknik) oh
achromatyczny : achromatyczny : (przym.) achromatic
acykliczny : acykliczny : (przym.) acyclic
acz : acz : (spójnik) though
aczkolwiek : aczkolwiek : (spójnik) albeit | : (spójnik) although
adamaszek : adamaszek : (rzecz.) damask
adaptacja : adaptacja : (rzecz.) adaptation | : (rzecz.) adapting | : (rzecz.) arrangement | : (rzecz.) customization
adaptacyjny : adaptacyjny : (przym.) adaptive
adaptator : adaptator : (rzecz.) adaptor
adapter : adapter : (rzecz.) pickup | : (rzecz.) record-player
adaptowalnosc : adaptowalność : (rzecz.) customizability
adaptowac : adaptować : (czas.) adapt | : (czas.) arrange | : (czas.) convert
addytywny : addytywny : (przym.) additive
adekwatnosc : adekwatność : (rzecz.) adequacy
adekwatny : adekwatny : (przym.) adequate | : (przym.) pertinent
adenina : adenina : (rzecz.) adenine
adenozyna : adenozyna : (rzecz.) adenosine
adermina : adermina : (rzecz.) pyridoxine
adhezja : adhezja : (rzecz.) adherence | : (rzecz.) adhesion
adhezyjnosc : adhezyjność : (rzecz.) tenacity
adiabatyczny : adiabatyczny : (przym.) adiabatic
adiunkt : adiunkt : (rzecz.) adjunct | : (rzecz.) lecturer | : (rzecz.) tutor
adiustacja : adiustacja : (rzecz.) layout | : (rzecz.) revision
adiustator : adiustator : (rzecz.) editor | : (rzecz.) subeditor | : (rzecz.) sub-editor
adiustowac : adiustować : (czas.) edit
adiutant : adiutant : (rzecz.) adjutant | : (rzecz.) aide | : (rzecz.) aide-de-camp
administracja : administracja : (rzecz.) admin | : (rzecz.) administration | : (rzecz.) government | : (rzecz.) management
administracyjnie : administracyjnie : (przysł.) administratively
administracyjny : administracyjny : (przym.) administrative
administrator : administrator : (rzecz.) sysop
administrowanie : administrowanie : (rzecz.) administration
administrowac : administrować : (czas.) administer | : (czas.) administrate | : (czas.) manage
admiracja : admiracja : (rzecz.) admiration | : (rzecz.) delight
admiralicja : admiralicja : (rzecz.) admiralty
admiralski : admiralski : (przym.) admiral's
admiral : admirał : (rzecz.) admiral
admonicja : admonicja : (rzecz.) admonition
adnotacja : adnotacja : (rzecz.) annotation | : (rzecz.) endorsement
adnotowac : adnotować : (czas.) annotate
adopcja : adopcja : (rzecz.) adoption
adoptowany : adoptowany : (przym.) adoptive
adoptowac : adoptować : (czas.) adapt | : (czas.) adopt
adoracja : adoracja : (rzecz.) adoration
adorator : adorator : (rzecz.) admirer | : (rzecz.) adorer
adorowac : adorować : (czas.) adore
adrenalina : adrenalina : (rzecz.) adrenalin | : (rzecz.) adrenaline | : (rzecz.) epinephrine
adres : adres : (rzecz.) address | : (rzecz.) direction | : (rzecz.) locator | : (rzecz.) superscription
adresarka : adresarka : (rzecz.) addresser | : (rzecz.) addressograph
adresat : adresat : (rzecz.) addressee | : (rzecz.) destination
adresograf : adresograf : (rzecz.) addresser | : (rzecz.) addressograph
adresowalnosc : adresowalność : (rzecz.) addressability
adresowalny : adresowalny : (przym.) addressable
adresowanie : adresowanie : (rzecz.) address | : (rzecz.) addressing
adresowac : adresować : (czas.) address
adsorbat : adsorbat : (rzecz.) adsorptive
adsorbent : adsorbent : (rzecz.) adsorbent
adsorbowac : adsorbować : (czas.) adsorb
adsorpcja : adsorpcja : (rzecz.) adsorption
adular : adular : (rzecz.) adularia
adwekcja : adwekcja : (rzecz.) advection
adwent : adwent : (rzecz.) advent
adwentysta : adwentysta : (rzecz.) Adventist
adwersarz : adwersarz : (rzecz.) adversary | : (rzecz.) opponent
adwokat : adwokat : (rzecz.) advocate | : (rzecz.) attorney | : (rzecz.) barrister | : (rzecz.) counsel | : (rzecz.) counsellor | : (rzecz.) fixer | : (rzecz.) lawyer | : (rzecz.) pleader | : (rzecz.) solicitor
aerator : aerator : (rzecz.) aerator
aerobik : aerobik : (rzecz.) aerobic | : (rzecz.) aerobics
aerobiologia : aerobiologia : (rzecz.) aerobiology
aerobus : aerobus : (rzecz.) airbus
aeroby : aeroby : (rzecz.) aerobes
aerodrom : aerodrom : (rzecz.) aerodrome | : (rzecz.) airdrome
aerodyna : aerodyna : (rzecz.) aerodyne
aerodynamiczny : aerodynamiczny : (przym.) aerodynamic | : (przym.) streamlined
aerodynamika : aerodynamika : (rzecz.) aerodynamics | : (rzecz.) aeromechanics
aerograf : aerograf : (rzecz.) aerograph | : (rzecz.) airbrush | : (rzecz.) air-brush
aeroklub : aeroklub : (rzecz.) aero
aeromechanika : aeromechanika : (rzecz.) aeromechanics
aerometr : aerometr : (rzecz.) aerometer | : (rzecz.) hygrometer
aeronauta : aeronauta : (rzecz.) aeronaut
aeronautyczny : aeronautyczny : (przym.) aeronautic | : (przym.) aeronautical
aeronautyka : aeronautyka : (rzecz.) aeronautics | : (rzecz.) aerospace
aeroplan : aeroplan : (rzecz.) airplane
aeroport : aeroport : (rzecz.) airport
aerostatyka : aerostatyka : (rzecz.) aerostatics
aerozol : aerozol : (rzecz.) aerosol | : (rzecz.) spray
afazja : afazja : (rzecz.) aphasia
afekt : afekt : (rzecz.) affection | : (rzecz.) affliction | : (rzecz.) emotion
afektacja : afektacja : (rzecz.) affectation | : (rzecz.) primness
afektowanie : afektowanie : (przysł.) affectedly
afektowany : afektowany : (przym.) affected | : (przym.) prim
afektywny : afektywny : (przym.) affective
afera : afera : (rzecz.) affair | : (rzecz.) intrigue | : (rzecz.) scam | : (rzecz.) scandal
afereza : afereza : (rzecz.) aphaeresis
aferzysta : aferzysta : (rzecz.) racketeer | : (rzecz.) swindler
afiks : afiks : (rzecz.) affix
afiliacja : afiliacja : (rzecz.) affiliation
afiliowac : afiliować : (czas.) affiliate
afiniczny : afiniczny : (przym.) affine
afirmacja : afirmacja : (rzecz.) affirmation
afisz : afisz : (rzecz.) bill | : (rzecz.) card | : (rzecz.) placard | : (rzecz.) playbill | : (rzecz.) poster
afiszowac : afiszować : (czas.) flaunt
aforyzm : aforyzm : (rzecz.) aphorism
afrodyzjak : afrodyzjak : (rzecz.) aphrodisiac
afront : afront : (rzecz.) affront | : (rzecz.) cut | : (rzecz.) insult | : (rzecz.) slight | : (rzecz.) snub
agar : agar : (rzecz.) agar-agar
agat : agat : (rzecz.) agate
agencja : agencja : (rzecz.) agency
agens : agens : (rzecz.) actor
agent : agent : (rzecz.) agent | : (rzecz.) factor | : (rzecz.) rep
agentura : agentura : (rzecz.) agency
agitacja : agitacja : (rzecz.) agitation | : (rzecz.) campaigning | : (rzecz.) canvass | : (rzecz.) canvassing
agitator : agitator : (rzecz.) agitator
agitowac : agitować : (czas.) agitate | : (czas.) electioneer
aglomeracja : aglomeracja : (rzecz.) agglomeration
aglomerat : aglomerat : (rzecz.) agglomerate
aglutynacja : aglutynacja : (rzecz.) agglutination
aglutynacyjny : aglutynacyjny : (przym.) agglutinative
aglutynina : aglutynina : (rzecz.) agglutinin
agnat : agnat : (rzecz.) agnate
agnostycyzm : agnostycyzm : (rzecz.) agnosticism
agnostyczny : agnostyczny : (przym.) agnostic
agnostyk : agnostyk : (rzecz.) agnostic
agonia : agonia : (rzecz.) agony
agorafobia : agorafobia : (rzecz.) agoraphobia
agrafka : agrafka : (rzecz.) safety-pin
agrariusz : agrariusz : (rzecz.) agrarian
agrarny : agrarny : (przym.) agrarian
agregacja : agregacja : (rzecz.) aggregation
agregat : agregat : (rzecz.) aggregate | : (rzecz.) unit
agregowac : agregować : (czas.) aggregate | : (czas.) aggregated
agresja : agresja : (rzecz.) aggression
agresor : agresor : (rzecz.) aggressor | : (rzecz.) attacker | : (rzecz.) blusterer
agrest : agrest : (rzecz.) gooseberries | : (rzecz.) gooseberry
agresywnie : agresywnie : (przysł.) aggressively
agresywnosc : agresywność : (rzecz.) aggression | : (rzecz.) aggressiveness | : (rzecz.) belligerence | : (rzecz.) truculence
agresywny : agresywny : (przym.) aggressive | : (przym.) offensive | : (przym.) violent
agrochemia : agrochemia : (rzecz.) agrochemicals
agrochemiczny : agrochemiczny : (przym.) agrochemical
agronom : agronom : (rzecz.) agriculturist | : (rzecz.) agronomist
agronomia : agronomia : (rzecz.) agronomy
agronomiczny : agronomiczny : (przym.) agronomic | : (przym.) agronomical
aha : aha : (wykrzyknik) aha
ajencja : ajencja : (rzecz.) agency | : (rzecz.) branch | : (rzecz.) franchise
ajent : ajent : (rzecz.) agent | : (rzecz.) factor
ajnsztajn : ajnsztajn : (rzecz.) einsteinium
akacja : akacja : (rzecz.) acacia
akademia : akademia : (rzecz.) academia | : (rzecz.) academy | : (rzecz.) college
akademicki : akademicki : (przym.) academic | : (przym.) collegiate | : (przym.) theoretic | : (przym.) theoretical
akademickosc : akademickość : (rzecz.) academic
akademik : akademik : (rzecz.) academic | : (rzecz.) dorm | : (rzecz.) dormitory | : (rzecz.) hostel
akant : akant : (rzecz.) acanthus
akapit : akapit : (rzecz.) indention | : (rzecz.) paragraph | : (rzecz.) subparagraph
akceleracja : akceleracja : (rzecz.) acceleration
akcelerator : akcelerator : (rzecz.) accelerator
akcent : akcent : (rzecz.) accent | : (rzecz.) drawl | : (rzecz.) emphasis | : (rzecz.) stress
akcentowanie : akcentowanie : (rzecz.) accentuation | : (rzecz.) emphasis
akcentowac : akcentować : (czas.) accent | : (czas.) accentuate | : (czas.) emphasize | : (czas.) stress
akcentowy : akcentowy : (przym.) accentual
akcept : akcept : (rzecz.) acceptance
akceptacja : akceptacja : (rzecz.) acceptability | : (rzecz.) acceptance | : (rzecz.) acceptation | : (rzecz.) assent | : (rzecz.) complaisance | : (rzecz.) go-ahead
akceptacyjny : akceptacyjny : (przym.) accepting
akceptant : akceptant : (rzecz.) acceptor
akceptor : akceptor : (rzecz.) accepter | : (rzecz.) acceptor
akceptowalnosc : akceptowalność : (rzecz.) acceptability | : (rzecz.) plausibility
akceptowalny : akceptowalny : (przym.) acceptable
akceptowac : akceptować : (czas.) accede | : (czas.) accept | : (czas.) approve | : (czas.) condone
akces : akces : (rzecz.) access | : (rzecz.) accession
akcesja : akcesja : (rzecz.) accession
akcesoria : akcesoria : (rzecz.) accessories | : (rzecz.) accessory | : (rzecz.) appliance
akcja : akcja : (rzecz.) action | : (rzecz.) campaign | : (rzecz.) operation | : (rzecz.) share | : (rzecz.) suit
akcjonariusz : akcjonariusz : (rzecz.) shareholder | : (rzecz.) share-holder | : (rzecz.) stockholder
akcydens : akcydens : (rzecz.) job
akcyjny : akcyjny : (przym.) capital | : (przym.) joint-stock
akcyza : akcyza : (rzecz.) excise
aklamacja : aklamacja : (rzecz.) acclamation
aklamowac : aklamować : (czas.) acclaim
aklimatyzacja : aklimatyzacja : (rzecz.) acclimation | : (rzecz.) acclimatization | : (rzecz.) adjustment | : (rzecz.) domestication
aklimatyzowanie : aklimatyzowanie : (rzecz.) acclimated | : (rzecz.) acclimatizing
aklimatyzowac : aklimatyzować : (czas.) acclimate | : (czas.) acclimatize | : (czas.) adjust | : (czas.) naturalize
akolita : akolita : (rzecz.) acolyte
akomodacja : akomodacja : (rzecz.) accommodation | : (rzecz.) housing
akomodowac : akomodować : (czas.) accommodate
akompaniament : akompaniament : (rzecz.) accompaniment
akompaniator : akompaniator : (rzecz.) accompanist
akompaniowac : akompaniować : (czas.) accompany
akonit : akonit : (rzecz.) aconite
akonto : akonto : (rzecz.) advance | : (rzecz.) deposit
akord : akord : (rzecz.) accord | : (rzecz.) chord | : (rzecz.) piece-work
akordeon : akordeon : (rzecz.) accordion | : (rzecz.) concertina
akordeonista : akordeonista : (rzecz.) accordionist
akr : akr : (rzecz.) acre
akredytacja : akredytacja : (rzecz.) accreditation
akredytowac : akredytować : (czas.) accredit | : (czas.) registered
akrobacja : akrobacja : (rzecz.) acrobatics | : (rzecz.) aerobatics
akrobata : akrobata : (rzecz.) acrobat | : (rzecz.) contortionist
akrobatyczny : akrobatyczny : (przym.) acrobatic
akrobatyka : akrobatyka : (rzecz.) acrobatics | : (rzecz.) aerobatics
akronim : akronim : (rzecz.) acronym
akropol : akropol : (rzecz.) acropolis
akrostych : akrostych : (rzecz.) acrostic
akryl : akryl : (rzecz.) acrylic
akrylowy : akrylowy : (przym.) acrylic
aksamit : aksamit : (rzecz.) velvet
aksamitka : aksamitka : (rzecz.) marigold
aksamitnosc : aksamitność : (rzecz.) mellowness | : (rzecz.) silkiness
aksamitny : aksamitny : (przym.) velvety
akseroftol : akseroftol : (rzecz.) vitamin
aksjologia : aksjologia : (rzecz.) axiology
aksjomat : aksjomat : (rzecz.) axiom | : (rzecz.) postulate
aksjomatyczny : aksjomatyczny : (przym.) axiomatic
akson : akson : (rzecz.) axon
aksonometryczny : aksonometryczny : (przym.) axonometric
akt : akt : (rzecz.) act | : (rzecz.) certificate | : (rzecz.) file | : (rzecz.) indictment | : (rzecz.) marriage | : (rzecz.) nude | : (rzecz.) nudity
akta : akta : (rzecz.) brief | : (rzecz.) dossier | : (rzecz.) dossiers | : (rzecz.) file | : (rzecz.) filing | : (rzecz.) portfolio | : (rzecz.) proceedings | : (rzecz.) record | : (rzecz.) statute
aktor : aktor : (rzecz.) actor | : (rzecz.) player | : (rzecz.) puppeteer
aktorka : aktorka : (rzecz.) actress
aktorski : aktorski : (przym.) actor's
aktorstwo : aktorstwo : (rzecz.) acting | : (rzecz.) histrionics
aktualizacja : aktualizacja : (rzecz.) actualization
aktualizowanie : aktualizowanie : (rzecz.) actualizing | : (rzecz.) update
aktualizowac : aktualizować : (czas.) update
aktualnie : aktualnie : (przysł.) currently | : (przysł.) topically
aktualnosc : aktualność : (rzecz.) timeliness | : (rzecz.) topicality
aktualny : aktualny : (przym.) current | : (przym.) effective | : (przym.) live | : (przym.) present | : (przym.) timely | : (przym.) topical | : (przym.) up-to-date
aktyn : aktyn : (rzecz.) actinium
aktyniczny : aktyniczny : (przym.) actinic
aktynowiec : aktynowiec : (rzecz.) actinide
aktyw : aktyw : (rzecz.) active
aktywa : aktywa : (rzecz.) assets
aktywacja : aktywacja : (rzecz.) activation
aktywator : aktywator : (rzecz.) activator | : (rzecz.) energizer
aktywista : aktywista : (rzecz.) activist | : (rzecz.) campaigner
aktywizacja : aktywizacja : (rzecz.) activation
aktywizm : aktywizm : (rzecz.) activism
aktywizowac : aktywizować : (czas.) activate | : (czas.) arouse
aktywnie : aktywnie : (przysł.) actively
aktywnosc : aktywność : (rzecz.) activity
aktywny : aktywny : (przym.) active | : (przym.) clickable
aktywowanie : aktywowanie : (rzecz.) activation
aktywowac : aktywować : (czas.) activate | : (czas.) wait
aktowka : aktówka : (rzecz.) briefcase | : (rzecz.) portfolio
akumulacja : akumulacja : (rzecz.) accumulation
akumulator : akumulator : (rzecz.) accumulator | : (rzecz.) A-register | : (rzecz.) battery
akumulowac : akumulować : (czas.) accumulate | : (czas.) accumulated | : (czas.) amass
akupresura : akupresura : (rzecz.) acupressure
akupunktura : akupunktura : (rzecz.) acupuncture
akuratnosc : akuratność : (rzecz.) meticulousness
akuratny : akuratny : (przym.) accurate | : (przym.) exact
akustyczny : akustyczny : (przym.) acoustic | : (przym.) acoustical | : (przym.) acoustically | : (przym.) resonant | : (przym.) sound | : (przym.) unplugged
akustyk : akustyk : (rzecz.) acoustician
akustyka : akustyka : (rzecz.) acoustic | : (rzecz.) acoustician | : (rzecz.) acoustics
akuszer : akuszer : (rzecz.) obstetrician
akuszeria : akuszeria : (rzecz.) obstetrics
akuszerka : akuszerka : (rzecz.) midwife
akuszerstwo : akuszerstwo : (rzecz.) midwifery
akwaforcista : akwaforcista : (rzecz.) etcher
akwaforta : akwaforta : (rzecz.) etching
akwakultura : akwakultura : (rzecz.) aquaculture
akwalung : akwalung : (rzecz.) aqualung | : (rzecz.) scuba
akwamaryn : akwamaryn : (rzecz.) aquamarine
akwamaryna : akwamaryna : (rzecz.) aqua | : (rzecz.) aquamarine
akwanauta : akwanauta : (rzecz.) aquanaut
akwaplan : akwaplan : (rzecz.) aquaplane
akwarela : akwarela : (rzecz.) aquarelle | : (rzecz.) watercolour | : (rzecz.) water-colour | : (rzecz.) watercolours
akwaria : akwaria : (rzecz.) aquaria | : (rzecz.) aquariums
akwarium : akwarium : (rzecz.) aquarium
akwatinta : akwatinta : (rzecz.) aquatint
akwedukt : akwedukt : (rzecz.) aqueduct
akwen : akwen : (rzecz.) reservoir
akwizycja : akwizycja : (rzecz.) acquisition | : (rzecz.) canvassing
akwizytor : akwizytor : (rzecz.) canvasser | : (rzecz.) salesman | : (rzecz.) solicitor
alabaster : alabaster : (rzecz.) alabaster
alarm : alarm : (rzecz.) alarm | : (rzecz.) alert | : (rzecz.) tocsin
alarmista : alarmista : (rzecz.) alarmist
alarmistyczny : alarmistyczny : (przym.) panicky
alarmowac : alarmować : (czas.) alarm | : (czas.) alert | : (czas.) warn
albatros : albatros : (rzecz.) albatross
albinizm : albinizm : (rzecz.) albinism
albinos : albinos : (rzecz.) albino
albo : albo : (spójnik) or
albowiem : albowiem : (spójnik) because
album : album : (rzecz.) album
albumina : albumina : (rzecz.) albumen | : (rzecz.) albumin | : (rzecz.) protein
alchemia : alchemia : (rzecz.) alchemy
alchemiczny : alchemiczny : (przym.) alchemical
alchemik : alchemik : (rzecz.) alchemist
ale : ale : (spójnik) but
alegat : alegat : (rzecz.) voucher
alegoria : alegoria : (rzecz.) allegory
alegorycznie : alegorycznie : (przysł.) allegorically
alegoryczny : alegoryczny : (przym.) allegoric | : (przym.) allegorical | : (przym.) figurative
aleja : aleja : (rzecz.) alameda | : (rzecz.) alley | : (rzecz.) avenue | : (rzecz.) drive | : (rzecz.) lane | : (rzecz.) parkway | : (rzecz.) street | : (rzecz.) vista
alejka : alejka : (rzecz.) alley | : (rzecz.) alleyway | : (rzecz.) lane
aleksandryn : aleksandryn : (rzecz.) alexandrine
aleksandryt : aleksandryt : (rzecz.) alexandrite
aleksja : aleksja : (rzecz.) alexia
alembik : alembik : (rzecz.) alembic
alergen : alergen : (rzecz.) allergen
alergia : alergia : (rzecz.) allergy
alergiczny : alergiczny : (przym.) allergenic | : (przym.) allergic
alfa : alfa : (rzecz.) alpha
alfabet : alfabet : (rzecz.) alphabet
alfabetycznie : alfabetycznie : (przysł.) alphabetically
alfabetyczny : alfabetyczny : (przym.) abecedarian | : (przym.) alphabetic | : (przym.) alphabetical
alfanumeryczny : alfanumeryczny : (przym.) alphabetic-numeric | : (przym.) alphanumeric | : (przym.) alphanumerical
alfons : alfons : (rzecz.) pander | : (rzecz.) pimp
algebra : algebra : (rzecz.) algebra
algebraicznie : algebraicznie : (przysł.) algebraically
algebraiczny : algebraiczny : (przym.) algebraic
algebraik : algebraik : (rzecz.) algebraist
algorytm : algorytm : (rzecz.) algorithm | : (rzecz.) policy
algorytmicznie : algorytmicznie : (przysł.) algorithmically
algorytmiczny : algorytmiczny : (przym.) algorithmic
aliancki : aliancki : (przym.) allied
alians : alians : (rzecz.) alliance
aliant : aliant : (rzecz.) ally
alibi : alibi : (rzecz.) alibi
alidada : alidada : (rzecz.) alidade
alienacja : alienacja : (rzecz.) alienation
alienowac : alienować : (czas.) alienate
alifatyczny : alifatyczny : (przym.) aliphatic
aligator : aligator : (rzecz.) alligator
alimentacja : alimentacja : (rzecz.) alimony
alimenty : alimenty : (rzecz.) alimonies | : (rzecz.) alimony | : (rzecz.) maintenance
aliteracja : aliteracja : (rzecz.) alliteration
aliteracyjny : aliteracyjny : (przym.) alliterative
alizaryna : alizaryna : (rzecz.) alizarin
alkalia : alkalia : (rzecz.) alkali
alkalicznosc : alkaliczność : (rzecz.) alkalinity
alkaliczny : alkaliczny : (przym.) alkaline
alkalizowanie : alkalizowanie : (rzecz.) alkalization | : (rzecz.) alkalize
alkalizowac : alkalizować : (czas.) alkalify | : (czas.) alkalize
alkaloid : alkaloid : (rzecz.) alkaloid
alkeny : alkeny : (rzecz.) alkenes
alkierz : alkierz : (rzecz.) alcove | : (rzecz.) closet
alkil : alkil : (rzecz.) alkyl
alkohol : alkohol : (rzecz.) alcohol | : (rzecz.) booze | : (rzecz.) liqueur | : (rzecz.) spirit
alkoholiczny : alkoholiczny : (przym.) alcoholic
alkoholik : alkoholik : (rzecz.) alcoholic | : (rzecz.) boozer
alkoholizm : alkoholizm : (rzecz.) alcoholism
alkoholizowac : alkoholizować : (czas.) load
alkoholometria : alkoholometria : (rzecz.) alcoholometry
alkoholomierz : alkoholomierz : (rzecz.) alcoholmeter
alkoholowy : alkoholowy : (przym.) alcoholic | : (przym.) boozy | : (przym.) intoxicating
alkomat : alkomat : (rzecz.) breathalyser | : (rzecz.) breathalyzer
alkowa : alkowa : (rzecz.) alcove | : (rzecz.) recess
alleluja : alleluja : (wykrzyknik) alleluia | : (wykrzyknik) halleluiah | : (wykrzyknik) hallelujah
almanach : almanach : (rzecz.) almanac
alniko : alniko : (rzecz.) alnico
aloes : aloes : (rzecz.) aloe
alokacja : alokacja : (rzecz.) allocation
alokowac : alokować : (czas.) allocate | : (czas.) allocated | : (czas.) allocates | : (czas.) allot | : (czas.) dispatch
alonz : alonż : (rzecz.) rider
alopatyczny : alopatyczny : (przym.) allopathic
alotropia : alotropia : (rzecz.) allotropy
alotropowy : alotropowy : (przym.) allotropic
aloza : aloza : (rzecz.) alewife | : (rzecz.) shad
alpaga : alpaga : (rzecz.) alpaca
alpaka : alpaka : (rzecz.) alpaca
alpinista : alpinista : (rzecz.) alpinist | : (rzecz.) climber | : (rzecz.) mountaineer
alpinistyka : alpinistyka : (rzecz.) mountain-climbing | : (rzecz.) mountaineering
alt : alt : (rzecz.) altitude | : (rzecz.) alto
altana : altana : (rzecz.) arbour | : (rzecz.) bower | : (rzecz.) picnic | : (rzecz.) summerhouse | : (rzecz.) summer-house
altanka : altanka : (rzecz.) alcove
alteracja : alteracja : (rzecz.) excitement
alternator : alternator : (rzecz.) alternator | : (rzecz.) alternators
alternatywa : alternatywa : (rzecz.) alternation | : (rzecz.) alternative | : (rzecz.) disjunction | : (rzecz.) option
alternatywnie : alternatywnie : (przysł.) alternatively
alternatywnosc : alternatywność : (rzecz.) alternative
alternatywny : alternatywny : (przym.) alternate | : (przym.) alternated | : (przym.) alternates | : (przym.) alternative | : (przym.) alternatives
altowy : altowy : (przym.) alto
altruista : altruista : (rzecz.) altruist
altruistyczny : altruistyczny : (przym.) altruistic
altruizm : altruizm : (rzecz.) altruism | : (rzecz.) unselfishness
altowka : altówka : (rzecz.) alto | : (rzecz.) viola
aluminium : aluminium : (rzecz.) aluminium
aluminotermia : aluminotermia : (rzecz.) aluminothermy
alumn : alumn : (rzecz.) alumni | : (rzecz.) alumnus
aluwialny : aluwialny : (przym.) alluvial
aluwium : aluwium : (rzecz.) alluvium
aluzja : aluzja : (rzecz.) allusion | : (rzecz.) hint | : (rzecz.) inkling | : (rzecz.) innuendo | : (rzecz.) intimation | : (rzecz.) tip
aluzyjny : aluzyjny : (przym.) allusive
amalgamat : amalgamat : (rzecz.) amalgam
amalgamowanie : amalgamowanie : (rzecz.) amalgamating
amalgamowac : amalgamować : (czas.) amalgamate | : (czas.) fuse
amant : amant : (rzecz.) beau | : (rzecz.) lover | : (rzecz.) suitor
amarant : amarant : (rzecz.) amaranth
amator : amator : (rzecz.) aficionado | : (rzecz.) amateur | : (rzecz.) dabbler | : (rzecz.) fan | : (rzecz.) layman | : (rzecz.) lover
amatorski : amatorski : (przym.) amateurish | : (przym.) amatory | : (przym.) unprofessional
amatorstwo : amatorstwo : (rzecz.) amateurishness | : (rzecz.) amateurism | : (rzecz.) dilettantism
amazonit : amazonit : (rzecz.) amazonite
amazonka : amazonka : (rzecz.) Amazon | : (rzecz.) horsewoman
ambaras : ambaras : (rzecz.) embarrassment | : (rzecz.) perplexity
ambasada : ambasada : (rzecz.) embassy
ambasador : ambasador : (rzecz.) ambassador | : (rzecz.) ambassadress
ambasadorski : ambasadorski : (przym.) ambassadorial
ambicja : ambicja : (rzecz.) ambition
ambitnie : ambitnie : (przysł.) ambitiously
ambitny : ambitny : (przym.) ambitious | : (przym.) aspiring
ambiwalencja : ambiwalencja : (rzecz.) ambivalence
ambiwalentny : ambiwalentny : (przym.) ambivalent
ambona : ambona : (rzecz.) ambo | : (rzecz.) lookout | : (rzecz.) look-out | : (rzecz.) pulpit
ambra : ambra : (rzecz.) ambergris | : (rzecz.) liquidambar
ambrazura : ambrazura : (rzecz.) porthole
ambrozja : ambrozja : (rzecz.) ambrosia | : (rzecz.) ragweed
ambulans : ambulans : (rzecz.) ambulance
ambulatorium : ambulatorium : (rzecz.) dispensary | : (rzecz.) policlinic
ambulatoryjny : ambulatoryjny : (przym.) ambulant | : (przym.) ambulatory
ameba : ameba : (rzecz.) amoeba | : (rzecz.) faint-heart
ameryk : ameryk : (rzecz.) americium
ametyst : ametyst : (rzecz.) amethyst
ametystowy : ametystowy : (przym.) amethystine
amfetamina : amfetamina : (rzecz.) amphetamine
amfibia : amfibia : (rzecz.) amphibian | : (rzecz.) amphibians
amfibol : amfibol : (rzecz.) hornblende
amfibole : amfibole : (rzecz.) amphiboles
amfiboliczny : amfiboliczny : (przym.) ambiguous
amfibologia : amfibologia : (rzecz.) amphibology
amfibrach : amfibrach : (rzecz.) amphibrach
amfilada : amfilada : (rzecz.) series | : (rzecz.) succession
amfiteatr : amfiteatr : (rzecz.) amphitheatre
amfora : amfora : (rzecz.) amphora
amidki : amidki : (rzecz.) amides
amina : amina : (rzecz.) amine
aminofenol : aminofenol : (rzecz.) aminophenol
aminowy : aminowy : (przym.) amine
amitotyczny : amitotyczny : (przym.) amitotic
amitoza : amitoza : (rzecz.) amitosis
amnestia : amnestia : (rzecz.) amnesty
amnestionowac : amnestionować : (czas.) amnesty
amnezja : amnezja : (rzecz.) amnesia | : (rzecz.) anamnesis
amok : amok : (rzecz.) amok
amon : amon : (rzecz.) ammonium
amoniak : amoniak : (rzecz.) ammonia
amoniakalny : amoniakalny : (przym.) ammoniac
amoniakat : amoniakat : (rzecz.) ammine
amonifikacja : amonifikacja : (rzecz.) ammonization
amonit : amonit : (rzecz.) ammonite
amoralnosc : amoralność : (rzecz.) amorality
amoralny : amoralny : (przym.) amoral
amorek : amorek : (rzecz.) cupid
amorficzny : amorficzny : (przym.) amorphous
amortyzacja : amortyzacja : (rzecz.) amortization | : (rzecz.) depreciation | : (rzecz.) redemption | : (rzecz.) sinking
amortyzator : amortyzator : (rzecz.) absorber | : (rzecz.) damper | : (rzecz.) shock-absorber
amortyzowac : amortyzować : (czas.) absorb | : (czas.) amortize | : (czas.) cushion | : (czas.) damp
amper : amper : (rzecz.) amp | : (rzecz.) ampere | : (rzecz.) amperes
amperogodzina : amperogodzina : (rzecz.) ampere-hour | : (rzecz.) amp-hours
amperomierz : amperomierz : (rzecz.) ammeter | : (rzecz.) ammeters
amperosekunda : amperosekunda : (rzecz.) ampere-second
amperozwoj : amperozwój : (rzecz.) ampere-turn
amplifikacja : amplifikacja : (rzecz.) amplification
amplifikator : amplifikator : (rzecz.) amplifier
amplifikowac : amplifikować : (czas.) exaggerate
amplituda : amplituda : (rzecz.) amplitude | : (rzecz.) profusion
amputacja : amputacja : (rzecz.) amputation
amputowac : amputować : (czas.) amputate | : (czas.) excise
ampulka : ampułka : (rzecz.) ampoule
amulet : amulet : (rzecz.) amulet
amunicja : amunicja : (rzecz.) ammo | : (rzecz.) ammunition
amylaza : amylaza : (rzecz.) amylase
anabaptysta : anabaptysta : (rzecz.) dipper
anabolizm : anabolizm : (rzecz.) anabolism
anachoreta : anachoreta : (rzecz.) anchorite | : (rzecz.) hermit
anachronicznosc : anachroniczność : (rzecz.) anachronism
anachroniczny : anachroniczny : (przym.) anachronistic
anachronizm : anachronizm : (rzecz.) anachronism
anaerob : anaerob : (rzecz.) anaerobe
anafaza : anafaza : (rzecz.) anaphase
anafilaksja : anafilaksja : (rzecz.) anaphylaxis
anafilaktyczny : anafilaktyczny : (przym.) anaphylactic
anaglif : anaglif : (rzecz.) anaglyph
anagram : anagram : (rzecz.) anagrams
anakonda : anakonda : (rzecz.) anaconda
analfabeta : analfabeta : (rzecz.) illiterate
analfabetyzm : analfabetyzm : (rzecz.) illiteracy
analgezja : analgezja : (rzecz.) analgesia
analitycznie : analitycznie : (przysł.) analytically
analitycznosc : analityczność : (rzecz.) analyticity
analityczny : analityczny : (przym.) analytic | : (przym.) analytical
analityk : analityk : (rzecz.) analyst
analiza : analiza : (rzecz.) analysis | : (rzecz.) assay | : (rzecz.) evaluation | : (rzecz.) examination | : (rzecz.) parse | : (rzecz.) scrutiny
analizator : analizator : (rzecz.) analyser | : (rzecz.) analyzer
analizowanie : analizowanie : (rzecz.) analysing
analizowac : analizować : (czas.) analyse | : (czas.) analyze | : (czas.) dissect | : (czas.) evaluate | : (czas.) explore | : (czas.) parse | : (czas.) resolve | : (czas.) scrutinize | : (czas.) study
analny : analny : (przym.) anal
analog : analog : (rzecz.) analogue
analogia : analogia : (rzecz.) analogy | : (rzecz.) anthology | : (rzecz.) parity
analogicznie : analogicznie : (przysł.) similarly
analogicznosc : analogiczność : (rzecz.) parity
analogiczny : analogiczny : (przym.) analogical | : (przym.) analogous | : (przym.) analogue
analogowy : analogowy : (przym.) analogue | : (przym.) analogues
anamneza : anamneza : (rzecz.) anamnesis | : (rzecz.) recollection
ananas : ananas : (rzecz.) pineapple | : (rzecz.) rascal
anapest : anapest : (rzecz.) anapaest
anarchia : anarchia : (rzecz.) anarchy | : (rzecz.) lawlessness
anarchiczny : anarchiczny : (przym.) anarchic | : (przym.) anarchical | : (przym.) lawless
anarchista : anarchista : (rzecz.) anarchist
anarchistyczny : anarchistyczny : (przym.) anarchistic
anarchizm : anarchizm : (rzecz.) anarchism | : (rzecz.) confusion
anatema : anatema : (rzecz.) anathema
anatom : anatom : (rzecz.) anatomist
anatomia : anatomia : (rzecz.) anatomy
anatomicznie : anatomicznie : (przysł.) anatomically
anatomiczny : anatomiczny : (przym.) anatomic | : (przym.) anatomical
ancymonek : ancymonek : (rzecz.) scamp
andezyn : andezyn : (rzecz.) andesine
andradyt : andradyt : (rzecz.) andradite
androgeniczny : androgeniczny : (przym.) androgynous
androgenny : androgenny : (przym.) androgenic
androgeny : androgeny : (przym.) androgens
andrus : andrus : (rzecz.) street-boy
andrut : andrut : (rzecz.) gofer | : (rzecz.) wafer
anegdociarz : anegdociarz : (rzecz.) storyteller | : (rzecz.) story-teller
anegdota : anegdota : (rzecz.) anecdote | : (rzecz.) story
anegdotyczny : anegdotyczny : (przym.) anecdotal | : (przym.) anecdotic | : (przym.) imaginary
aneks : aneks : (rzecz.) annex | : (rzecz.) appendix | : (rzecz.) enclosure
aneksja : aneksja : (rzecz.) annexation
anektowac : anektować : (czas.) annex
anemia : anemia : (rzecz.) anaemia
anemiczny : anemiczny : (przym.) anaemic
anemograf : anemograf : (rzecz.) anemograph
anemometr : anemometr : (rzecz.) anemometer | : (rzecz.) wind-gauge
anemon : anemon : (rzecz.) anemone
anemoskop : anemoskop : (rzecz.) anemoscope
aneroid : aneroid : (rzecz.) aneroid
anestezja : anestezja : (rzecz.) anaesthesia
anestezjolog : anestezjolog : (rzecz.) anaesthesiologist | : (rzecz.) anaesthetist
anestezjologia : anestezjologia : (rzecz.) anaesthesiology
aneuryna : aneuryna : (rzecz.) thiamine
anewryzm : anewryzm : (rzecz.) aneurism | : (rzecz.) aneurysm
angaz : angaż : (rzecz.) contract | : (rzecz.) engagement
angazowac : angażować : (czas.) engage | : (czas.) enrol | : (czas.) hire | : (czas.) involve
angina : angina : (rzecz.) angina
anglez : anglez : (rzecz.) frock-coat
anglezyt : anglezyt : (rzecz.) anglesite
anglikanin : anglikanin : (rzecz.) Anglican | : (rzecz.) protestant
anglikanizm : anglikanizm : (rzecz.) Anglicanism
anglizowac : anglizować : (czas.) anglicize
anglofil : anglofil : (rzecz.) anglophile
anglosaski : anglosaski : (przym.) Anglo-Saxon
angstrem : angstrem : (rzecz.) angst | : (rzecz.) angstrom
anhydryt : anhydryt : (rzecz.) anhydrite
ani : ani : (spójnik) nor | : (spójnik) or
anielski : anielski : (przym.) angelic | : (przym.) angelical
anielsko : anielsko : (przysł.) angelically
anihilacja : anihilacja : (rzecz.) annihilation | : (rzecz.) dematerialization
anihilator : anihilator : (rzecz.) annihilator
anihilowac : anihilować : (czas.) annihilate | : (czas.) destroy
anilana : anilana : (rzecz.) aniline
anilina : anilina : (rzecz.) aniline
animacja : animacja : (rzecz.) animation
animalista : animalista : (rzecz.) animalist
animalizm : animalizm : (rzecz.) animalism
animator : animator : (rzecz.) animator
animista : animista : (rzecz.) animist
animistyczny : animistyczny : (przym.) animistic
animizm : animizm : (rzecz.) animism
animowac : animować : (czas.) animate | : (czas.) enliven
animozja : animozja : (rzecz.) animosity
animusz : animusz : (rzecz.) animation | : (rzecz.) breeziness | : (rzecz.) courage | : (rzecz.) pep | : (rzecz.) spirit | : (rzecz.) vigour
anion : anion : (rzecz.) anion | : (rzecz.) anions
anionowy : anionowy : (przym.) anionic
aniol : anioł : (rzecz.) angel | : (rzecz.) angelus
anizotropia : anizotropia : (rzecz.) anisotropy
anizotropowy : anizotropowy : (przym.) anisotropic
anizeli : aniżeli : (spójnik) than
ankieta : ankieta : (rzecz.) inquiry | : (rzecz.) poll | : (rzecz.) questionnaire | : (rzecz.) survey
ankieter : ankieter : (rzecz.) enumerator | : (rzecz.) interviewer | : (rzecz.) pollster
ankietowac : ankietować : (czas.) poll
annalista : annalista : (rzecz.) annalist
annaly : annały : (rzecz.) annals
anoda : anoda : (rzecz.) anode | : (rzecz.) anodes | : (rzecz.) scrapbook
anodowy : anodowy : (przym.) anodal | : (przym.) anodic
anodyzacja : anodyzacja : (rzecz.) anodizing
anomalia : anomalia : (rzecz.) anomaly
anomalny : anomalny : (przym.) anomalous
anonim : anonim : (rzecz.) anonym
anonimowo : anonimowo : (przysł.) anonymously | : (przysł.) incognito
anonimowosc : anonimowość : (rzecz.) anonymity
anonimowy : anonimowy : (przym.) anonymous
anons : anons : (rzecz.) advertisement | : (rzecz.) announcement
anonsowac : anonsować : (czas.) advertise | : (czas.) announce
anoreksja : anoreksja : (rzecz.) anorexia
anormalnie : anormalnie : (przysł.) abnormally
anormalnosc : anormalność : (rzecz.) abnormality
anormalny : anormalny : (przym.) aberrant | : (przym.) abnormal | : (przym.) anomalous
antaba : antaba : (rzecz.) bolt | : (rzecz.) handle
antagonista : antagonista : (rzecz.) antagonist
antagonistyczny : antagonistyczny : (przym.) adversarial | : (przym.) antagonistic
antagonizm : antagonizm : (rzecz.) antagonism
antagonizowac : antagonizować : (czas.) antagonize
antalek : antałek : (rzecz.) cask
antena : antena : (rzecz.) aerial | : (rzecz.) antenna
antenat : antenat : (rzecz.) ancestor | : (rzecz.) forefather | : (rzecz.) progenitor
antenatka : antenatka : (rzecz.) ancestress
antidotum : antidotum : (rzecz.) antidote
antologia : antologia : (rzecz.) anthology
antologiczny : antologiczny : (przym.) anthological
antonim : antonim : (rzecz.) antonym
antracyt : antracyt : (rzecz.) anthracite
antrakt : antrakt : (rzecz.) interlude | : (rzecz.) intermission | : (rzecz.) interval
antresola : antresola : (rzecz.) entresol | : (rzecz.) mezzanine
antropocentryzm : antropocentryzm : (rzecz.) anthropocentrism
antropofagia : antropofagia : (rzecz.) cannibalism
antropogeneza : antropogeneza : (rzecz.) anthropogenesis
antropogeniczny : antropogeniczny : (przym.) anthropogenic
antropoidalny : antropoidalny : (przym.) anthropogenic | : (przym.) subhuman
antropolog : antropolog : (rzecz.) anthropologist
antropologia : antropologia : (rzecz.) anthropology
antropologiczny : antropologiczny : (przym.) anthropological
antropometria : antropometria : (rzecz.) anthropometry
antropomorficzny : antropomorficzny : (przym.) anthropomorphic
antropomorfizm : antropomorfizm : (rzecz.) anthropomorphism
antrykot : antrykot : (rzecz.) blade | : (rzecz.) entrecote
antyalkoholowy : antyalkoholowy : (przym.) teetotal
antybakteryjny : antybakteryjny : (przym.) antibacterial
antybiotyk : antybiotyk : (rzecz.) antibiotic
antybioza : antybioza : (rzecz.) antibiosis
antychryst : antychryst : (rzecz.) antichrist
antycyklon : antycyklon : (rzecz.) anticyclone
antycypacja : antycypacja : (rzecz.) anticipation
antycypacyjny : antycypacyjny : (przym.) anticipatory
antycypowac : antycypować : (czas.) anticipate | : (czas.) forestalls
antyczny : antyczny : (przym.) ancient | : (przym.) antique
antyczastka : antycząstka : (rzecz.) antiparticle
antydatowac : antydatować : (czas.) antedate | : (czas.) backdate | : (czas.) predate
antydepresyjny : antydepresyjny : (przym.) antidepressant
antydopingowy : antydopingowy : (przym.) anti-doping
antydumpingowy : antydumpingowy : (przym.) anti-dumping
antyelektron : antyelektron : (rzecz.) positron
antyfaszysta : antyfaszysta : (rzecz.) antifascist
antyfaszystowski : antyfaszystowski : (przym.) antifascist | : (przym.) anti-fascist
antyfaszyzm : antyfaszyzm : (rzecz.) anti-fascism
antyfeminista : antyfeminista : (rzecz.) antifeminist | : (rzecz.) misogynist | : (rzecz.) woman-hater
antyfraza : antyfraza : (rzecz.) antiphrasis
antygen : antygen : (rzecz.) antigen
antygenowy : antygenowy : (przym.) antigenic
antyimperialistyczny : antyimperialistyczny : (przym.) anti-imperialistic
antyinflacyjny : antyinflacyjny : (przym.) anti-inflationary
antyk : antyk : (rzecz.) antique | : (rzecz.) antiquity
antykatoda : antykatoda : (rzecz.) anticathode
antyklerykalny : antyklerykalny : (przym.) anticlerical
antyklina : antyklina : (rzecz.) anticline | : (rzecz.) saddlebag
antykomunista : antykomunista : (rzecz.) anticommunist
antykomunizm : antykomunizm : (rzecz.) anticommunism
antykoncepcja : antykoncepcja : (rzecz.) contraception
antykoncepcyjny : antykoncepcyjny : (przym.) contraceptive
antykorozyjny : antykorozyjny : (przym.) anticorrosive
antykwa : antykwa : (rzecz.) roman
antykwariat : antykwariat : (rzecz.) apparel | : (rzecz.) bookshop
antykwariusz : antykwariusz : (rzecz.) antiquarian | : (rzecz.) antiquary
antykwarski : antykwarski : (przym.) antiquarian | : (przym.) second-hand
antykwaryczny : antykwaryczny : (przym.) antiquarian | : (przym.) second-hand
antylogarytm : antylogarytm : (rzecz.) antilog | : (rzecz.) antilogarithm
antylopa : antylopa : (rzecz.) antelope
antyludowy : antyludowy : (przym.) antisocial
antymagnetyczny : antymagnetyczny : (przym.) nonmagnetic
antymateria : antymateria : (rzecz.) antimatter
antymilitaryzm : antymilitaryzm : (rzecz.) pacifism
antymon : antymon : (rzecz.) antimony
antymonit : antymonit : (rzecz.) antimonite | : (rzecz.) stibnite
antymonopolowy : antymonopolowy : (przym.) antitrust | : (przym.) anti-trust
antynaukowy : antynaukowy : (przym.) antiscientific
antyneutrino : antyneutrino : (rzecz.) antineutrino
antyneutron : antyneutron : (rzecz.) antineutron
antynomia : antynomia : (rzecz.) antimony | : (rzecz.) antinomy
antynuklearny : antynuklearny : (przym.) antinuclear
antypasat : antypasat : (rzecz.) antitrade
antypasaty : antypasaty : (przym.) antitrades
antypatia : antypatia : (rzecz.) antipathy | : (rzecz.) dislike | : (rzecz.) distaste
antypatyczny : antypatyczny : (przym.) antipathetic | : (przym.) repulsive | : (przym.) unsympathetic
antypanstwowy : antypaństwowy : (przym.) antinational
antypoda : antypoda : (rzecz.) antipode
antypodyczny : antypodyczny : (przym.) antipodal
antypokojowy : antypokojowy : (przym.) bellicose
antyproton : antyproton : (rzecz.) antiproton
antyrewolucyjny : antyrewolucyjny : (przym.) antirevolutionary
antysanitarny : antysanitarny : (przym.) unsanitary
antysemicki : antysemicki : (przym.) anti-Semitic
antysemita : antysemita : (rzecz.) anti-Semite
antysemityzm : antysemityzm : (rzecz.) anti-Semitism
antyseptycznie : antyseptycznie : (przysł.) antiseptically
antyseptyczny : antyseptyczny : (przym.) antiseptic
antyseptyk : antyseptyk : (rzecz.) antiseptic
antyseptyka : antyseptyka : (rzecz.) antisepsis
antyspoleczny : antyspołeczny : (przym.) antisocial | : (przym.) dissociable
antystatyczny : antystatyczny : (przym.) antistatic
antystrofa : antystrofa : (rzecz.) antistrophe
antytetyczny : antytetyczny : (przym.) antithetic
antyteza : antyteza : (rzecz.) antithesis
antytoksyczny : antytoksyczny : (przym.) antitoxic
antytoksyna : antytoksyna : (rzecz.) antitoxin
antytrustowy : antytrustowy : (przym.) antitrust
antyutleniacz : antyutleniacz : (rzecz.) antioxidant
antywirus : antywirus : (rzecz.) antivirus
antywojenny : antywojenny : (przym.) antiwar | : (przym.) anti-war
anulowanie : anulowanie : (rzecz.) annulment | : (rzecz.) cancel | : (rzecz.) cancellation | : (rzecz.) defeasance | : (rzecz.) nullification
anulowac : anulować : (czas.) abate | : (czas.) abort | : (czas.) annul | : (czas.) cancel | : (czas.) delete | : (czas.) kill | : (czas.) nullify | : (czas.) undo | : (czas.) vacate
anyz : anyż : (rzecz.) anise | : (rzecz.) aniseed
anyzowy : anyżowy : (przym.) aniseed
anyzowka : anyżówka : (rzecz.) anisette
aorta : aorta : (rzecz.) aorta
aoryst : aoryst : (rzecz.) aorist
aparat : aparat : (rzecz.) apparatus | : (rzecz.) camera
aparatczyk : aparatczyk : (rzecz.) apparatchik
aparatura : aparatura : (rzecz.) apparatus | : (rzecz.) machinery | : (rzecz.) outfit
aparaturowy : aparaturowy : (przym.) instrumental
apartament : apartament : (rzecz.) apartment | : (rzecz.) kit | : (rzecz.) penthouse | : (rzecz.) suite
apartheid : apartheid : (rzecz.) apartheid
aparycja : aparycja : (rzecz.) apparition | : (rzecz.) look
apaszka : apaszka : (rzecz.) cravat | : (rzecz.) neckerchief | : (rzecz.) scarf
apatia : apatia : (rzecz.) apathy | : (rzecz.) indifference | : (rzecz.) malaise
apatycznie : apatycznie : (przysł.) apathetically | : (przysł.) listlessly
apatycznosc : apatyczność : (rzecz.) languor
apatyczny : apatyczny : (przym.) apathetic | : (przym.) lackadaisical | : (przym.) languid | : (przym.) listless | : (przym.) musty | : (przym.) torpid
apatyt : apatyt : (rzecz.) apatite
apel : apel : (rzecz.) appeal | : (rzecz.) call | : (rzecz.) muster | : (rzecz.) plea
apelacja : apelacja : (rzecz.) appeal
apelacyjny : apelacyjny : (przym.) appellate
apelant : apelant : (rzecz.) appealer | : (rzecz.) appellant
apelowac : apelować : (czas.) appeal | : (czas.) push
apertura : apertura : (rzecz.) aperture
apetycznie : apetycznie : (przysł.) appetizingly | : (przysł.) fetchingly | : (przysł.) invitingly
apetyczny : apetyczny : (przym.) appetising | : (przym.) appetizing | : (przym.) attractive | : (przym.) mouth-watering | : (przym.) tasty | : (przym.) toothsome
apetyt : apetyt : (rzecz.) appetite | : (rzecz.) desire
aplauz : aplauz : (rzecz.) applause | : (rzecz.) cheer | : (rzecz.) plaudit
aplet : aplet : (rzecz.) applet
aplikacja : aplikacja : (rzecz.) application | : (rzecz.) appliqué | : (rzecz.) apprenticeship
aplikant : aplikant : (rzecz.) applicant | : (rzecz.) apprentice | : (rzecz.) novice | : (rzecz.) trainee
aplikantura : aplikantura : (rzecz.) apprenticeship
aplikatura : aplikatura : (rzecz.) fingering
aplikowac : aplikować : (czas.) administer | : (czas.) apply | : (czas.) dose
aplit : aplit : (rzecz.) haplite
apodyktycznie : apodyktycznie : (przysł.) authoritatively | : (przysł.) dogmatically
apodyktycznosc : apodyktyczność : (rzecz.) dogmatism | : (rzecz.) self-assertion
apodyktyczny : apodyktyczny : (przym.) apodictic | : (przym.) assertive | : (przym.) bossy | : (przym.) domineering | : (przym.) overbearing
apofonia : apofonia : (rzecz.) ablaut
apoftegmat : apoftegmat : (rzecz.) apothegm
apogeum : apogeum : (rzecz.) apogee | : (rzecz.) climax | : (rzecz.) height | : (rzecz.) zenith
apokalipsa : apokalipsa : (rzecz.) apocalypse | : (rzecz.) revelation
apokaliptyczny : apokaliptyczny : (przym.) apocalyptic | : (przym.) apocalyptical
apokryf : apokryf : (rzecz.) apocrypha
apokryficzny : apokryficzny : (przym.) apocryphal
apolitycznosc : apolityczność : (rzecz.) non-political
apolityczny : apolityczny : (przym.) non-political
apolog : apolog : (rzecz.) apologue
apologeta : apologeta : (rzecz.) apologist
apologetyczny : apologetyczny : (przym.) apologetic
apologia : apologia : (rzecz.) apologue | : (rzecz.) apology
apopleksja : apopleksja : (rzecz.) apoplexy | : (rzecz.) stroke
apoplektyczny : apoplektyczny : (przym.) apoplectic
aporter : aporter : (rzecz.) retriever
aportowac : aportować : (czas.) fetch | : (czas.) retrieve
apostata : apostata : (rzecz.) apostate
apostazja : apostazja : (rzecz.) apostasy
apostolski : apostolski : (przym.) apostolic
apostolstwo : apostolstwo : (rzecz.) apostolate
apostol : apostoł : (rzecz.) apostle
apostolowac : apostołować : (czas.) evangelize
apostrof : apostrof : (rzecz.) apostrophe
apostrofa : apostrofa : (rzecz.) apostrophe
apotema : apotema : (rzecz.) apothem
apoteoza : apoteoza : (rzecz.) apotheosis
apoteozowac : apoteozować : (czas.) glorify
apozycja : apozycja : (rzecz.) apposition
apretowac : apretować : (czas.) finish
apretura : apretura : (rzecz.) aperture | : (rzecz.) dressing | : (rzecz.) finish
apreturowanie : apreturowanie : (rzecz.) seasoning
aprioryczny : aprioryczny : (przym.) priori
aprobata : aprobata : (rzecz.) adhesion | : (rzecz.) applause | : (rzecz.) approbation | : (rzecz.) approval | : (rzecz.) praise | : (rzecz.) sanction | : (rzecz.) tumbler
aprobowac : aprobować : (czas.) approbate | : (czas.) approve | : (czas.) connive | : (czas.) countenance
aproksymacja : aproksymacja : (rzecz.) approximation | : (rzecz.) approximations
aproksymowac : aproksymować : (czas.) approximate
aprowizator : aprowizator : (rzecz.) caterer | : (rzecz.) purveyor
apsyda : apsyda : (rzecz.) apse
apteczka : apteczka : (rzecz.) medicine-chest
apteczny : apteczny : (przym.) officinal | : (przym.) pharmaceutical
apteka : apteka : (rzecz.) chemist | : (rzecz.) chemist's | : (rzecz.) dispensary | : (rzecz.) druggist | : (rzecz.) drugstore | : (rzecz.) pharmacy
aptekarski : aptekarski : (przym.) officinal
aptekarstwo : aptekarstwo : (rzecz.) pharmacy
aptekarz : aptekarz : (rzecz.) apothecary | : (rzecz.) chemist | : (rzecz.) dispenser | : (rzecz.) druggist | : (rzecz.) pharmacist
ar : ar : (rzecz.) are | : (rzecz.) macaw
ara : ara : (rzecz.) macaw
arabeska : arabeska : (rzecz.) arabesque
arachid : arachid : (rzecz.) groundnut | : (rzecz.) peanut
aragonit : aragonit : (rzecz.) aragonite
arak : arak : (rzecz.) arrack
aranzacja : aranżacja : (rzecz.) arrangement | : (rzecz.) design
aranzer : aranżer : (rzecz.) arranger | : (rzecz.) organizer
aranzowac : aranżować : (czas.) arrange
araukaria : araukaria : (rzecz.) araucaria
arbiter : arbiter : (rzecz.) arbitrator | : (rzecz.) moderator | : (rzecz.) peacemaker | : (rzecz.) peace-maker | : (rzecz.) referee | : (rzecz.) umpire
arbitralnosc : arbitralność : (rzecz.) arbitrariness
arbitralny : arbitralny : (przym.) arbitrary | : (przym.) highhanded | : (przym.) high-handed
arbitraz : arbitraż : (rzecz.) arbitrage | : (rzecz.) arbitration
arbitrazowy : arbitrażowy : (przym.) arbitral
arbuz : arbuz : (rzecz.) watermelon
archaicznosc : archaiczność : (rzecz.) anarchism
archaiczny : archaiczny : (przym.) anarchic | : (przym.) archaic
archaizm : archaizm : (rzecz.) archaism
archaizowac : archaizować : (czas.) archaize
archaniol : archanioł : (rzecz.) archangel | : (rzecz.) room
archeolog : archeolog : (rzecz.) archaeologist
archeologia : archeologia : (rzecz.) archaeology
archeologiczny : archeologiczny : (przym.) archaeological
archetyp : archetyp : (rzecz.) archetype
archidiakon : archidiakon : (rzecz.) archdeacon
archidiecezja : archidiecezja : (rzecz.) archdiocese
archimandryta : archimandryta : (rzecz.) archimandrite
archipelag : archipelag : (rzecz.) archipelago
architekt : architekt : (rzecz.) architect
architektonicznie : architektonicznie : (przysł.) architecturally
architektoniczny : architektoniczny : (przym.) architectonic | : (przym.) architectural
architektonika : architektonika : (rzecz.) architectonics | : (rzecz.) tectonics
architektura : architektura : (rzecz.) architecture
architraw : architraw : (rzecz.) architrave
archiwalny : archiwalny : (przym.) archival
archiwariusz : archiwariusz : (rzecz.) archivist | : (rzecz.) registrar
archiwista : archiwista : (rzecz.) archivist | : (rzecz.) registrar
archiwistyka : archiwistyka : (rzecz.) archive
archiwizacja : archiwizacja : (rzecz.) archive | : (rzecz.) archiving | : (rzecz.) filing
archiwizowanie : archiwizowanie : (rzecz.) archive | : (rzecz.) archiving
archiwizowac : archiwizować : (czas.) archive
archiwolta : archiwolta : (rzecz.) archivolt
archiwowanie : archiwowanie : (rzecz.) archiving
archiwowac : archiwować : (czas.) archive
archiwum : archiwum : (rzecz.) archive | : (rzecz.) archives
archont : archont : (rzecz.) archon
arcybiskup : arcybiskup : (rzecz.) archbishop
arcybiskupstwo : arcybiskupstwo : (rzecz.) archbishopric
arcydzielo : arcydzieło : (rzecz.) masterpiece
arcydziegiel : arcydzięgiel : (rzecz.) angelica | : (rzecz.) ash
arcykaplan : arcykapłan : (rzecz.) archpriest | : (rzecz.) pontiff
arcyksiaze : arcyksiążę : (rzecz.) archduke
arcyksiazecy : arcyksiążęcy : (przym.) archducal
arcyksiestwo : arcyksięstwo : (rzecz.) archduchy
arcypasterz : arcypasterz : (rzecz.) bishops
areal : areał : (rzecz.) acreage | : (rzecz.) area
arena : arena : (rzecz.) arena
arenda : arenda : (rzecz.) lease | : (rzecz.) leasehold | : (rzecz.) leasing
arendarz : arendarz : (rzecz.) publican
arendowac : arendować : (czas.) lease
areometr : areometr : (rzecz.) densitometer | : (rzecz.) hydrometer
areszt : areszt : (rzecz.) array | : (rzecz.) arrest | : (rzecz.) attention | : (rzecz.) custody | : (rzecz.) detention | : (rzecz.) glasshouse | : (rzecz.) joint | : (rzecz.) retention
aresztant : aresztant : (rzecz.) arrestee | : (rzecz.) convict
aresztowanie : aresztowanie : (rzecz.) apprehension | : (rzecz.) arrest | : (rzecz.) seizure
aresztowac : aresztować : (czas.) apprehend | : (czas.) arrest | : (czas.) detain
argentyt : argentyt : (rzecz.) argentite
argon : argon : (rzecz.) argon
argument : argument : (rzecz.) argument | : (rzecz.) operand
argumentacja : argumentacja : (rzecz.) argumentation | : (rzecz.) reasoning | : (rzecz.) submersion
argumentator : argumentator : (rzecz.) debater
argumentowanie : argumentowanie : (rzecz.) arguing | : (rzecz.) argumentation
argumentowac : argumentować : (czas.) argue | : (czas.) plead | : (czas.) submit
aria : aria : (rzecz.) aria
ariergarda : ariergarda : (rzecz.) rearguard
arka : arka : (rzecz.) ark
arkada : arkada : (rzecz.) arcade
arkadowy : arkadowy : (przym.) arcaded
arkady : arkady : (rzecz.) arcade
arkan : arkan : (rzecz.) lariat
arktyczny : arktyczny : (przym.) arctic
arkusz : arkusz : (rzecz.) postcard | : (rzecz.) sheet | : (rzecz.) spreadsheet
arlekin : arlekin : (rzecz.) harlequin
arlekinada : arlekinada : (rzecz.) buffoonery | : (rzecz.) harlequinade
armata : armata : (rzecz.) cannon | : (rzecz.) gun
armatka : armatka : (rzecz.) gun
armator : armator : (rzecz.) outfitter | : (rzecz.) owner
armatura : armatura : (rzecz.) armament | : (rzecz.) armature | : (rzecz.) fitting | : (rzecz.) fittings | : (rzecz.) fixture | : (rzecz.) reinforcement
armia : armia : (rzecz.) army
arogancja : arogancja : (rzecz.) arrogance | : (rzecz.) haughtiness
arogancki : arogancki : (przym.) arrogant | : (przym.) brash | : (przym.) overweening | : (przym.) pert | : (przym.) presumptuous | : (przym.) rude
arogancko : arogancko : (przysł.) arrogantly
aromat : aromat : (rzecz.) aroma | : (rzecz.) fragrance | : (rzecz.) odour | : (rzecz.) savour | : (rzecz.) scent | : (rzecz.) zest
aromaterapia : aromaterapia : (rzecz.) aromatherapy
aromatycznie : aromatycznie : (przysł.) aromatically | : (przysł.) fragrantly
aromatyczny : aromatyczny : (przym.) aromatic | : (przym.) fragrant | : (przym.) redolent | : (przym.) savoury | : (przym.) spicy | : (przym.) tangy
aromatyzacja : aromatyzacja : (rzecz.) aromatization
aromatyzowac : aromatyzować : (czas.) aromatize
arsen : arsen : (rzecz.) arsenic
arsenal : arsenał : (rzecz.) armoury | : (rzecz.) arsenal
arsenek : arsenek : (rzecz.) arsenide
arseniak : arseniak : (rzecz.) arsine
arsenian : arsenian : (rzecz.) arsenate
arsenowodor : arsenowodór : (rzecz.) arsine
arsenowy : arsenowy : (przym.) arsenic
arsyna : arsyna : (rzecz.) arsine
arszenik : arszenik : (rzecz.) arsenic
artefakt : artefakt : (rzecz.) artefact
arteria : arteria : (rzecz.) artery | : (rzecz.) thoroughfare
arterioskleroza : arterioskleroza : (rzecz.) arteriosclerosis
artezyjski : artezyjski : (przym.) artesian
artretyczny : artretyczny : (przym.) arthritic | : (przym.) gouty
artretyzm : artretyzm : (rzecz.) arthritis
artykulacja : artykulacja : (rzecz.) articulation
artykulik : artykulik : (rzecz.) par
artykul : artykuł : (rzecz.) article | : (rzecz.) commodity | : (rzecz.) contribution | : (rzecz.) editorial | : (rzecz.) implement | : (rzecz.) item | : (rzecz.) paper | : (rzecz.) story | : (rzecz.) vet
artykulowac : artykułować : (czas.) articulate
artykuly : artykuły : (rzecz.) articles
artyleria : artyleria : (rzecz.) artillery | : (rzecz.) gunnery | : (rzecz.) ordnance
artylerzysta : artylerzysta : (rzecz.) artillerist | : (rzecz.) artilleryman | : (rzecz.) artillery-man | : (rzecz.) gunner
artysta : artysta : (rzecz.) artist | : (rzecz.) artiste | : (rzecz.) craftsman | : (rzecz.) entertainer
artystycznie : artystycznie : (przysł.) artistically
artystyczny : artystyczny : (przym.) artistic | : (przym.) longhaired | : (przym.) long-haired
artyzm : artyzm : (rzecz.) artistry
aryjski : aryjski : (przym.) Aryan
aryl : aryl : (rzecz.) aryl
arystokracja : arystokracja : (rzecz.) aristocracy | : (rzecz.) nobility | : (rzecz.) peerage | : (rzecz.) rank
arystokrata : arystokrata : (rzecz.) aristocrat | : (rzecz.) nobleman
arystokratyczny : arystokratyczny : (przym.) aristocratic | : (przym.) patrician
arytmetycznie : arytmetycznie : (przysł.) arithmetically
arytmetyczny : arytmetyczny : (przym.) arithmetic | : (przym.) arithmetical
arytmetyk : arytmetyk : (rzecz.) arithmetician
arytmetyka : arytmetyka : (rzecz.) arithmetic | : (rzecz.) sum
arytmia : arytmia : (rzecz.) arrhythmia
arytmometr : arytmometr : (rzecz.) calculator
as : as : (rzecz.) ace
asceta : asceta : (rzecz.) ascetic
ascetyczny : ascetyczny : (przym.) ascetic | : (przym.) ascetical
ascetyzm : ascetyzm : (rzecz.) asceticism
asceza : asceza : (rzecz.) asceticism
aseksualny : aseksualny : (przym.) asexual
asekuracja : asekuracja : (rzecz.) assurance | : (rzecz.) insurance
asekurant : asekurant : (rzecz.) underwriter
asekurowac : asekurować : (czas.) insure
asembler : asembler : (rzecz.) assembler
asenizacja : asenizacja : (rzecz.) sanitation
aseptycznie : aseptycznie : (przysł.) aseptically
aseptyczny : aseptyczny : (przym.) aseptic
aseptyka : aseptyka : (rzecz.) asepsis
asercja : asercja : (rzecz.) assertion
asertywnosc : asertywność : (rzecz.) assertiveness | : (rzecz.) self-assertion
asertywny : asertywny : (przym.) assertive | : (przym.) self-assertive
asesor : asesor : (rzecz.) assessor
asfalt : asfalt : (rzecz.) asphalt | : (rzecz.) bitumen | : (rzecz.) tarmac
asfaltowanie : asfaltowanie : (rzecz.) asphalt
asfaltowac : asfaltować : (czas.) asphalt
askorbinowy : askorbinowy : (przym.) ascorbic
asocjacja : asocjacja : (rzecz.) association
asocjacyjny : asocjacyjny : (przym.) associational | : (przym.) associative
asonans : asonans : (rzecz.) assonance
asonansowy : asonansowy : (przym.) assonant
asortyment : asortyment : (rzecz.) assortment | : (rzecz.) range
aspekt : aspekt : (rzecz.) aspect | : (rzecz.) dimension
aspektowy : aspektowy : (przym.) aspectual
aspiracja : aspiracja : (rzecz.) ambition | : (rzecz.) aspiration
aspirant : aspirant : (rzecz.) aspirant | : (rzecz.) candidate | : (rzecz.) midshipman
aspirata : aspirata : (rzecz.) aspirate
aspirator : aspirator : (rzecz.) aspirator
aspirowac : aspirować : (czas.) aspirate | : (czas.) aspire
aspiryna : aspiryna : (rzecz.) aspirin
aspoleczny : aspołeczny : (przym.) antisocial | : (przym.) asocial
astat : astat : (rzecz.) astatine
astenia : astenia : (rzecz.) asthenia
asteniczny : asteniczny : (przym.) weak
aster : aster : (rzecz.) aster
asteroida : asteroida : (rzecz.) asteroid
asterysk : asterysk : (rzecz.) asterisk
asteryzm : asteryzm : (rzecz.) asterism
astma : astma : (rzecz.) asthma
astmatyczny : astmatyczny : (przym.) asthmatic
astmatyk : astmatyk : (rzecz.) asthmatic
astralny : astralny : (przym.) astral
astrobiologia : astrobiologia : (rzecz.) astrobiology
astrofizyka : astrofizyka : (rzecz.) astrophysics
astrofotografia : astrofotografia : (rzecz.) astrophotography
astrograf : astrograf : (rzecz.) astrograph
astrokompas : astrokompas : (rzecz.) astrocompass
astrokopula : astrokopuła : (rzecz.) astrodome
astrolabium : astrolabium : (rzecz.) astrolabe
astrolog : astrolog : (rzecz.) astrologer | : (rzecz.) astrologist
astrologia : astrologia : (rzecz.) astrology
astrologiczny : astrologiczny : (przym.) astrologic | : (przym.) astrological
astrometria : astrometria : (rzecz.) astrometry
astronauta : astronauta : (rzecz.) astronaut | : (rzecz.) spaceman
astronautyka : astronautyka : (rzecz.) astronautics | : (rzecz.) astronomy | : (rzecz.) cosmonautics | : (rzecz.) space
astronawigacja : astronawigacja : (rzecz.) astronavigation
astronom : astronom : (rzecz.) astronomer | : (rzecz.) astronomers
astronomia : astronomia : (rzecz.) astronautics | : (rzecz.) astronomy
astronomiczny : astronomiczny : (przym.) astronomic | : (przym.) astronomical
astrowiezyczka : astrowieżyczka : (rzecz.) astrodome
astygmatyczny : astygmatyczny : (przym.) astigmatic
astygmatyzm : astygmatyzm : (rzecz.) astigmatism
asumpt : asumpt : (rzecz.) occasion
asygnacja : asygnacja : (rzecz.) assignation
asygnata : asygnata : (rzecz.) assignation | : (rzecz.) assignment
asygnowanie : asygnowanie : (rzecz.) appropriation | : (rzecz.) budgeting
asygnowac : asygnować : (czas.) allocate | : (czas.) allot | : (czas.) appropriate | : (czas.) earmark
asymetria : asymetria : (rzecz.) asymmetry | : (rzecz.) dissymmetry
asymetryczny : asymetryczny : (przym.) asymmetric | : (przym.) asymmetrical
asymilacja : asymilacja : (rzecz.) assimilation | : (rzecz.) uptake
asymilacyjny : asymilacyjny : (przym.) assimilative
asymilowac : asymilować : (czas.) assimilate
asymptota : asymptota : (rzecz.) asymptote
asymptotyczny : asymptotyczny : (przym.) asymptotic | : (przym.) asymptotical
asynchroniczny : asynchroniczny : (przym.) asynchronous
asysta : asysta : (rzecz.) assistance | : (rzecz.) company | : (rzecz.) escort
asystent : asystent : (rzecz.) aide | : (rzecz.) assistant | : (rzecz.) houseman | : (rzecz.) midshipman
asystentura : asystentura : (rzecz.) assistantship | : (rzecz.) assistantships
asystowac : asystować : (czas.) accompany | : (czas.) assist
atak : atak : (rzecz.) access | : (rzecz.) assault | : (rzecz.) attack | : (rzecz.) bout | : (rzecz.) fit | : (rzecz.) offensive | : (rzecz.) raid | : (rzecz.) spasm
atakowac : atakować : (czas.) affect | : (czas.) assail | : (czas.) assault | : (czas.) attack | : (czas.) attempt | : (czas.) charge | : (czas.) invade | : (czas.) strike | : (czas.) tilt
ataksja : ataksja : (rzecz.) ataxia
atawistyczny : atawistyczny : (przym.) atavistic
atawizm : atawizm : (rzecz.) atavism | : (rzecz.) reversion
ateista : ateista : (rzecz.) atheist | : (rzecz.) unbeliever
ateistyczny : ateistyczny : (przym.) atheistic
ateizm : ateizm : (rzecz.) atheism
atelier : atelier : (rzecz.) atelier
atencja : atencja : (rzecz.) attention | : (rzecz.) deference
atest : atest : (rzecz.) attestation | : (rzecz.) certificate
atestacja : atestacja : (rzecz.) attestation | : (rzecz.) validation
atestowac : atestować : (czas.) attest | : (czas.) certify
atlant : atlant : (rzecz.) atlas
atlas : atlas : (rzecz.) atlas
atleta : atleta : (rzecz.) athlete | : (rzecz.) strongman
atletycznie : atletycznie : (przysł.) athletically
atletyczny : atletyczny : (przym.) athletic
atletyka : atletyka : (rzecz.) athletics
atmosfera : atmosfera : (rzecz.) air | : (rzecz.) ambiance | : (rzecz.) ambience | : (rzecz.) atmosphere | : (rzecz.) character | : (rzecz.) mood
atmosferyczny : atmosferyczny : (przym.) atmospheric
atol : atol : (rzecz.) atoll
atom : atom : (rzecz.) atom | : (rzecz.) atomy
atomista : atomista : (rzecz.) atomist
atomistyczny : atomistyczny : (przym.) atomic
atomistyka : atomistyka : (rzecz.) atomics | : (rzecz.) atomism
atomizacja : atomizacja : (rzecz.) atomization
atomizm : atomizm : (rzecz.) atomism
atomizowac : atomizować : (czas.) atomize
atomowo : atomowo : (przysł.) atomically
atomowosc : atomowość : (rzecz.) atomicity
atomowy : atomowy : (przym.) atomic | : (przym.) atomics | : (przym.) nuclear
atonalnosc : atonalność : (rzecz.) atonality
atonalny : atonalny : (przym.) atonal
atrakcja : atrakcja : (rzecz.) attraction | : (rzecz.) diversion | : (rzecz.) excitement
atrakcyjnie : atrakcyjnie : (przysł.) attractively
atrakcyjnosc : atrakcyjność : (rzecz.) attraction | : (rzecz.) attractiveness | : (rzecz.) marketability
atrakcyjny : atrakcyjny : (przym.) attractive | : (przym.) desirable | : (przym.) fetching | : (przym.) good | : (przym.) good-looking | : (przym.) handsome | : (przym.) nice-looking
atrament : atrament : (rzecz.) ink
atramentowy : atramentowy : (przym.) inky
atrapa : atrapa : (rzecz.) catch | : (rzecz.) dummy
atrofia : atrofia : (rzecz.) atrophy | : (rzecz.) atrophying
atroficzny : atroficzny : (przym.) atrophied
atropina : atropina : (rzecz.) atropine | : (rzecz.) belladonna
atrybucja : atrybucja : (rzecz.) attribution
atrybut : atrybut : (rzecz.) attribute | : (rzecz.) characteristic
atrybutywny : atrybutywny : (przym.) attributive
attyka : attyka : (rzecz.) attic
atut : atut : (rzecz.) asset | : (rzecz.) ruff | : (rzecz.) trump
atypowy : atypowy : (przym.) atypical
atlas : atłas : (rzecz.) satin
atlasowy : atłasowy : (przym.) satin | : (przym.) satiny | : (przym.) silky
audiencja : audiencja : (rzecz.) audience
audiogram : audiogram : (rzecz.) audiogram
audiometr : audiometr : (rzecz.) audiometer
audiometryczny : audiometryczny : (przym.) audiometric
audiowizualny : audiowizualny : (przym.) audiovisual | : (przym.) audio-visual
audycja : audycja : (rzecz.) broadcast | : (rzecz.) show
audyt : audyt : (rzecz.) audit
audytor : audytor : (rzecz.) auditor | : (rzecz.) judge-advocate
audytorium : audytorium : (rzecz.) audience | : (rzecz.) auditorium
aukcja : aukcja : (rzecz.) auction | : (rzecz.) item | : (rzecz.) sale
auksanometr : auksanometr : (rzecz.) auxanometer
aula : aula : (rzecz.) hall
aura : aura : (rzecz.) weather
aureola : aureola : (rzecz.) aureole | : (rzecz.) halation | : (rzecz.) halo
aurypigment : aurypigment : (rzecz.) orpiment
auskultacja : auskultacja : (rzecz.) auscultation
auspicje : auspicje : (rzecz.) auspices | : (rzecz.) patronage
austenit : austenit : (rzecz.) austenite
austeria : austeria : (rzecz.) inn
auszpik : auszpik : (rzecz.) aspic
aut : aut : (rzecz.) cars
autarchia : autarchia : (rzecz.) autarchy
autarkia : autarkia : (rzecz.) autarchy | : (rzecz.) autarky
autentycznie : autentycznie : (przysł.) authentically
autentycznosc : autentyczność : (rzecz.) authenticity | : (rzecz.) genuineness
autentyczny : autentyczny : (przym.) authentic | : (przym.) genuine | : (przym.) kosher | : (przym.) literal | : (przym.) original | : (przym.) serious
autentyk : autentyk : (rzecz.) original
autentyzm : autentyzm : (rzecz.) authenticity
auto : auto : (rzecz.) auto
autoanaliza : autoanaliza : (rzecz.) self-analysis
autobiografia : autobiografia : (rzecz.) autobiography
autobiograficznie : autobiograficznie : (przysł.) autobiographically
autobiograficzny : autobiograficzny : (przym.) autobiographic | : (przym.) autobiographical
autobus : autobus : (rzecz.) bus | : (rzecz.) coach | : (rzecz.) jitney | : (rzecz.) motorbus | : (rzecz.) omnibus | : (rzecz.) terminus
autochton : autochton : (rzecz.) autochthon | : (rzecz.) foreigner
autochtoni : autochtoni : (rzecz.) aborigines
autochtoniczny : autochtoniczny : (przym.) autochthonous | : (przym.) indigenous | : (przym.) native
autochtonski : autochtoński : (przym.) autochthonous
autodestrukcja : autodestrukcja : (rzecz.) self-destruction
autodydakta : autodydakta : (rzecz.) self
autodydaktyczny : autodydaktyczny : (przym.) self-taught
autodyna : autodyna : (rzecz.) autodyne
autofilia : autofilia : (rzecz.) selfishness
autogeneza : autogeneza : (rzecz.) autogenesis
autogeniczny : autogeniczny : (przym.) autogenic
autograf : autograf : (rzecz.) autograph | : (rzecz.) signature
autografia : autografia : (rzecz.) autograph | : (rzecz.) autography
autografowanie : autografowanie : (rzecz.) autographing | : (rzecz.) autographs
autokar : autokar : (rzecz.) charabanc | : (rzecz.) char-a-banc | : (rzecz.) coach | : (rzecz.) motor-coach
autokataliza : autokataliza : (rzecz.) autocatalysis
autoklaw : autoklaw : (rzecz.) autoclave
autokorelacja : autokorelacja : (rzecz.) autocorrelation
autokracja : autokracja : (rzecz.) autarky | : (rzecz.) autocracy
autokrata : autokrata : (rzecz.) autocrat
autokratyczny : autokratyczny : (przym.) autocratic
autokrytycyzm : autokrytycyzm : (rzecz.) self
autoliza : autoliza : (rzecz.) autolysis
automat : automat : (rzecz.) automaton | : (rzecz.) device
automatycznie : automatycznie : (przysł.) automatically
automatyczny : automatyczny : (przym.) automatic | : (przym.) self-acting
automatyka : automatyka : (rzecz.) automatic | : (rzecz.) automatics | : (rzecz.) automation
automatyzacja : automatyzacja : (rzecz.) automation
automatyzm : automatyzm : (rzecz.) automatism
automatyzowac : automatyzować : (czas.) automate
automobil : automobil : (rzecz.) automobile
automobilista : automobilista : (rzecz.) motorist
automobilizm : automobilizm : (rzecz.) motoring
autonomia : autonomia : (rzecz.) autonomy
autonomicznie : autonomicznie : (przysł.) autonomously
autonomiczny : autonomiczny : (przym.) autonomic | : (przym.) autonomous | : (przym.) offline | : (przym.) standalone
autonomista : autonomista : (rzecz.) autonomist
autopilot : autopilot : (rzecz.) autopilot
autoportret : autoportret : (rzecz.) self | : (rzecz.) self-portrait
autopsja : autopsja : (rzecz.) autopsy
autor : autor : (rzecz.) author | : (rzecz.) penman | : (rzecz.) writer
autorament : autorament : (rzecz.) class | : (rzecz.) sort
autoreklama : autoreklama : (rzecz.) self | : (rzecz.) self-advertisement | : (rzecz.) self-advertising
autorka : autorka : (rzecz.) authoress
autorotacja : autorotacja : (rzecz.) autorotation
autorski : autorski : (przym.) author's | : (przym.) copyright
autorstwo : autorstwo : (rzecz.) author | : (rzecz.) authorship
autorytarny : autorytarny : (przym.) authoritarian
autorytaryzm : autorytaryzm : (rzecz.) authoritarianism
autorytatywnosc : autorytatywność : (rzecz.) authoritarianism | : (rzecz.) dictatorship
autorytatywny : autorytatywny : (przym.) authoritarian | : (przym.) authoritative
autorytet : autorytet : (rzecz.) authority
autoryzacja : autoryzacja : (rzecz.) authentication | : (rzecz.) authorising | : (rzecz.) authorization
autoryzowanie : autoryzowanie : (rzecz.) authorization
autoryzowany : autoryzowany : (przym.) authorized
autoryzowac : autoryzować : (czas.) authorise | : (czas.) authorize
autostop : autostop : (rzecz.) gamble | : (rzecz.) hitch-hiking
autostopowicz : autostopowicz : (rzecz.) hitchhiker | : (rzecz.) hitch-hiker
autostrada : autostrada : (rzecz.) autobahn | : (rzecz.) expressway | : (rzecz.) freeway | : (rzecz.) highway | : (rzecz.) motorway | : (rzecz.) speedway | : (rzecz.) superhighway | : (rzecz.) throughway
autosugestia : autosugestia : (rzecz.) autosuggestion
autotransformator : autotransformator : (rzecz.) autotransformer
autotrof : autotrof : (rzecz.) autotrophic
autotypia : autotypia : (rzecz.) autotype
autowy : autowy : (przym.) out
autozyro : autożyro : (rzecz.) autogiro | : (rzecz.) gyroplane
autystyczny : autystyczny : (przym.) autistic
autyzm : autyzm : (rzecz.) autism
awangarda : awangarda : (rzecz.) avant-garde | : (rzecz.) vanguard
awangardowy : awangardowy : (przym.) avant-garde
awangardyzm : awangardyzm : (rzecz.) vanguard
awans : awans : (rzecz.) advance | : (rzecz.) advancement | : (rzecz.) brevet | : (rzecz.) breveted | : (rzecz.) position | : (rzecz.) preferment | : (rzecz.) promotion
awansowac : awansować : (czas.) advance | : (czas.) breveted | : (czas.) promote | : (czas.) promoted
awantaz : awantaż : (rzecz.) asset
awantura : awantura : (rzecz.) affray | : (rzecz.) bluster | : (rzecz.) brawl | : (rzecz.) broil | : (rzecz.) disturbance | : (rzecz.) fracas | : (rzecz.) fuss | : (rzecz.) quarrel | : (rzecz.) racket | : (rzecz.) row | : (rzecz.) ruction | : (rzecz.) rumpus | : (rzecz.) scandal | : (rzecz.) scene | : (rzecz.) scrimmage
awanturnictwo : awanturnictwo : (rzecz.) fussiness | : (rzecz.) rowdiness
awanturniczo : awanturniczo : (przysł.) rowdily | : (przysł.) stormily
awanturniczosc : awanturniczość : (rzecz.) fussiness
awanturniczy : awanturniczy : (przym.) adventurous | : (przym.) hazardous | : (przym.) rackety | : (przym.) rowdy | : (przym.) swashbuckling
awanturnik : awanturnik : (rzecz.) adventurer | : (rzecz.) brawler | : (rzecz.) pettifogger | : (rzecz.) rowdy | : (rzecz.) ruffian | : (rzecz.) wrangler
awanturowac : awanturować : (czas.) brawl | : (czas.) bully | : (czas.) hector
awaria : awaria : (rzecz.) accident | : (rzecz.) average | : (rzecz.) breakdown | : (rzecz.) catastrophe | : (rzecz.) damage | : (rzecz.) failure | : (rzecz.) incident | : (rzecz.) malfunction
awaryjnosc : awaryjność : (rzecz.) failure
awatar : awatar : (rzecz.) avatar
awers : awers : (rzecz.) obverse | : (rzecz.) side
awersja : awersja : (rzecz.) averseness | : (rzecz.) aversion | : (rzecz.) distaste
awifauna : awifauna : (rzecz.) avifauna
awionetka : awionetka : (rzecz.) airplane
awionika : awionika : (rzecz.) avionics
awizacja : awizacja : (rzecz.) notification
awizo : awizo : (rzecz.) advice | : (rzecz.) notice | : (rzecz.) notification
awizowac : awizować : (czas.) notify
awokado : awokado : (rzecz.) avocado
azalia : azalia : (rzecz.) azalea
azbest : azbest : (rzecz.) asbestos
azbestoza : azbestoza : (rzecz.) asbestosis
azot : azot : (rzecz.) nitrogen
azotan : azotan : (rzecz.) nitrate
azotawy : azotawy : (przym.) nitrous
azotek : azotek : (rzecz.) nitride
azotowanie : azotowanie : (rzecz.) nitration
azotowac : azotować : (czas.) nitrify
azotowy : azotowy : (przym.) nitric | : (przym.) nitrogenous
azotyn : azotyn : (rzecz.) nitrite
azuryt : azuryt : (rzecz.) azurite
azyl : azyl : (rzecz.) asylum | : (rzecz.) sanctuary | : (rzecz.) sanctum
azylant : azylant : (rzecz.) asylum
azymut : azymut : (rzecz.) azimuth
alamucic : ałamucić : (czas.) coquet
alun : ałun : (rzecz.) alum
az : aż : (spójnik) so | : (spójnik) till | : (spójnik) until
azeby : ażeby : (spójnik) for | : (spójnik) that
azio : ażio : (rzecz.) premium
azur : ażur : (rzecz.) openwork
azurek : ażurek : (rzecz.) hemstitch
azurowac : ażurować : (czas.) pink
