zeugmatic : (a.) Of or pertaining to zeugma; characterized by zeugma.
zygodactyle : (n.) Any zygodactylous bird.
zulus : (n. pl.) The most important tribe belonging to the Kaffir race. They inhabit a region on the southeast coast of Africa, but formerly occupied a much more extensive country. They are noted for their warlike disposition, courage, and military skill.
zoisite : (n.) A grayish or whitish mineral occurring in orthorhombic, prismatic crystals, also in columnar masses. It is a silicate of alumina and lime, and is allied to epidote.
zinciferous : (a.) Containing or affording zinc.
zechstein : (n.) The upper division of the Permian (Dyas) of Europe. The prevailing rock is a magnesian limestone.
zequin : (n.) See Sequin.
zealant : (n.) One who is zealous; a zealot; an enthusiast.
zootic : (a.) Containing the remains of organized bodies; said of rock or soil.
zoography : (n.) A description of animals, their forms and habits.
zooidal : (a.) Of or pertaining to a zooid; as, a zooidal form.
zantewood : (n.) A yellow dyewood; fustet; -- called also zante, and zante fustic. See Fustet, and the Note under Fustic. | : (n.) Satinwood (Chloroxylon Swietenia).
zygomorphic : (a.) Alt. of Zygomorphous
zincification : (n.) The act or process of applying zinc; the condition of being zincified, or covered with zinc; galvanization.
zambo : (n.) The child of a mulatto and a negro; also, the child of an Indian and a negro; colloquially or humorously, a negro; a sambo.
zechin : (n.) See Sequin.
zend : (n.) Properly, the translation and exposition in the Huzv/resh, or literary Pehlevi, language, of the Avesta, the Zoroastrian sacred writings; as commonly used, the language (an ancient Persian dialect) in which the Avesta is written.
zebrawood : (n.) A kind of cabinet wood having beautiful black, brown, and whitish stripes, the timber of a tropical American tree (Connarus Guianensis). | : (n.) The wood of a small West Indian myrtaceous tree (Eugenia fragrans). | : (n.) The wood of an East Indian tree of the genus Guettarda.
zopilote : (n.) The urubu, or American black vulture.
zoolatry : (n.) The worship of animals.
zygobranchiate : (a.) Of or pertaining to the Zygobranchia.
zinky : (a.) See Zincky.
zoilean : (a.) Having the characteristic of Zoilus, a bitter, envious, unjust critic, who lived about 270 years before Christ.
zymology : (n.) A treatise on the fermentation of liquors, or the doctrine of fermentation.
zincide : (n.) A binary compound of zinc.
zoologically : (adv.) In a zoological manner; according to the principles of zoology.
zymological : (a.) Of or pertaining to zymology.
zeros : (pl. ) of Zero
zosterops : (n.) A genus of birds that comprises the white-eyes. See White-eye.
zigzag : (n.) Something that has short turns or angles. | : (n.) A molding running in a zigzag line; a chevron, or series of chevrons. See Illust. of Chevron, 3. | : (n.) See Boyau. | : (a.) Having short, sharp turns; running this way and that in an onward course. | : (v. t.) To form with short turns. | : (v. i.) To move in a zigzag manner; also, to have a zigzag shape.
zax : (n.) A tool for trimming and puncturing roofing slates.
zehner : (n.) An Austrian silver coin equal to ten kreutzers, or about five cents.
zoomorphic : (a.) Of or pertaining to zoomorphism.
zygomatic : (a.) Of, pertaining to, or in the region of, the zygoma.
zymose : (n.) Invertin.
zygodactylae : (n. pl.) The zygodactylous birds. In a restricted sense applied to a division of birds which includes the barbets, toucans, honey guides, and other related birds.
zante : (n.) See Zantewood.
zygantrum : (n.) See under Zygosphene.
zantiot : (n.) A native or inhabitant of Zante, one of the Ionian Islands.
zymic : (a.) Pertaining to, or produced by, fermentation; -- formerly, by confusion, used to designate lactic acid.
zoophytological : (a.) Of or pertaining to zoophytology; as, zoophytological observations.
zonule : (n.) A little zone, or girdle.
zamang : (n.) An immense leguminous tree (Pithecolobium Saman) of Venezuela. Its branches form a hemispherical mass, often one hundred and eighty feet across. The sweet pulpy pods are used commonly for feeding cattle. Also called rain tree.
zoomorphism : (n.) The transformation of men into beasts. | : (n.) The quality of representing or using animal forms; as, zoomorphism in ornament. | : (n.) The representation of God, or of gods, in the form, or with the attributes, of the lower animals.
zocco : (n.) Alt. of Zoccolo
zythepsary : (n.) A brewery.
zoophagous : (a.) Feeding on animals.
zirconoid : (n.) A double eight-sided pyramid, a form common with tetragonal crystals; -- so called because this form often occurs in crystals of zircon.
zambos : (pl. ) of Zambo
zealed : (a.) Full of zeal; characterized by zeal.
zoochemistry : (n.) Animal chemistry; particularly, the description of the chemical compounds entering into the composition of the animal body, in distinction from biochemistry.
zodiac : (n.) An imaginary belt in the heavens, 16! or 18! broad, in the middle of which is the ecliptic, or sun's path. It comprises the twelve constellations, which one constituted, and from which were named, the twelve signs of the zodiac. | : (n.) A figure representing the signs, symbols, and constellations of the zodiac. | : (n.) A girdle; a belt.
zonate : (a.) Divided by parallel planes; as, zonate tetraspores, found in certain red algae.
zigzaggery : (n.) The quality or state of being zigzag; crookedness.
zittern : (n.) See Cittern.
zigzagged : (imp. & p. p.) of Zigzag
ziphioid : (n.) See Xiphioid.
zygapophysis : (n.) One of the articular processes of a vertebra, of which there are usually four, two anterior and two posterior. See under Vertebra.
zouave : (n.) One of an active and hardy body of soldiers in the French service, originally Arabs, but now composed of Frenchmen who wear the Arab dress. | : (n.) Hence, one of a body of soldiers who adopt the dress and drill of the Zouaves, as was done by a number of volunteer regiments in the army of the United States in the Civil War, 1861-65.
zedoary : (n.) A medicinal substance obtained in the East Indies, having a fragrant smell, and a warm, bitter, aromatic taste. It is used in medicine as a stimulant.
zincify : (v. t.) To coat or impregnate with zinc.
z : ( ) Z, the twenty-sixth and last letter of the English alphabet, is a vocal consonant. It is taken from the Latin letter Z, which came from the Greek alphabet, this having it from a Semitic source. The ultimate origin is probably Egyptian. Etymologically, it is most closely related to s, y, and j; as in glass, glaze; E. yoke, Gr. /, L. yugum; E. zealous, jealous.
zizania : (n.) A genus of grasses including Indian rice. See Indian rice, under Rice.
zymosis : (n.) A fermentation; hence, an analogous process by which an infectious disease is believed to be developed. | : (n.) A zymotic disease.
zinnwaldite : (n.) A kind of mica containing lithium, often associated with tin ore.
zobo : (n.) A kind of domestic cattle reared in Asia for its flesh and milk. It is supposed to be a hybrid between the zebu and the yak.
zoosporangium : (n.) A spore, or conceptacle containing zoospores.
zend-avesta : (n.) The sacred writings of the ancient Persian religion, attributed to Zoroaster, but chiefly of a later date.
zooecia : (pl. ) of Zooecium
zeolitic : (a.) Of or pertaining to a zeolite; consisting of, or resembling, a zeolite.
zumbooruk : (n.) A small cannon supported by a swiveled rest on the back of a camel, whence it is fired, -- used in the East.
zoophaga : (n. pl.) An artificial group comprising various carnivorous and insectivorous animals.
zygenid : (n.) Any one of numerous species of moths of the family Zygaenidae, most of which are bright colored. The wood nymph and the vine forester are examples. Also used adjectively.
zoochemy : (n.) Animal chemistry; zoochemistry.
zoocytia : (pl. ) of Zoocytium
zebu : (n.) A bovine mammal (Ros Indicus) extensively domesticated in India, China, the East Indies, and East Africa. It usually has short horns, large pendulous ears, slender legs, a large dewlap, and a large, prominent hump over the shoulders; but these characters vary in different domestic breeds, which range in size from that of the common ox to that of a large mastiff.
zygodactyl : (n.) Alt. of Zygodactyle
zincous : (a.) Of, pertaining to, or containing, zinc; zincic; as, zincous salts. | : (a.) Hence, formerly, basic, basylous, as opposed to chlorous. | : (a.) Of or pertaining to the positive pole of a galvanic battery; electro-positive.
zoologist : (n.) One who is well versed in zoology.
zero : (n.) A cipher; nothing; naught. | : (n.) The point from which the graduation of a scale, as of a thermometer, commences. | : (n.) Fig.: The lowest point; the point of exhaustion; as, his patience had nearly reached zero.
zoanthacea : (n. pl.) A suborder of Actinaria, including Zoanthus and allied genera, which are permanently attached by their bases.
zollverein : (n.) Literally, a customs union; specifically, applied to the several customs unions successively formed under the leadership of Prussia among certain German states for establishing liberty of commerce among themselves and common tariff on imports, exports, and transit.
zonure : (n.) Any one of several of South African lizards of the genus Zonura, common in rocky situations.
zoophoric : (a.) Bearing or supporting the figure of an animal; as, a zoophoric column.
zostera : (n.) A genus of plants of the Naiadaceae, or Pondweed family. Zostera marina is commonly known as sea wrack, and eelgrass.
zu/is : (n. pl.) A tribe of Pueblo Indians occupying a village in New Mexico, on the Zu/i River.
zetetic : (a.) Seeking; proceeding by inquiry. | : (n.) A seeker; -- a name adopted by some of the Pyrrhonists.
zea : (n.) A genus of large grasses of which the Indian corn (Zea Mays) is the only species known. Its origin is not yet ascertained. See Maize.
zoogeographical : (a.) Of or pertaining to zoography.
zed : (n.) The letter Z; -- called also zee, and formerly izzard.
ziega : (n.) Curd produced from milk by adding acetic acid, after rennet has ceased to cause coagulation.
zinkenite : (n.) A steel-gray metallic mineral, a sulphide of antimony and lead.
zaptiah : (n.) A Turkish policeman.
zaratite : (n.) A hydrous carbonate of nickel occurring as an emerald-green incrustation on chromite; -- called also emerald nickel.
zooid : (a.) Pertaining to, or resembling, an animal. | : (n.) An organic body or cell having locomotion, as a spermatic cell or spermatozooid. | : (n.) An animal in one of its inferior stages of development, as one of the intermediate forms in alternate generation. | : (n.) One of the individual animals in a composite group, as of Anthozoa, Hydroidea, and Bryozoa; -- sometimes restricted to those individuals in which the mouth and digestive organs are not developed.
zigzaggy : (a.) Having sharp turns.
zaffer : (n.) A pigment obtained, usually by roasting cobalt glance with sand or quartz, as a dark earthy powder. It consists of crude cobalt oxide, or of an impure cobalt arseniate. It is used in porcelain painting, and in enameling pottery, to produce a blue color, and is often confounded with smalt, from which, however, it is distinct, as it contains no potash. The name is often loosely applied to mixtures of zaffer proper with silica, or oxides of iron, manganese, etc.
zeroes : (pl. ) of Zero
zymometer : (n.) Alt. of Zymosimeter
zeugma : (n.) A figure by which an adjective or verb, which agrees with a nearer word, is, by way of supplement, referred also to another more remote; as, "hic illius arma, hic currus fuit;" where fuit, which agrees directly with currus, is referred also to arma.
zeuglodonta : (n. pl.) Same as Phocodontia.
zoea : (n.) A peculiar larval stage of certain decapod Crustacea, especially of crabs and certain Anomura.
zamouse : (n.) A West African buffalo (Bubalus brachyceros) having short horns depressed at the base, and large ears fringed internally with three rows of long hairs. It is destitute of a dewlap. Called also short-horned buffalo, and bush cow.
zorilla : (n.) Either one of two species of small African carnivores of the genus Ictonyx allied to the weasels and skunks.
zincode : (n.) The positive electrode of an electrolytic cell; anode.
zinnia : (n.) Any plant of the composite genus Zinnia, Mexican herbs with opposite leaves and large gay-colored blossoms. Zinnia elegans is the commonest species in cultivation.
zeal : (n.) Passionate ardor in the pursuit of anything; eagerness in favor of a person or cause; ardent and active interest; engagedness; enthusiasm; fervor. | : (n.) A zealot. | : (v. i.) To be zealous.
zemindary : (n.) Alt. of Zemindari
zaim : (n.) A Turkish chief who supports a mounted militia bearing the same name.
zain : (n.) A horse of a dark color, neither gray nor white, and having no spots.
zoogenic : (a.) Of or pertaining to zoogeny, animal production.
zealful : (a.) Full of zeal.
zymogenic : (a.) Pertaining to, or formed by, a zymogene. | : (a.) Capable of producing a definite zymogen or ferment.
zootomical : (a.) Of or pertaining to zootomy.
zythum : (n.) A kind of ancient malt beverage; a liquor made from malt and wheat.
zoologies : (pl. ) of Zoology
zoogloea : (n.) A colony or mass of bacteria imbedded in a viscous gelatinous substance. The zoogloea is characteristic of a transitory stage through which rapidly multiplying bacteria pass in the course of their evolution. Also used adjectively.
zandmole : (n.) The sand mole.
zemindar : (n.) Same as Zamindar.
zachun : (n.) An oil pressed by the Arabs from the fruit of a small thorny tree (Balanites Aegyptiaca), and sold to piligrims for a healing ointment.
zoroastrianism : (n.) The religious system of Zoroaster, the legislator and prophet of the ancient Persians, which was the national faith of Persia; mazdeism. The system presupposes a good spirit (Ormuzd) and an opposing evil spirit (Ahriman). Cf. Fire worship, under Fire, and Parsee.
zokor : (n.) An Asiatic burrowing rodent (Siphneus aspalax) resembling the mole rat. It is native of the Altai Mountains.
zoned : (a.) Wearing a zone, or girdle. | : (a.) Having zones, or concentric bands; striped. | : (a.) Zonate.
zoographist : (n.) A zoographer.
zincography : (n.) The art or process of engraving or etching on zinc, in which the design is left in relief in the style of a wood cut, the rest of the ground being eaten away by acid.
zythem : (n.) See Zythum.
zeuzerian : (n.) Any one of a group of bombycid moths of which the genus Zeuzera is the type. Some of these moths are of large size. The goat moth is an example.
zonnar : (n.) See Zonar.
zoospore : (n.) A spore provided with one or more slender cilia, by the vibration of which it swims in the water. Zoospores are produced by many green, and by some olive-brown, algae. In certain species they are divided into the larger macrozoospores and the smaller microzoospores. Called also sporozoid, and swarmspore. | : (n.) See Swarmspore.
zaerthe : (n.) Same as Z/rthe.
zemindari : (n.) Same as Zamindary.
zealless : (a.) Wanting zeal.
zeta : (n.) A Greek letter corresponding to our z.
zoophite : (n.) A zoophyte.
zareba : (n.) An improvised stockade; especially, one made of thorn bushes, etc.
zoophytoid : (a.) Pertaining to, or resembling, a zoophyte.
zoogony : (n.) The doctrine of the formation of living beings.
zymophyte : (n.) A bacteroid ferment.
zenith : (n.) That point in the visible celestial hemisphere which is vertical to the spectator; the point of the heavens directly overhead; -- opposed to nadir. | : (n.) hence, figuratively, the point of culmination; the greatest height; the height of success or prosperity.
zanies : (pl. ) of Zany
zebrine : (a.) Pertaining to, or resembling, the zebra.
zinced : ( ) of Zinc
zymogen : (n.) A mother substance, or antecedent, of an enzyme or chemical ferment; -- applied to such substances as, not being themselves actual ferments, may by internal changes give rise to a ferment.
zoophyte : (v. i.) Any one of numerous species of invertebrate animals which more or less resemble plants in appearance, or mode of growth, as the corals, gorgonians, sea anemones, hydroids, bryozoans, sponges, etc., especially any of those that form compound colonies having a branched or treelike form, as many corals and hydroids. | : (v. i.) Any one of the Zoophyta.
zymosimeter : (n.) An instrument for ascertaining the degree of fermentation occasioned by the mixture of different liquids, and the degree of heat which they acquire in fermentation.
zendik : (n.) An atheist or unbeliever; -- name given in the East to those charged with disbelief of any revealed religion, or accused of magical heresies.
zinziberaceous : (a.) Same as Zingiberaceous.
zubr : (n.) The aurochs.
zest : (n.) A piece of orange or lemon peel, or the aromatic oil which may be squeezed from such peel, used to give flavor to liquor, etc. | : (n.) Hence, something that gives or enhances a pleasant taste, or the taste itself; an appetizer; also, keen enjoyment; relish; gusto. | : (n.) The woody, thick skin inclosing the kernel of a walnut. | : (v. t.) To cut into thin slips, as the peel of an orange, lemon, etc.; to squeeze, as peel, over the surface of anything. | : (v. t.) To give a relish or flavor to; to heighten the taste or relish of; as, to zest wine.
zoantharian : (a.) Of or pertaining to the Zoantharia. | : (n.) One of the Anthozoa.
zodiacal : (a.) Of or pertaining to the zodiac; situated within the zodiac; as, the zodiacal planets.
zenick : (n.) A South African burrowing mammal (Suricata tetradactyla), allied to the civets. It is grayish brown, with yellowish transverse stripes on the back. Called also suricat.
zoophyta : (n. pl.) An extensive artificial and heterogeneous group of animals, formerly adopted by many zoologists. It included the c/lenterates, echinoderms, sponges, Bryozoa, Protozoa, etc.
zygapophyses : (pl. ) of Zygapophysis
zomboruk : (n.) See Zumbooruk.
zoophytology : (n.) The natural history zoophytes.
zapotilla : (n.) See Sapodilla.
zayat : (n.) A public shed, or portico, for travelers, worshipers, etc.
zoomelanin : (n.) A pigment giving the black color to the feathers of many birds.
zoster : (n.) Shingles.
ziment-water : (n.) A kind of water found in copper mines; water impregnated with copper.
zoopathology : (n.) Animal pathology.
zygosis : (n.) Same as Conjugation.
zonular : (a.) Of or pertaining to a zone; zone-shaped.
zootomist : (n.) One who dissects animals, or is skilled in zootomy.
zaphrentis : (n.) An extinct genus of cyathophylloid corals common in the Paleozoic formations. It is cup-shaped with numerous septa, and with a deep pit in one side of the cup.
zincoid : (a.) Pertaining to, or resembling, zinc; -- said of the electricity of the zincous plate in connection with a copper plate in a voltaic circle; also, designating the positive pole.
zaphara : (n.) Zaffer.
zany : (n.) A merry-andrew; a buffoon. | : (v. t.) To mimic.
zesting : (p. pr. & vb. n.) of Zest
zamite : (n.) A fossil cycad of the genus Zamia.
zirconate : (n.) A salt of zirconic acid.
zinsang : (n.) The delundung.
zoophilist : (n.) A lover of animals.
zoochlorella : (n.) One of the small green granulelike bodies found in the interior of certain stentors, hydras, and other invertebrates.
zenithal : (a.) Of or pertaining to the zenith.
zirco- : ( ) A combining form (also used adjectively) designating zirconium as an element of certain double compounds; zircono-; as in zircofluoric acid, sodium zircofluoride.
zingari : (pl. ) of Zingaro
zincic : (a.) Pertaining to, containing, or resembling, zinc; zincous.
zincane : (n.) Zinc chloride.
zingaro : (n.) A gypsy.
zink : (n.) See Zinc.
zif : (n.) The second month of the Jewish ecclesiastical year, corresponding to our May.
zealot : (n.) One who is zealous; one who engages warmly in any cause, and pursues his object with earnestness and ardor; especially, one who is overzealous, or carried away by his zeal; one absorbed in devotion to anything; an enthusiast; a fanatical partisan.
zufolo : (n.) A little flute or flageolet, especially that which is used to teach birds.
zigger : (v. i.) Alt. of Zighyr
zinc : (n.) An abundant element of the magnesium-cadmium group, extracted principally from the minerals zinc blende, smithsonite, calamine, and franklinite, as an easily fusible bluish white metal, which is malleable, especially when heated. It is not easily oxidized in moist air, and hence is used for sheeting, coating galvanized iron, etc. It is used in making brass, britannia, and other alloys, and is also largely consumed in electric batteries. Symbol Zn. Atomic weight 64.9. | : (v. t.) To coat with zinc; to galvanize.
zincing : ( ) of Zinc | : (n.) The act or process of applying zinc; galvanization.
zounds : (interj.) An exclamation formerly used as an oath, and an expression of anger or wonder.
zonar : (n.) A belt or girdle which the Christians and Jews of the Levant were obliged to wear to distinguish them from Mohammedans.
zygantra : (pl. ) of Zygantrum
zincongraphical : (a.) Of or pertaining to zincography; as, zincographic processes.
zygosphene : (n.) A median process on the front part of the neural arch of the vertebrae of most snakes and some lizards, which fits into a fossa, called the zygantrum, on the back part of the arch in front.
za : (n.) An old solfeggio name for B flat; the seventh harmonic, as heard in the or aeolian string; -- so called by Tartini. It was long considered a false, but is the true note of the chord of the flat seventh.
zinco-polar : (a.) Electrically polarized like the surface of the zinc presented to the acid in a battery, which has zincous affinity.
zoonule : (n.) Same as Zoonite.
zoril : (n.) Same as Zorilla.
zuchetto : (n.) A skullcap covering the tonsure, worn under the berretta. The pope's is white; a cardinal's red; a bishop's purple; a priest's black.
zocle : (n.) Same as Socle.
zyme : (n.) A ferment. | : (n.) The morbific principle of a zymotic disease.
zonal : (a.) Of or pertaining to a zone; having the form of a zone or zones.
zealotical : (a.) Like, or suitable to, a zealot; ardently zealous.
zoanthoid : (a.) Of or pertaining to the Zoanthacea.
zeus : (n.) The chief deity of the Greeks, and ruler of the upper world (cf. Hades). He was identified with Jupiter.
zunyite : (n.) A fluosilicate of alumina occurring in tetrahedral crystals at the Zu/i mine in Colorado.
zeolite : (n.) A term now used to designate any one of a family of minerals, hydrous silicates of alumina, with lime, soda, potash, or rarely baryta. Here are included natrolite, stilbite, analcime, chabazite, thomsonite, heulandite, and others. These species occur of secondary origin in the cavities of amygdaloid, basalt, and lava, also, less frequently, in granite and gneiss. So called because many of these species intumesce before the blowpipe.
zander : (n.) A European pike perch (Stizostedion lucioperca) allied to the wall-eye; -- called also sandari, sander, sannat, schill, and zant.
zygoma : (n.) The jugal, malar, or cheek bone. | : (n.) The zygomatic process of the temporal bone. | : (n.) The whole zygomatic arch.
zirconic : (a.) Pertaining to, containing, or resembling, zirconium; as, zirconic oxide; zirconic compounds.
zygodactylic : (a.) Alt. of Zygodactylous
zootomy : (n.) The dissection or the anatomy of animals; -- distinguished from androtomy.
zoic : (a.) Of or pertaining to animals, or animal life.
zoonite : (n.) One of the segments of the body of an articulate animal. | : (n.) One of the theoretic transverse divisions of any segmented animal.
zirconia : (n.) The oxide of zirconium, obtained as a white powder, and possessing both acid and basic properties. On account of its infusibility, and brilliant luminosity when incandescent, it is used as an ingredient of sticks for the Drummomd light.
zemni : (n.) The blind mole rat (Spalax typhlus), native of Eastern Europe and Asia. Its eyes and ears are rudimentary, and its fur is soft and brownish, more or less tinged with gray. It constructs extensive burrows.
zabism : (n.) See Sabianism.
zonaria : (n. pl.) A division of Mammalia in which the placenta is zonelike.
zoophagan : (n.) A animal that feeds on animal food.
zimb : (n.) A large, venomous, two-winged fly, native of Abyssinia. It is allied to the tsetse fly, and, like the latter, is destructive to cattle.
zygomorphous : (a.) Symmetrical bilaterally; -- said of organisms, or parts of organisms, capable of division into two symmetrical halves only in a single plane.
zygosperm : (n.) A spore formed by the union of the contents of two similar cells, either of the same or of distinct individual plants. Zygosperms are found in certain orders of algae and fungi.
zoochemical : (a.) Pertaining to zoochemistry.
zyophyte : (n.) Any plant of a proposed class or grand division (Zygophytes, Zygophyta, or Zygosporeae), in which reproduction consists in the union of two similar cells. Cf. Oophyte.
zeekoe : (n.) A hippopotamus.
zoodendria : (pl. ) of Zoodendrium
zighyr : (v. i.) Same as Sicker.
zephyr : (n.) The west wind; poetically, any soft, gentle breeze.
zealotry : (n.) The character and behavior of a zealot; excess of zeal; fanatical devotion to a cause.
zircon : (n.) A mineral occurring in tetragonal crystals, usually of a brown or gray color. It consists of silica and zirconia. A red variety, used as a gem, is called hyacinth. Colorless, pale-yellow or smoky-brown varieties from Ceylon are called jargon.
zootrophic : (a.) Of or pertaining to the nourishment of animals.
zonae : (pl. ) of Zona
zoological : (a.) Of or pertaining to zoology, or the science of animals.
zamia : (n.) A genus of cycadaceous plants, having the appearance of low palms, but with exogenous wood. See Coontie, and Illust. of Strobile.
zuisin : (n.) The American widgeon.
zirconium : (n.) A rare element of the carbon-silicon group, intermediate between the metals and nonmetals, obtained from the mineral zircon as a dark sooty powder, or as a gray metallic crystalline substance. Symbol Zr. Atomic weight, 90.4.
zoocyst : (n.) A cyst formed by certain Protozoa and unicellular plants which the contents divide into a large number of granules, each of which becomes a germ.
zetetics : (a.) A branch of algebra which relates to the direct search for unknown quantities.
zoosperm : (n.) One of the spermatic particles; spermatozoid.
zalambdodont : (a.) Of or pertaining to a tribe (Zalambdodonta) of Insectivora in which the molar teeth have but one V-shaped ridge. | : (n.) One of the Zalambdodonta. The tenrec, solenodon, and golden moles are examples.
zoographer : (n.) One who describes animals, their forms and habits.
zuche : (n.) A stump of a tree.
zarathustrism : (n.) See Zoroastrianism.
zacco : (n.) See Zocco.
zealous : (a.) Filled with, or characterized by, zeal; warmly engaged, or ardent, in behalf of an object. | : (a.) Filled with religious zeal.
zamindar : (n.) A landowner; also, a collector of land revenue; now, usually, a kind of feudatory recognized as an actual proprietor so long as he pays to the government a certain fixed revenue.
zoogeny : (n.) Alt. of Zoogony
zephyrus : (n.) The west wind, or zephyr; -- usually personified, and made the most mild and gentle of all the sylvan deities.
zymome : (n.) A glutinous substance, insoluble in alcohol, resembling legumin; -- now called vegetable fibrin, vegetable albumin, or gluten casein.
zarathustric : (a.) Of or pertaining to Zarathustra, or Zoroaster; Zoroastrian.
zoonomy : (n.) The laws of animal life, or the science which treats of the phenomena of animal life, their causes and relations.
zion : (n.) A hill in Jerusalem, which, after the capture of that city by the Israelites, became the royal residence of David and his successors. | : (n.) Hence, the theocracy, or church of God. | : (n.) The heavenly Jerusalem; heaven.
zoilism : (n.) Resemblance to Zoilus in style or manner; carping criticism; detraction.
zoutch : (v. t.) To stew, as flounders, eels, etc., with just enough or liquid to cover them.
zoccolo : (n.) Same as Socle.
zampogna : (n.) A sort of bagpipe formerly in use among Italian peasants. It is now almost obsolete.
zillah : (n.) A district or local division, as of a province.
zoocytium : (n.) The common support, often branched, of certain species of social Infusoria.
zymologic : (a.) Alt. of Zymological
zebub : (n.) A large noxious fly of Abyssinia, which like the tsetse fly, is destructive to cattle.
zerda : (n.) The fennec.
zibeth : (n.) A carnivorous mammal (Viverra zibetha) closely allied to the civet, from which it differs in having the spots on the body less distinct, the throat whiter, and the black rings on the tail more numerous.
zoetrope : (n.) An optical toy, in which figures made to revolve on the inside of a cylinder, and viewed through slits in its circumference, appear like a single figure passing through a series of natural motions as if animated or mechanically moved.
zincographer : (n.) An engraver on zinc.
zooecium : (n.) One of the cells or tubes which inclose the feeling zooids of Bryozoa. See Illust. of Sea Moss.
zymologist : (n.) One who is skilled in zymology, or in the fermentation of liquors.
zumology : (n.) Alt. of Zumometer
zarathustrian : (a.) Alt. of Zarathustric
zincked : (imp. & p. p.) of Zinc
zircono : ( ) See Zirco-.
zoogamy : (n.) The sexual reproduction of animals.
zona : (n.) A zone or band; a layer.
zoonic : (a.) Of or pertaining to animals; obtained from animal substances.
zeriba : (n.) Same as Zareba.
zebec : (n.) See Xebec.
zanyism : (n.) State or character of a zany; buffoonery.
zeylanite : (n.) See Ceylanite.
zoogamous : (a.) Of or pertaining zoogamy.
zone : (n.) A girdle; a cincture. | : (n.) One of the five great divisions of the earth, with respect to latitude and temperature. | : (n.) The portion of the surface of a sphere included between two parallel planes; the portion of a surface of revolution included between two planes perpendicular to the axis. | : (n.) A band or stripe extending around a body. | : (n.) A band or area of growth encircling anything; as, a zone of evergreens on a mountain; the zone of animal or vegetable life in the ocean around an island or a continent; the Alpine zone, that part of mountains which is above the limit of tree growth. | : (n.) A series of planes having mutually parallel intersections. | : (n.) Circuit; circumference. | : (v. t.) To girdle; to encircle.
zeuglodon : (n.) A genus of extinct Eocene whales, remains of which have been found in the Gulf States. The species had very long and slender bodies and broad serrated teeth. See Phocodontia.
zircona : (n.) Zirconia.
zincongraphic : (a.) Alt. of Zincongraphical
zoopsychology : (n.) Animal psychology.
zested : (imp. & p. p.) of Zest
zenana : (n.) The part of a dwelling appropriated to women.
zincking : (p. pr. & vb. n.) of Zinc | : (n.) Alt. of Zincing
zein : (n.) A nitrogenous substance of the nature of gluten, obtained from the seeds of Indian corn (Zea) as a soft, yellowish, amorphous substance.
zoophytical : (a.) Of or pertaining to zoophytes.
zoo- : ( ) A combining form from Gr. zwo^,n an animal, as in zoogenic, zoology, etc.
zoophorous : (n.) The part between the architrave and cornice; the frieze; -- so called from the figures of animals carved upon it.
zumometer : (n.) See Zymic, Zymological, etc.
zymotic : (a.) Of, pertaining to, or caused by, fermentation. | : (a.) Designating, or pertaining to, a certain class of diseases. See Zymotic disease, below.
zircofluoride : (n.) A double fluoride of zirconium and hydrogen, or some other positive element or radical; as, zircofluoride of sodium.
zymase : (n.) A soluble ferment, or enzyme. See Enzyme.
zamindary : (n.) Alt. of Zamindari
zohar : (n.) A Jewish cabalistic book attributed by tradition to Rabbi Simon ben Yochi, who lived about the end of the 1st century, a. d. Modern critics believe it to be a compilation of the 13th century.
zante currant : ( ) A kind of seedless grape or raisin; -- so called from Zante, one of the Ionian Islands.
zarnich : (n.) Native sulphide of arsenic, including sandarach, or realgar, and orpiment.
zoroastrian : (a.) Of or pertaining to Zoroaster, or his religious system. | : (n.) A follower of Zoroaster; one who accepts Zoroastrianism.
zincky : (a.) Pertaining to zinc, or having its appearance.
zingiberaceous : (a.) Of or pertaining to ginger, or to a tribe (Zingibereae) of endogenous plants of the order Scitamineae. See Scitamineous.
zonulet : (n.) A zonule.
zilla : (n.) A low, thorny, suffrutescent, crucifeous plant (Zilla myagroides) found in the deserts of Egypt. Its leaves are boiled in water, and eaten, by the Arabs.
zoide : (n.) See Meride.
zoozoo : (n.) The wood pigeon.
zumic : (n.) Alt. of Zumometer
zoographical : (a.) Of or pertaining to the description of animals.
zoographic : (a.) Alt. of Zoographical
zabaism : (n.) Alt. of Zabism
zoophily : (n.) Love of animals.
zaimet : (n.) A district from which a Zaim draws his revenue.
zoa : (pl. ) of Zoon
zygodactylous : (a.) Yoke-footed; having the toes disposed in pairs; -- applied to birds which have two toes before and two behind, as the parrot, cuckoo, woodpecker, etc.
zoanthropy : (n.) A kind of monomania in which the patient believes himself transformed into one of the lower animals.
zylonite : (n.) Celluloid.
zope : (n.) A European fresh-water bream (Abramis ballerus).
zincite : (n.) Native zinc oxide; a brittle, translucent mineral, of an orange-red color; -- called also red zinc ore, and red oxide of zinc.
zoodendrium : (n.) The branched, and often treelike, support of the colonies of certain Infusoria.
zooerythrine : (n.) A peculiar organic red coloring matter found in the feathers of various birds.
zygobranchia : (n. pl.) A division of marine gastropods in which the gills are developed on both sides of the body and the renal organs are also paired. The abalone (Haliotis) and the keyhole limpet (Fissurella) are examples.
zymogene : (n.) One of a physiological group of globular bacteria which produces fermentations of diverse nature; -- distinguished from pathogene.
zoanthus : (n.) A genus of Actinaria, including numerous species, found mostly in tropical seas. The zooids or polyps resemble small, elongated actinias united together at their bases by fleshy stolons, and thus forming extensive groups. The tentacles are small and bright colored.
zoantharia : (n. pl.) Same as Anthozoa.
zoosporic : (a.) Of or pertaining to zoospores; of the nature of zoospores.
zarthe : (n.) A European bream (Abramis vimba).
zamindari : (n.) The jurisdiction of a zamindar; the land possessed by a zamindar.
zoneless : (a.) Not having a zone; ungirded.
zebra : (n.) Either one of two species of South African wild horses remarkable for having the body white or yellowish white, and conspicuously marked with dark brown or brackish bands.
zeolitiform : (a.) Having the form of a zeolite.
zealotist : (n.) A zealot.
zenik : (n.) See Zenick.
zoophytic : (a.) Alt. of Zoophytical
zoroastrism : (n.) Same as Zoroastrianism.
zati : (n.) A species of macaque (Macacus pileatus) native of India and Ceylon. It has a crown of long erect hair, and tuft of radiating hairs on the back of the head. Called also capped macaque.
zealotism : (n.) The character or conduct of a zealot; zealotry.
zingel : (n.) A small, edible, freshwater European perch (Aspro zingel), having a round, elongated body and prominent snout.
zoologer : (n.) A zoologist.
zietrisikite : (n.) A mineral wax, vert similar to ozocerite. It is found at Zietrisika, Moldavia, whence its name.
zigzagging : (p. pr. & vb. n.) of Zigzag
zinco- : ( ) A combining form from zinc; in chemistry, designating zinc as an element of certain double compounds. Also used adjectively.
zoanthodeme : (n.) The zooids of a compound anthozoan, collectively.
zibet : (n.) Alt. of Zibeth
zoon : (n.) An animal which is the sole product of a single egg; -- opposed to zooid. | : (n.) Any one of the perfectly developed individuals of a compound animal.
zabian : (a. & n.) See Sabian.
zeuglodont : ( ) Any species of Zeuglodonta.
zauschneria : (n.) A genus of flowering plants. Zauschneria Californica is a suffrutescent perennial, with showy red flowers much resembling those of the garden fuchsia.
zoopraxiscope : (n.) An instrument similar to, or the same as, the, the phenakistoscope, by means of which pictures projected upon a screen are made to exhibit the natural movements of animals, and the like.
zoogeography : (n.) The study or description of the geographical distribution of animals.
zumological : (n.) Alt. of Zumometer
zwanziger : (n.) An Austrian silver coin equivalent to 20 kreutzers, or about 10 cents.
zizel : (n.) The suslik.
zygodactyli : (n. pl.) Same as Scansores.
zither : (n.) An instrument of music used in Austria and Germany. It has from thirty to forty wires strung across a shallow sounding-board, which lies horizontally on a table before the performer, who uses both hands in playing on it. [Not to be confounded with the old lute-shaped cittern, or cithern.]
zoology : (n.) That part of biology which relates to the animal kingdom, including the structure, embryology, evolution, classification, habits, and distribution of all animals, both living and extinct. | : (n.) A treatise on this science.
zygospore : (n.) Same as Zygosperm. | : (n.) A spore formed by the union of several zoospores; -- called also zygozoospore.
zeugobranchiata : (n. pl.) Same as Zygobranchia.
