teodor : Teodor : (rzecz.) Theodore
teresa : Teresa : (rzecz.) Theresa
tomasz : Tomasz : (rzecz.) Tom
tomek : Tomek : (rzecz.) Tommy
tabaka : tabaka : (rzecz.) snuff
tabakiera : tabakiera : (rzecz.) snuffbox | : (rzecz.) snuff-box
tabakierka : tabakierka : (rzecz.) snuffbox | : (rzecz.) snuff-box
tabela : tabela : (rzecz.) chart | : (rzecz.) schedule | : (rzecz.) table | : (rzecz.) tabulation
tabelaryczny : tabelaryczny : (przym.) tabular
tabelka : tabelka : (rzecz.) chart | : (rzecz.) table
tabernakulum : tabernakulum : (rzecz.) tabernacle
tabletka : tabletka : (rzecz.) lozenge | : (rzecz.) tablet
tablica : tablica : (rzecz.) array | : (rzecz.) blackboard | : (rzecz.) board | : (rzecz.) chart | : (rzecz.) daughterboard | : (rzecz.) panel | : (rzecz.) plaque | : (rzecz.) stele | : (rzecz.) tablet
tablicowac : tablicować : (czas.) tabulate
tabliczka : tabliczka : (rzecz.) bar | : (rzecz.) plate | : (rzecz.) tablet
tabliczkowy : tabliczkowy : (przym.) tabular
tabor : tabor : (rzecz.) camp | : (rzecz.) rolling
taboret : taboret : (rzecz.) stool
tabu : tabu : (rzecz.) taboo | : (rzecz.) taboos
tabulacja : tabulacja : (rzecz.) tab | : (rzecz.) tabulation
tabulator : tabulator : (rzecz.) tab | : (rzecz.) tabs | : (rzecz.) tabulator | : (rzecz.) tabulators
tabulatura : tabulatura : (rzecz.) tablature
tabulogram : tabulogram : (rzecz.) tabulations
tabulowanie : tabulowanie : (rzecz.) tabulation
tabulowac : tabulować : (czas.) tabulate
tabun : tabun : (rzecz.) herd | : (rzecz.) horde
taca : taca : (rzecz.) coaster | : (rzecz.) plate | : (rzecz.) plateau | : (rzecz.) platter | : (rzecz.) salver | : (rzecz.) tray | : (rzecz.) waiter
tachometr : tachometr : (rzecz.) rev-counter | : (rzecz.) speedometer | : (rzecz.) tachometer
tachykardia : tachykardia : (rzecz.) tachycardia
tachymetr : tachymetr : (rzecz.) tachymeter
tacka : tacka : (rzecz.) in-tray | : (rzecz.) salver | : (rzecz.) tray
taczka : taczka : (rzecz.) barrow | : (rzecz.) wheelbarrow
taczki : taczki : (rzecz.) barrow | : (rzecz.) wheelbarrow
tafelka : tafelka : (rzecz.) tile
tafla : tafla : (rzecz.) pane | : (rzecz.) panel | : (rzecz.) sheet | : (rzecz.) surface | : (rzecz.) tile
taflami : taflami : (rzecz.) pane
taflowanie : taflowanie : (rzecz.) pane
taflowac : taflować : (czas.) tile
taflowy : taflowy : (przym.) flagged
tafta : tafta : (rzecz.) taffeta
taic : taić : (czas.) conceal | : (czas.) hide | : (czas.) suppress
tajac : tajać : (czas.) melt | : (czas.) thaw
tajemnica : tajemnica : (rzecz.) mystery | : (rzecz.) riddle | : (rzecz.) secret
tajemniczo : tajemniczo : (przysł.) mysteriously
tajemniczosc : tajemniczość : (rzecz.) mysteriousness | : (rzecz.) secrecy | : (rzecz.) stealth
tajemniczy : tajemniczy : (przym.) abstruse | : (przym.) arcane | : (przym.) backdoor | : (przym.) cryptic | : (przym.) inscrutable | : (przym.) mysterious | : (przym.) secret | : (przym.) secretive | : (przym.) stealthy | : (przym.) subterranean | : (przym.) subterraneous | : (przym.) surreptitious | : (przym.) uncanny
tajemny : tajemny : (przym.) clandestine | : (przym.) furtive | : (przym.) occult | : (przym.) privy | : (przym.) recondite | : (przym.) secret
tajfun : tajfun : (rzecz.) typhoon
tajga : tajga : (rzecz.) taiga
tajniak : tajniak : (rzecz.) sleuth
tajnie : tajnie : (przysł.) secretly | : (przysł.) underground
tajnik : tajnik : (rzecz.) secret
tajnosc : tajność : (rzecz.) confidentiality | : (rzecz.) conspiracy | : (rzecz.) secrecy
tajny : tajny : (przym.) clandestine | : (przym.) classified | : (przym.) private | : (przym.) privy | : (przym.) secret | : (przym.) surreptitious | : (przym.) undercover | : (przym.) underground
tak : tak : (przysł.) ay | : (przysł.) aye | : (przysł.) so | : (przysł.) thus | : (przysł.) yeah | : (przysł.) yep
taki : taki : (przym.) lucky | : (przym.) such | : (przym.) tentative
takielarz : takielarz : (rzecz.) rigger
takielunek : takielunek : (rzecz.) rig | : (rzecz.) rigging | : (rzecz.) tackle | : (rzecz.) tackling
tako : tako : (przysł.) so
taksa : taksa : (rzecz.) rate | : (rzecz.) tax
taksacja : taksacja : (rzecz.) appraisal | : (rzecz.) valuation
taksator : taksator : (rzecz.) appraiser | : (rzecz.) assessor | : (rzecz.) estimator | : (rzecz.) valuator
taksja : taksja : (rzecz.) taxis
taksometr : taksometr : (rzecz.) clock | : (rzecz.) taximeter
taksonomia : taksonomia : (rzecz.) taxonomy
taksonomiczny : taksonomiczny : (przym.) taxonomic
taksowanie : taksowanie : (rzecz.) measurement
taksowac : taksować : (czas.) apprize | : (czas.) assess
taksowka : taksówka : (rzecz.) cab | : (rzecz.) minicab | : (rzecz.) taxi | : (rzecz.) taxicab | : (rzecz.) taxi-cab
taksowkarz : taksówkarz : (rzecz.) cabby | : (rzecz.) cabman | : (rzecz.) taxi-driver | : (rzecz.) taxman
takt : takt : (rzecz.) bar | : (rzecz.) beat | : (rzecz.) cadence | : (rzecz.) discretion | : (rzecz.) savoir-faire | : (rzecz.) state | : (rzecz.) stroke | : (rzecz.) tact | : (rzecz.) tick | : (rzecz.) time
taktomierz : taktomierz : (rzecz.) metronome
taktownie : taktownie : (przysł.) tactfully
taktownosc : taktowność : (rzecz.) tact
taktowny : taktowny : (przym.) considerate | : (przym.) discreet | : (przym.) tactful
taktycznie : taktycznie : (przysł.) tactically
taktyczny : taktyczny : (przym.) tactic | : (przym.) tactical
taktyk : taktyk : (rzecz.) tactician | : (rzecz.) tactics
taktyka : taktyka : (rzecz.) policy | : (rzecz.) tactic | : (rzecz.) tactician | : (rzecz.) tactics
takze : także : (przysł.) also | : (przysł.) either | : (przysł.) too
tal : tal : (rzecz.) thallium
talent : talent : (rzecz.) abilities | : (rzecz.) faculty | : (rzecz.) genius | : (rzecz.) talent
talerz : talerz : (rzecz.) cymbal | : (rzecz.) dish | : (rzecz.) plate | : (rzecz.) plateful
talerzyk : talerzyk : (rzecz.) plate
talia : talia : (rzecz.) deck | : (rzecz.) pack | : (rzecz.) purchase | : (rzecz.) waist | : (rzecz.) waistline
talizman : talizman : (rzecz.) charm | : (rzecz.) talisman
talk : talk : (rzecz.) talc | : (rzecz.) tale
talon : talon : (rzecz.) coupon | : (rzecz.) voucher
talrep : talrep : (rzecz.) lanyard
tam : tam : (przysł.) there | : (przysł.) thither | : (przysł.) where | : (przysł.) yonder
tama : tama : (rzecz.) bund | : (rzecz.) dam | : (rzecz.) dike | : (rzecz.) stopping | : (rzecz.) weir
tamaryndowiec : tamaryndowiec : (rzecz.) tamarind
tamaryszek : tamaryszek : (rzecz.) tamarisk
tamborek : tamborek : (rzecz.) tambour
tamburyn : tamburyn : (rzecz.) tambourine
tamburyno : tamburyno : (rzecz.) tambourine
tamowac : tamować : (czas.) block | : (czas.) dam | : (czas.) obstruct | : (czas.) stem | : (czas.) trammel
tampon : tampon : (rzecz.) dabber | : (rzecz.) pad | : (rzecz.) tampon
tamponowanie : tamponowanie : (rzecz.) tampons
tamponowac : tamponować : (czas.) plug | : (czas.) staunch
tamze : tamże : (przysł.) there | : (przysł.) therein | : (przysł.) thereof
tan : tan : (rzecz.) dance
tancerz : tancerz : (rzecz.) dancer
tancmistrz : tancmistrz : (rzecz.) dancing-master
tandem : tandem : (rzecz.) tandem
tandeta : tandeta : (rzecz.) garbage | : (rzecz.) goldbrick | : (rzecz.) rubbish | : (rzecz.) shoddy | : (rzecz.) trash | : (rzecz.) trumpery
tandetnosc : tandetność : (rzecz.) shoddiness
tandetny : tandetny : (przym.) chaffy | : (przym.) cheap | : (przym.) shoddy | : (przym.) tacky | : (przym.) trashy | : (przym.) trumpery
tangens : tangens : (rzecz.) tangent
tangensowy : tangensowy : (przym.) tangential
tango : tango : (rzecz.) tango
tani : tani : (przym.) cheap | : (przym.) inexpensive
taniec : taniec : (rzecz.) bop | : (rzecz.) dance | : (rzecz.) dancing | : (rzecz.) hop | : (rzecz.) pas
taniec : tanieć : (czas.) cheapen
tanina : tanina : (rzecz.) tannin
tanio : tanio : (przysł.) cheaply
taniosc : taniość : (rzecz.) cheapness
tanizna : tanizna : (rzecz.) trash
tankietka : tankietka : (rzecz.) whippet
tankowanie : tankowanie : (rzecz.) fuelling
tankowac : tankować : (czas.) fuel | : (czas.) refuel
tankowiec : tankowiec : (rzecz.) tanker
tantal : tantal : (rzecz.) tantalum
tantalit : tantalit : (rzecz.) tantalite
tantiema : tantiema : (rzecz.) bonus | : (rzecz.) dividend | : (rzecz.) royalty
taoizm : taoizm : (rzecz.) Taoism
tapczan : tapczan : (rzecz.) couch
tapeciarz : tapeciarz : (rzecz.) decorator | : (rzecz.) paperhanger | : (rzecz.) paper-hanger
tapeta : tapeta : (rzecz.) paper | : (rzecz.) tapestry | : (rzecz.) wallpaper | : (rzecz.) wall-paper
tapetowanie : tapetowanie : (rzecz.) paperhanging | : (rzecz.) wallpapering
tapetowac : tapetować : (czas.) upholster | : (czas.) wallpaper
tapetowy : tapetowy : (przym.) wall-paper
tapicer : tapicer : (rzecz.) decorator | : (rzecz.) upholsterer
tapicerka : tapicerka : (rzecz.) upholstery | : (rzecz.) valet
tapicernia : tapicernia : (rzecz.) upholstery
tapicerski : tapicerski : (przym.) upholsterer's
tapicerstwo : tapicerstwo : (rzecz.) upholstery
tapioka : tapioka : (rzecz.) cassava | : (rzecz.) tapioca
tapir : tapir : (rzecz.) tapir
tapirowac : tapirować : (czas.) backcomb | : (czas.) back-comb
taplac : taplać : (czas.) splash
tara : tara : (rzecz.) tare
taraban : taraban : (rzecz.) kettledrum | : (rzecz.) kettle-drum
taran : taran : (rzecz.) ram
taranowac : taranować : (czas.) ram
tarantela : tarantela : (rzecz.) tarantella
tarantula : tarantula : (rzecz.) tarantula
tarapaty : tarapaty : (rzecz.) mischief | : (rzecz.) trouble
taras : taras : (rzecz.) bench | : (rzecz.) terrace
tarasowanie : tarasowanie : (rzecz.) benching
tarasowac : tarasować : (czas.) bar | : (czas.) block | : (czas.) obstruct
tarasowy : tarasowy : (przym.) terraced
tarcica : tarcica : (rzecz.) deal | : (rzecz.) lumber | : (rzecz.) planking
tarcie : tarcie : (rzecz.) attrition | : (rzecz.) friction
tarciowy : tarciowy : (przym.) frictional
tarcza : tarcza : (rzecz.) badge | : (rzecz.) butt | : (rzecz.) dial | : (rzecz.) disc | : (rzecz.) disk | : (rzecz.) face | : (rzecz.) shield | : (rzecz.) target | : (rzecz.) targeting | : (rzecz.) tee
tarczka : tarczka : (rzecz.) shield | : (rzecz.) tarsus
tarczyca : tarczyca : (rzecz.) thyroid
tarczycowy : tarczycowy : (przym.) thyroid | : (przym.) thyroidal
tarczowka : tarczówka : (rzecz.) circular-sawing
targ : targ : (rzecz.) breaking | : (rzecz.) fair | : (rzecz.) marker | : (rzecz.) market
targac : targać : (czas.) encroach | : (czas.) jerk
targniecie : targnięcie : (rzecz.) jerk
targowanie : targowanie : (rzecz.) chaffer
targowac : targować : (czas.) bargain | : (czas.) haggle
targowisko : targowisko : (rzecz.) marker | : (rzecz.) market | : (rzecz.) marketplace | : (rzecz.) mart
targowy : targowy : (przym.) fair
tarka : tarka : (rzecz.) grater | : (rzecz.) rasp
tarlatan : tarlatan : (rzecz.) tarlatan
tarmosic : tarmosić : (czas.) tousle
tarmoszenie : tarmoszenie : (rzecz.) scuffle
tarnik : tarnik : (rzecz.) rasp
tarnina : tarnina : (rzecz.) blackthorn | : (rzecz.) sloe
tartak : tartak : (rzecz.) lumber-mill | : (rzecz.) sawmill | : (rzecz.) saw-mill
tartan : tartan : (rzecz.) tartan
taryfa : taryfa : (rzecz.) fare | : (rzecz.) rate | : (rzecz.) schedule | : (rzecz.) tariff
taryfikator : taryfikator : (rzecz.) tariff
taryfowanie : taryfowanie : (rzecz.) tariff
tarzanie : tarzanie : (rzecz.) flounder | : (rzecz.) rolling | : (rzecz.) wallow
tarzac : tarzać : (czas.) roll | : (czas.) wallow | : (czas.) welter
tarlo : tarło : (rzecz.) spawning
tarn : tarń : (rzecz.) tarn
tasak : tasak : (rzecz.) chopper | : (rzecz.) cleaver
tasiemcowy : tasiemcowy : (przym.) lengthy | : (przym.) mile-long
tasiemiec : tasiemiec : (rzecz.) tapeworm
tasiemka : tasiemka : (rzecz.) fob | : (rzecz.) ribbon | : (rzecz.) string | : (rzecz.) tape
tasowanie : tasowanie : (rzecz.) reshuffle | : (rzecz.) shuffle
tasowac : tasować : (czas.) shuffle
tastrowanie : tastrowanie : (rzecz.) keyboarding
tasza : tasza : (rzecz.) lumpfish
taszczyc : taszczyć : (czas.) lug | : (czas.) tote
tata : tata : (rzecz.) dad | : (rzecz.) dada | : (rzecz.) daddy | : (rzecz.) father | : (rzecz.) pa | : (rzecz.) papa
tatarczany : tatarczany : (przym.) tuatara
taternictwo : taternictwo : (rzecz.) mountain-climbing | : (rzecz.) mountaineering
taternik : taternik : (rzecz.) mountaineer
tato : tato : (rzecz.) dad | : (rzecz.) daddy
tatuaz : tatuaż : (rzecz.) tattoo
tatulek : tatulek : (rzecz.) daddy
tatuowac : tatuować : (czas.) tattoo
tatus : tatuś : (rzecz.) dad | : (rzecz.) daddy | : (rzecz.) pa | : (rzecz.) papa | : (rzecz.) poppa
tautologia : tautologia : (rzecz.) tautology
tautologicznie : tautologicznie : (przysł.) tautologically
tautologiczny : tautologiczny : (przym.) tautological
tawerna : tawerna : (rzecz.) pub | : (rzecz.) tavern
tanczenie : tańczenie : (rzecz.) dancing
tanczyc : tańczyć : (czas.) dance | : (czas.) jig | : (czas.) prance
tasma : taśma : (rzecz.) band | : (rzecz.) belt | : (rzecz.) ribbon | : (rzecz.) tape | : (rzecz.) webbing
tasmowy : taśmowy : (przym.) tama
tchawica : tchawica : (rzecz.) trachea | : (rzecz.) windpipe
tchnienie : tchnienie : (rzecz.) breath | : (rzecz.) waft
tchniecie : tchnięcie : (rzecz.) breath
tchnac : tchnąć : (czas.) breathe | : (czas.) inspire
tchorz : tchórz : (rzecz.) caitiff | : (rzecz.) coward | : (rzecz.) craven | : (rzecz.) dastard | : (rzecz.) funk | : (rzecz.) polecat | : (rzecz.) skunk
tchorzliwosc : tchórzliwość : (rzecz.) cowardice
tchorzliwy : tchórzliwy : (przym.) chickenhearted | : (przym.) chicken-hearted | : (przym.) cowardly | : (przym.) craven | : (przym.) fainthearted | : (przym.) faint-hearted | : (przym.) funky | : (przym.) recreant | : (przym.) unmanly | : (przym.) white-livered | : (przym.) yellow | : (przym.) yellow-bellied
tchorzostwo : tchórzostwo : (rzecz.) cowardice | : (rzecz.) poltroonery
tchorzyc : tchórzyć : (czas.) flinch
teatr : teatr : (rzecz.) drama | : (rzecz.) intermezzo | : (rzecz.) playhouse | : (rzecz.) theatre
teatralizacja : teatralizacja : (rzecz.) dramatization | : (rzecz.) staging
teatralnie : teatralnie : (przysł.) theatrically
teatralnosc : teatralność : (rzecz.) melodrama | : (rzecz.) staginess
teatralny : teatralny : (przym.) histrionic | : (przym.) stagy | : (przym.) theatrical
teatroman : teatroman : (rzecz.) theatregoer
technet : technet : (rzecz.) technetium
technicznie : technicznie : (przysł.) technically
techniczno-ekonomiczny : techniczno-ekonomiczny : (przym.) techno-economic
techniczny : techniczny : (przym.) mechanical | : (przym.) technical | : (przym.) technological
technik : technik : (rzecz.) engineer | : (rzecz.) technician
technika : technika : (rzecz.) engineering | : (rzecz.) technician | : (rzecz.) technique | : (rzecz.) technology
technikum : technikum : (rzecz.) tech
techno : techno : (rzecz.) techno
technokracja : technokracja : (rzecz.) technocracy
technokrata : technokrata : (rzecz.) technocrat
technolog : technolog : (rzecz.) technologist
technologia : technologia : (rzecz.) technique | : (rzecz.) technology
technologicznie : technologicznie : (przysł.) technologically
technologiczny : technologiczny : (przym.) technological
teczka : teczka : (rzecz.) binder | : (rzecz.) briefcase | : (rzecz.) case | : (rzecz.) folder | : (rzecz.) portfolio | : (rzecz.) satchel | : (rzecz.) scrapbook | : (rzecz.) wallet
teizm : teizm : (rzecz.) theism
teka : teka : (rzecz.) briefcase | : (rzecz.) brief-case | : (rzecz.) portfolio
tekst : tekst : (rzecz.) corpus | : (rzecz.) lyrics | : (rzecz.) passage | : (rzecz.) print | : (rzecz.) record | : (rzecz.) script | : (rzecz.) text | : (rzecz.) txt
tekstowy : tekstowy : (przym.) textual
tekstura : tekstura : (rzecz.) texture
tekstylia : tekstylia : (rzecz.) textile | : (rzecz.) textiles
tekstylny : tekstylny : (przym.) textile
tektoniczny : tektoniczny : (przym.) tectonic
tektonika : tektonika : (rzecz.) tectonics
tektura : tektura : (rzecz.) board | : (rzecz.) cardboard | : (rzecz.) pasteboard
tekturka : tekturka : (rzecz.) cardboard
teksciarz : tekściarz : (rzecz.) songwriter
teledysk : teledysk : (rzecz.) clip | : (rzecz.) video
telefaks : telefaks : (rzecz.) fax
telefon : telefon : (rzecz.) interphone | : (rzecz.) phone | : (rzecz.) telephone
telefonia : telefonia : (rzecz.) telephony
telefoniczny : telefoniczny : (przym.) telephonic
telefonista : telefonista : (rzecz.) operator | : (rzecz.) telephonist
telefonowanie : telefonowanie : (rzecz.) caller | : (rzecz.) calls
telefonowac : telefonować : (czas.) call | : (czas.) phone | : (czas.) ring | : (czas.) telephone
telefotografia : telefotografia : (rzecz.) telephotograph | : (rzecz.) telephotography
telegraf : telegraf : (rzecz.) telegraph | : (rzecz.) telegraphy | : (rzecz.) ticker
telegrafia : telegrafia : (rzecz.) telegraphy
telegraficznie : telegraficznie : (przysł.) telegraphically
telegraficzny : telegraficzny : (przym.) telegraphic
telegrafista : telegrafista : (rzecz.) telegrapher
telegrafowanie : telegrafowanie : (rzecz.) telegraphs
telegrafowac : telegrafować : (czas.) telegraph | : (czas.) wire
telegram : telegram : (rzecz.) cable | : (rzecz.) telegram
telekinetyczny : telekinetyczny : (przym.) telekinetic
telekineza : telekineza : (rzecz.) telekinesis
telekomunikacja : telekomunikacja : (rzecz.) communication | : (rzecz.) communications | : (rzecz.) connectivity | : (rzecz.) telecommunication | : (rzecz.) telecommunications
telekomutacja : telekomutacja : (rzecz.) telecommuting
telekonferencja : telekonferencja : (rzecz.) teleconference | : (rzecz.) teleconferencing
telekonferencje : telekonferencje : (rzecz.) teleconferencing
teleks : teleks : (rzecz.) telex
telemetr : telemetr : (rzecz.) telemeter
telemetria : telemetria : (rzecz.) telemetry
telemetryczny : telemetryczny : (przym.) telemetric
teleobiektyw : teleobiektyw : (rzecz.) telephoto
teleologia : teleologia : (rzecz.) teleology
teleologiczny : teleologiczny : (przym.) teleological
telepatia : telepatia : (rzecz.) telepathy
telepatyczny : telepatyczny : (przym.) telepathic
telepac : telepać : (czas.) jolt
telepraca : telepraca : (rzecz.) telecommuting
teleprzetwarzanie : teleprzetwarzanie : (rzecz.) teleprocessing
teleskop : teleskop : (rzecz.) telescope
teleskopowa : teleskopowa : (rzecz.) telephoto
teleskopowo : teleskopowo : (przysł.) telescopically
teleskopowy : teleskopowy : (przym.) telescopic
teletransmisja : teletransmisja : (rzecz.) telecast
teleturniej : teleturniej : (rzecz.) quiz
telewidz : telewidz : (rzecz.) viewer
telewizja : telewizja : (rzecz.) television | : (rzecz.) telly
telewizor : telewizor : (rzecz.) television | : (rzecz.) television-set
tellur : tellur : (rzecz.) tellurium
tellurek : tellurek : (rzecz.) telluride
temat : temat : (rzecz.) matter | : (rzecz.) plot | : (rzecz.) stem | : (rzecz.) subject | : (rzecz.) subject-matter | : (rzecz.) theme | : (rzecz.) topic
tematowy : tematowy : (przym.) thematic
tematycznie : tematycznie : (przysł.) thematically | : (przysł.) topically
tematycznosc : tematyczność : (rzecz.) topicality
tematyczny : tematyczny : (przym.) thematic
tematyka : tematyka : (rzecz.) topic
temblak : temblak : (rzecz.) sling
tembr : tembr : (rzecz.) timbre
tempera : tempera : (rzecz.) tempera | : (rzecz.) temperature
temperament : temperament : (rzecz.) temper | : (rzecz.) temperament
temperatura : temperatura : (rzecz.) extreme | : (rzecz.) temperature
temperowac : temperować : (czas.) sharpen
temperowka : temperówka : (rzecz.) pencil | : (rzecz.) pencil-sharpener | : (rzecz.) sharpener
templariusz : templariusz : (rzecz.) templar
tempo : tempo : (rzecz.) momentum | : (rzecz.) pace | : (rzecz.) tempo
ten : ten : (rzecz.) one | : (rzecz.) wrecker
tendencja : tendencja : (rzecz.) drift | : (rzecz.) movement | : (rzecz.) propensity | : (rzecz.) tendency | : (rzecz.) trend
tendencyjnosc : tendencyjność : (rzecz.) slant | : (rzecz.) tendentiousness
tendencyjny : tendencyjny : (przym.) tendentious
tenis : tenis : (rzecz.) tennis
tenisista : tenisista : (rzecz.) tennis | : (rzecz.) tennis-player
tenisowka : tenisówka : (rzecz.) sneaker
tenor : tenor : (rzecz.) tenor
tensor : tensor : (rzecz.) contract | : (rzecz.) tensor
tent : tent : (rzecz.) awning
tenuta : tenuta : (rzecz.) gavelkind
teodycea : teodycea : (rzecz.) theodicy
teokracja : teokracja : (rzecz.) theocracy
teokrata : teokrata : (rzecz.) theocrat
teokratyczny : teokratyczny : (przym.) theocratic
teolog : teolog : (rzecz.) theologian
teologia : teologia : (rzecz.) deity | : (rzecz.) divinity | : (rzecz.) theology
teologicznie : teologicznie : (przysł.) theologically
teologiczny : teologiczny : (przym.) theological
teoremat : teoremat : (rzecz.) theorem
teoretycznie : teoretycznie : (przysł.) theoretically
teoretyczny : teoretyczny : (przym.) academic | : (przym.) speculative | : (przym.) theoretic | : (przym.) theoretical
teoretyk : teoretyk : (rzecz.) theoretician | : (rzecz.) theorist
teoretyzowanie : teoretyzowanie : (rzecz.) theorizing
teoretyzowac : teoretyzować : (czas.) theorize
teoria : teoria : (rzecz.) theory
teoriomnogosciowy : teoriomnogościowy : (przym.) set-theoretic
teownik : teownik : (rzecz.) T-bar | : (rzecz.) tee
teozofia : teozofia : (rzecz.) theosophy
tera : tera : (rzecz.) terra
terabajt : terabajt : (rzecz.) terabyte
terakota : terakota : (rzecz.) terracotta
terakotowy : terakotowy : (przym.) terracotta
terapeuta : terapeuta : (rzecz.) therapist
terapeutycznie : terapeutycznie : (przysł.) therapeutically
terapeutyczny : terapeutyczny : (przym.) therapeutic
terapeutyka : terapeutyka : (rzecz.) therapeutics | : (rzecz.) therapy
terapia : terapia : (rzecz.) therapeutics | : (rzecz.) therapy
terasa : terasa : (rzecz.) terrace
teratologia : teratologia : (rzecz.) teratology
teraz : teraz : (przysł.) now | : (przysł.) nowadays
terazniejszosc : teraźniejszość : (rzecz.) present
terb : terb : (rzecz.) terbium
tercet : tercet : (rzecz.) trio
tercja : tercja : (rzecz.) period | : (rzecz.) tierce
tercyna : tercyna : (rzecz.) triplet
teren : teren : (rzecz.) area | : (rzecz.) field | : (rzecz.) foreside | : (rzecz.) ground | : (rzecz.) grounds | : (rzecz.) land | : (rzecz.) right-of-way | : (rzecz.) site | : (rzecz.) space | : (rzecz.) terrain | : (rzecz.) territory
terenoznawstwo : terenoznawstwo : (rzecz.) topography
terenowka : terenówka : (rzecz.) roadster
terier : terier : (rzecz.) terrier
terkot : terkot : (rzecz.) clatter | : (rzecz.) rattle
terkotanie : terkotanie : (rzecz.) rattle
terkotac : terkotać : (czas.) chatter | : (czas.) rattle
terkotliwy : terkotliwy : (przym.) rattling
term : term : (rzecz.) term
termalny : termalny : (przym.) thermal
termicznie : termicznie : (przysł.) thermally
termiczny : termiczny : (przym.) thermal
termin : termin : (rzecz.) appellation | : (rzecz.) date | : (rzecz.) deadline | : (rzecz.) notice | : (rzecz.) term | : (rzecz.) time | : (rzecz.) time-limit
terminal : terminal : (rzecz.) terminal | : (rzecz.) workstation
terminarz : terminarz : (rzecz.) agenda | : (rzecz.) schedule | : (rzecz.) time-table
terminator : terminator : (rzecz.) apprentice
terminologia : terminologia : (rzecz.) nomenclature | : (rzecz.) terminology
terminologicznie : terminologicznie : (przysł.) terminologically
terminologiczny : terminologiczny : (przym.) terminological
terminowanie : terminowanie : (rzecz.) apprenticeship | : (rzecz.) time
terminowo : terminowo : (przysł.) punctually
terminowy : terminowy : (przym.) time
termit : termit : (rzecz.) ant | : (rzecz.) termite
termodynamiczny : termodynamiczny : (przym.) thermodynamic
termodynamika : termodynamika : (rzecz.) thermodynamics
termoelektrycznosc : termoelektryczność : (rzecz.) thermoelectricity
termoelektryczny : termoelektryczny : (przym.) thermoelectric
termoelement : termoelement : (rzecz.) thermocouple
termograf : termograf : (rzecz.) thermograph | : (rzecz.) thermometer
termoizolacyjny : termoizolacyjny : (przym.) heat-insulating
termojadrowy : termojądrowy : (przym.) thermonuclear
termokatoda : termokatoda : (rzecz.) hot-cathode
termometr : termometr : (rzecz.) thermometer
termometria : termometria : (rzecz.) thermometry
termometryczny : termometryczny : (przym.) thermometric
termonuklearny : termonuklearny : (przym.) thermonuclear
termoodporny : termoodporny : (przym.) heat-resisting
termoogniwo : termoogniwo : (rzecz.) thermocouple
termopara : termopara : (rzecz.) thermocouple
termoplastyczny : termoplastyczny : (przym.) thermoplastic
termoregulacja : termoregulacja : (rzecz.) thermoregulation
termos : termos : (rzecz.) flask | : (rzecz.) thermos
termosfera : termosfera : (rzecz.) thermosphere
termostat : termostat : (rzecz.) thermostat
termostatycznie : termostatycznie : (przysł.) thermostatically
termostatyczny : termostatyczny : (przym.) thermostatic
termostos : termostos : (rzecz.) thermopile
termoterapia : termoterapia : (rzecz.) thermotherapy
termoutwardzalny : termoutwardzalny : (przym.) heat-hardening | : (przym.) hot-setting | : (przym.) thermosetting
terpentyna : terpentyna : (rzecz.) turpentine
terrarium : terrarium : (rzecz.) terrarium
terror : terror : (rzecz.) terror
terrorysta : terrorysta : (rzecz.) bully | : (rzecz.) terrorist
terroryzm : terroryzm : (rzecz.) terrorism
terroryzowanie : terroryzowanie : (rzecz.) terrorization
terroryzowac : terroryzować : (czas.) attempt | : (czas.) bully | : (czas.) terrify | : (czas.) terrorize
terytorialnosc : terytorialność : (rzecz.) territoriality
terytorialny : terytorialny : (przym.) territorial
terytorium : terytorium : (rzecz.) territory
test : test : (rzecz.) chi-square | : (rzecz.) paper | : (rzecz.) test
testament : testament : (rzecz.) testament
testamentowy : testamentowy : (przym.) testamentary
testator : testator : (rzecz.) testator
tester : tester : (rzecz.) tester
testosteron : testosteron : (rzecz.) testosterone
testowanie : testowanie : (rzecz.) testing
testowac : testować : (czas.) bequeath | : (czas.) test
tetracyklina : tetracyklina : (rzecz.) tetracycline
tetrada : tetrada : (rzecz.) tetrad
tetraedr : tetraedr : (rzecz.) tetrahedron
tetrametr : tetrametr : (rzecz.) tetrameter
tetrarcha : tetrarcha : (rzecz.) tetrarch
tetryk : tetryk : (rzecz.) grumbler
teza : teza : (rzecz.) thesis
tezaurus : tezaurus : (rzecz.) thesaurus
tezauryzowac : tezauryzować : (czas.) treasure
tesciowa : teściowa : (rzecz.) mother | : (rzecz.) mother-in-law
tesciowie : teściowie : (rzecz.) in-laws | : (rzecz.) parents-in-law
tesc : teść : (rzecz.) father | : (rzecz.) father-in-law
tez : też : (przysł.) also | : (przysł.) either | : (przysł.) too
tiamina : tiamina : (rzecz.) thiamine
tiara : tiara : (rzecz.) tiara
tik : tik : (rzecz.) teak | : (rzecz.) tic
tiosiarczan : tiosiarczan : (rzecz.) hyposulfite
tir : tir : (rzecz.) lorry
titr : titr : (rzecz.) titre
tiul : tiul : (rzecz.) tulle
tkacz : tkacz : (rzecz.) weaver | : (rzecz.) widow-bird
tkanie : tkanie : (rzecz.) texture
tkanina : tkanina : (rzecz.) cardigan | : (rzecz.) cloth | : (rzecz.) fabric | : (rzecz.) jersey | : (rzecz.) linen | : (rzecz.) material | : (rzecz.) seersucker | : (rzecz.) stuff | : (rzecz.) tapestry | : (rzecz.) tarpaulin | : (rzecz.) textile | : (rzecz.) texture | : (rzecz.) tissue | : (rzecz.) twill | : (rzecz.) web
tkanka : tkanka : (rzecz.) tissue
tkac : tkać : (czas.) weave
tkliwie : tkliwie : (przysł.) affectionately
tkliwosc : tkliwość : (rzecz.) affection | : (rzecz.) tenderness
tkliwy : tkliwy : (przym.) affectionate | : (przym.) loving
tkniety : tknięty : (przym.) intact
tknac : tknąć : (czas.) tip
tkwienie : tkwienie : (rzecz.) being
tkwic : tkwić : (czas.) attach | : (czas.) inhere | : (czas.) stick | : (czas.) underlie
tlen : tlen : (rzecz.) oxygen
tlenek : tlenek : (rzecz.) monoxide | : (rzecz.) oxide
tlenienie : tlenienie : (rzecz.) oxygen | : (rzecz.) water
tlenic : tlenić : (czas.) oxidize
tlenowiec : tlenowiec : (rzecz.) aerobe | : (rzecz.) oxygen
tlenowy : tlenowy : (przym.) oxygenic
tlic : tlić : (czas.) glow | : (czas.) smoulder
tnacy : tnący : (przym.) incisive
toaleta : toaleta : (rzecz.) bathroom | : (rzecz.) cloakroom | : (rzecz.) dressing | : (rzecz.) dressing-table | : (rzecz.) growler | : (rzecz.) lavatory | : (rzecz.) restroom | : (rzecz.) toilet | : (rzecz.) toilette | : (rzecz.) washroom | : (rzecz.) water-closet
toaletka : toaletka : (rzecz.) dresser
toaletowy : toaletowy : (przym.) toile
toast : toast : (rzecz.) toast | : (rzecz.) wassail
tobogan : tobogan : (rzecz.) toboggan
tobolek : tobołek : (rzecz.) bundle
tobol : tobół : (rzecz.) bundle
toczak : toczak : (rzecz.) grindstone | : (rzecz.) millstone
toczek : toczek : (rzecz.) toque
toczenie : toczenie : (rzecz.) lathing
toczen : toczeń : (rzecz.) lupus
toczydlo : toczydło : (rzecz.) grindstone
toczyc : toczyć : (czas.) bowl | : (czas.) edge | : (czas.) roll | : (czas.) trundle | : (czas.) wheel | : (czas.) whet
toga : toga : (rzecz.) gown | : (rzecz.) robe | : (rzecz.) toga
tok : tok : (rzecz.) course | : (rzecz.) progress
tokaj : tokaj : (rzecz.) tokay
tokarka : tokarka : (rzecz.) lathe
tokarko-wyoblarka : tokarko-wyoblarka : (rzecz.) spinner
tokarnia : tokarnia : (rzecz.) lathe | : (rzecz.) turnery
tokarstwo : tokarstwo : (rzecz.) turnery
tokarz : tokarz : (rzecz.) turner
tokowac : tokować : (czas.) toot
toksycznosc : toksyczność : (rzecz.) toxicity
toksyczny : toksyczny : (przym.) poisonous | : (przym.) toxic
toksykolog : toksykolog : (rzecz.) toxicologist
toksykologia : toksykologia : (rzecz.) toxicology
toksykologiczny : toksykologiczny : (przym.) toxicological
toksyna : toksyna : (rzecz.) toxin
tolerancja : tolerancja : (rzecz.) sufferance | : (rzecz.) tolerance | : (rzecz.) toleration
tolerancyjnie : tolerancyjnie : (przysł.) tolerantly
tolerancyjny : tolerancyjny : (przym.) broadminded | : (przym.) broad-minded | : (przym.) liberal | : (przym.) tolerant
tolerowanie : tolerowanie : (rzecz.) sufferance | : (rzecz.) tolerance
tolerowac : tolerować : (czas.) abide | : (czas.) stand | : (czas.) suffer | : (czas.) tolerate
toluen : toluen : (rzecz.) methylbenzene | : (rzecz.) toluene
tom : tom : (rzecz.) volume
tomahawk : tomahawk : (rzecz.) tomahawk
tomasyna : tomasyna : (rzecz.) slag
tombak : tombak : (rzecz.) pinchbeck
tomofan : tomofan : (rzecz.) cellophane
tomograf : tomograf : (rzecz.) scanner
tomografia : tomografia : (rzecz.) scanning | : (rzecz.) tomography
ton : ton : (rzecz.) tone | : (rzecz.) tonnes | : (rzecz.) tune
tona : tona : (rzecz.) ton | : (rzecz.) tonne
tona-sila : tona-siła : (rzecz.) ton-force
tonacja : tonacja : (rzecz.) key | : (rzecz.) pitch | : (rzecz.) tone
tonalnosc : tonalność : (rzecz.) tonality
tonalny : tonalny : (przym.) tonal
tonaz : tonaż : (rzecz.) tonnage
toner : toner : (rzecz.) toner
toniczny : toniczny : (przym.) tonal | : (przym.) tonic
tonik : tonik : (rzecz.) tonic
tonika : tonika : (rzecz.) keynote | : (rzecz.) tonic | : (rzecz.) tonics
tonowanie : tonowanie : (rzecz.) grading | : (rzecz.) toning
tonowac : tonować : (czas.) gradate | : (czas.) soft-pedal | : (czas.) tone
tonowy : tonowy : (przym.) tonal
tonsura : tonsura : (rzecz.) tonsure
tonac : tonąć : (czas.) drown | : (czas.) sink
top : top : (rzecz.) top
topaz : topaz : (rzecz.) topaz
topiarz : topiarz : (rzecz.) teaser
topiel : topiel : (rzecz.) gulf | : (rzecz.) whirlpool
topielec : topielec : (rzecz.) kelpie
topienie : topienie : (rzecz.) fusion | : (rzecz.) melting
topik : topik : (rzecz.) fuse-link
topic : topić : (czas.) drown | : (czas.) fuse | : (czas.) liquefy | : (czas.) melt | : (czas.) smelt | : (czas.) thaw
topliwosc : topliwość : (rzecz.) fusibility
topliwy : topliwy : (przym.) fusible
topnienie : topnienie : (rzecz.) meltdown | : (rzecz.) melting
topniec : topnieć : (czas.) liquefy | : (czas.) melt | : (czas.) thaw
topnik : topnik : (rzecz.) flux
topnisko : topnisko : (rzecz.) hearth
topograf : topograf : (rzecz.) topographer
topografia : topografia : (rzecz.) topography
topograficznie : topograficznie : (przysł.) topographically
topograficzny : topograficzny : (przym.) topographic | : (przym.) topographical | : (przym.) typographical
topola : topola : (rzecz.) poplar
topologia : topologia : (rzecz.) topology
topologiczny : topologiczny : (przym.) topological
toporek : toporek : (rzecz.) adze | : (rzecz.) broadaxe | : (rzecz.) hand-axe | : (rzecz.) hatchet | : (rzecz.) tomahawk
toporny : toporny : (przym.) clumsy | : (przym.) coarse | : (przym.) gross
topsel : topsel : (rzecz.) topsail
topor : topór : (rzecz.) axe | : (rzecz.) chopper | : (rzecz.) hatchet
topzagiel : topżagiel : (rzecz.) skysail
tor : tor : (rzecz.) lane | : (rzecz.) path | : (rzecz.) thorium | : (rzecz.) track | : (rzecz.) trajectory
torba : torba : (rzecz.) bag | : (rzecz.) bagful | : (rzecz.) holdall | : (rzecz.) pannier | : (rzecz.) pouch | : (rzecz.) sac | : (rzecz.) satchel | : (rzecz.) sporran | : (rzecz.) wallet
torbacz : torbacz : (rzecz.) marsupial
torbiel : torbiel : (rzecz.) cyst | : (rzecz.) sac
torbielowaty : torbielowaty : (przym.) cystic
toreador : toreador : (rzecz.) toreador
torebka : torebka : (rzecz.) bag | : (rzecz.) bursa | : (rzecz.) handbag | : (rzecz.) purse | : (rzecz.) reticule | : (rzecz.) sachet
torebkowaty : torebkowaty : (przym.) capsular
torebkowy : torebkowy : (przym.) capsular
torf : torf : (rzecz.) peat | : (rzecz.) turf
torfiasty : torfiasty : (przym.) peaty
torfowiec : torfowiec : (rzecz.) peat-moss | : (rzecz.) sphagnum
torfowisko : torfowisko : (rzecz.) moss | : (rzecz.) peat-bog
torfowy : torfowy : (przym.) peaty
torkret : torkret : (rzecz.) grout
tornado : tornado : (rzecz.) tornado
tornister : tornister : (rzecz.) backpack | : (rzecz.) knapsack | : (rzecz.) pack | : (rzecz.) satchel | : (rzecz.) schoolbag
toron : toron : (rzecz.) radon-220
torowanie : torowanie : (rzecz.) paving | : (rzecz.) pioneer | : (rzecz.) pioneering
torowac : torować : (czas.) clear | : (czas.) pave
torowiec : torowiec : (rzecz.) platelayer
torowisko : torowisko : (rzecz.) track | : (rzecz.) track-way
torpeda : torpeda : (rzecz.) torpedo
torpedowac : torpedować : (czas.) torpedo
torpedowiec : torpedowiec : (rzecz.) torpedo-boat
torreador : torreador : (rzecz.) bullfighter
tors : tors : (rzecz.) thorax | : (rzecz.) torso | : (rzecz.) trunk
tort : tort : (rzecz.) cake | : (rzecz.) layer-cake | : (rzecz.) tart
tortownica : tortownica : (rzecz.) cake-pan
tortura : tortura : (rzecz.) torture
torturowanie : torturowanie : (rzecz.) torture
torturowac : torturować : (czas.) rack | : (czas.) torture
tory : tory : (rzecz.) tracks
torys : torys : (rzecz.) Tory
tost : tost : (rzecz.) toast
toster : toster : (rzecz.) toaster
totalitarny : totalitarny : (przym.) totalitarian
totalitaryzm : totalitaryzm : (rzecz.) totalitarianism
totalizator : totalizator : (rzecz.) pool | : (rzecz.) sweepstakes
totalizm : totalizm : (rzecz.) totalitarianism
totalnie : totalnie : (przysł.) totally
totalnosc : totalność : (rzecz.) totality
totalny : totalny : (przym.) all-oat | : (przym.) all-out | : (przym.) total
totez : toteż : (spójnik) so
totolotek : totolotek : (rzecz.) lotto
towar : towar : (rzecz.) article | : (rzecz.) commodity | : (rzecz.) gong | : (rzecz.) goods | : (rzecz.) item | : (rzecz.) merchandise | : (rzecz.) product | : (rzecz.) stock | : (rzecz.) stuff | : (rzecz.) ware
towary : towary : (rzecz.) articles
towarzyski : towarzyski : (przym.) communicative | : (przym.) companionable | : (przym.) convivial | : (przym.) gregarious | : (przym.) outgoing | : (przym.) sociable | : (przym.) social
towarzysko : towarzysko : (przysł.) socially
towarzyskosc : towarzyskość : (rzecz.) sociability
towarzystwo : towarzystwo : (rzecz.) companionship | : (rzecz.) company | : (rzecz.) fellowship | : (rzecz.) grange | : (rzecz.) party | : (rzecz.) society
towarzysz : towarzysz : (rzecz.) associate | : (rzecz.) attendant | : (rzecz.) chum | : (rzecz.) companion | : (rzecz.) comrade | : (rzecz.) escort | : (rzecz.) fellow | : (rzecz.) helpmate | : (rzecz.) helpmeet | : (rzecz.) mate | : (rzecz.) pal | : (rzecz.) partner | : (rzecz.) playfellow | : (rzecz.) playmate | : (rzecz.) yokefellow | : (rzecz.) yoke-fellow
towarzyszenie : towarzyszenie : (rzecz.) accompaniment
towarzyszyc : towarzyszyć : (czas.) accompanied | : (czas.) accompany | : (czas.) attend | : (czas.) chaperon | : (czas.) escort
towarzyszacy : towarzyszący : (przym.) attendant
ton : toń : (rzecz.) depth | : (rzecz.) depths | : (rzecz.) tonnes
tozsamosc : tożsamość : (rzecz.) identity
tozsamy : tożsamy : (przym.) different
tracenie : tracenie : (rzecz.) losing
tracheotomia : tracheotomia : (rzecz.) tracheotomy
tracic : tracić : (czas.) execute | : (czas.) lose
trackball : trackball : (rzecz.) trackball
tracz : tracz : (rzecz.) sawyer
tradycja : tradycja : (rzecz.) lore | : (rzecz.) tradition
tradycjonalista : tradycjonalista : (rzecz.) traditionalist
tradycjonalizm : tradycjonalizm : (rzecz.) traditionalism
tradycyjnie : tradycyjnie : (przysł.) traditionally
tradycyjnosc : tradycyjność : (rzecz.) elder
tradycyjny : tradycyjny : (przym.) customary | : (przym.) time-honoured | : (przym.) traditional
traf : traf : (rzecz.) chance | : (rzecz.) coincidence | : (rzecz.) fortune | : (rzecz.) luck | : (rzecz.) occurrence | : (rzecz.) serendipity
trafiac : trafiać : (czas.) catch | : (czas.) hit | : (czas.) strike
trafienie : trafienie : (rzecz.) hit
trafic : trafić : (czas.) chance | : (czas.) happen | : (czas.) hit | : (czas.) occur
trafnie : trafnie : (przysł.) accurately | : (przysł.) aptly | : (przysł.) pat
trafnosc : trafność : (rzecz.) accuracy | : (rzecz.) adequacy | : (rzecz.) appositeness | : (rzecz.) aptness | : (rzecz.) cogency | : (rzecz.) pertness | : (rzecz.) relevance | : (rzecz.) rightness
trafny : trafny : (przym.) accurate | : (przym.) apposite | : (przym.) apropos | : (przym.) apt | : (przym.) correct | : (przym.) exact | : (przym.) felicitous | : (przym.) relevant | : (przym.) right | : (przym.) seasonable | : (przym.) shrewd
tragarz : tragarz : (rzecz.) carrier | : (rzecz.) longshoreman | : (rzecz.) porter
tragedia : tragedia : (rzecz.) disaster | : (rzecz.) tragedy
tragediopisarz : tragediopisarz : (rzecz.) tragedian
tragicznie : tragicznie : (przysł.) tragically
tragicznosc : tragiczność : (rzecz.) luridness
tragiczny : tragiczny : (przym.) terrible | : (przym.) tragic
tragik : tragik : (rzecz.) tragedian
tragikomedia : tragikomedia : (rzecz.) tragicomedy
tragikomiczny : tragikomiczny : (przym.) tragicomic
tragizm : tragizm : (rzecz.) tragedy
trajektoria : trajektoria : (rzecz.) trajectory
trajkot : trajkot : (rzecz.) chatter | : (rzecz.) patter
trajkotanie : trajkotanie : (rzecz.) chatter | : (rzecz.) waffle
trajkotac : trajkotać : (czas.) chatter | : (czas.) jabber | : (czas.) waffle | : (czas.) yap
trajkotka : trajkotka : (rzecz.) chatterbox | : (rzecz.) gabbler
trak : trak : (rzecz.) gangrene
trakcja : trakcja : (rzecz.) traction
trakt : trakt : (rzecz.) track | : (rzecz.) tract
traktat : traktat : (rzecz.) tract | : (rzecz.) tractate | : (rzecz.) treatise | : (rzecz.) treaty
traktor : traktor : (rzecz.) feeder | : (rzecz.) traction-engine | : (rzecz.) tractor
traktowanie : traktowanie : (rzecz.) attitude | : (rzecz.) dealing | : (rzecz.) treatment | : (rzecz.) usage
traktowac : traktować : (czas.) deal | : (czas.) handle | : (czas.) treat | : (czas.) treated
tralka : tralka : (rzecz.) baluster | : (rzecz.) banister
tramp : tramp : (rzecz.) tramp
trampolina : trampolina : (rzecz.) diving-board | : (rzecz.) springboard | : (rzecz.) spring-board | : (rzecz.) trampoline
tramwaj : tramwaj : (rzecz.) streetcar | : (rzecz.) street-car | : (rzecz.) tram | : (rzecz.) tramcar | : (rzecz.) tram-car | : (rzecz.) tramway | : (rzecz.) trolley-car
tramwajarz : tramwajarz : (rzecz.) tramway-worker
tran : tran : (rzecz.) blubber | : (rzecz.) cod-liver-oil
trans : trans : (rzecz.) trance | : (rzecz.) translation
transakcja : transakcja : (rzecz.) bargain | : (rzecz.) business | : (rzecz.) deal | : (rzecz.) dicker | : (rzecz.) transaction
transatlantycki : transatlantycki : (przym.) transatlantic
transcendencja : transcendencja : (rzecz.) transcendence
transcendentalista : transcendentalista : (rzecz.) transcendentalist
transcendentalizm : transcendentalizm : (rzecz.) transcendentalism
transcendentalny : transcendentalny : (przym.) transcendent | : (przym.) transcendental
transcendentny : transcendentny : (przym.) external | : (przym.) transcendent
transduktor : transduktor : (rzecz.) pickup
transept : transept : (rzecz.) transept
transfer : transfer : (rzecz.) transfer
transfiguracja : transfiguracja : (rzecz.) transfiguration
transformacja : transformacja : (rzecz.) transformation | : (rzecz.) transition
transformator : transformator : (rzecz.) transformer
transformowac : transformować : (czas.) transform
transfuzja : transfuzja : (rzecz.) transfusion
transgeniczny : transgeniczny : (przym.) transgenic
transgresja : transgresja : (rzecz.) transgression
transkontynentalny : transkontynentalny : (przym.) intercontinental | : (przym.) transcontinental
transkrybowac : transkrybować : (czas.) transcribe
transkrypcja : transkrypcja : (rzecz.) transcript | : (rzecz.) transcription
translacja : translacja : (rzecz.) repeater | : (rzecz.) resolution | : (rzecz.) translation
translacyjny : translacyjny : (przym.) translational
translator : translator : (rzecz.) translator
transliteracja : transliteracja : (rzecz.) transliteration
transliterowac : transliterować : (czas.) transliterate
translokacja : translokacja : (rzecz.) translocation
transmisja : transmisja : (rzecz.) broadcast | : (rzecz.) communication | : (rzecz.) transmission
transmitancja : transmitancja : (rzecz.) transmittance
transmitowanie : transmitowanie : (rzecz.) broadcasting
transmitowac : transmitować : (czas.) broadcast | : (czas.) relayed | : (czas.) televise | : (czas.) transmit
transmutacja : transmutacja : (rzecz.) transmutation
transoceaniczny : transoceaniczny : (przym.) transoceanic
transparent : transparent : (rzecz.) banner
transpiracja : transpiracja : (rzecz.) transpiration
transplantacja : transplantacja : (rzecz.) transplantation
transplantowac : transplantować : (czas.) graft
transponowanie : transponowanie : (rzecz.) transposing | : (rzecz.) transposition
transponowac : transponować : (czas.) transpose
transport : transport : (rzecz.) carrying | : (rzecz.) haulage | : (rzecz.) transport | : (rzecz.) transportation
transporter : transporter : (rzecz.) conveyer | : (rzecz.) conveyor
transportowanie : transportowanie : (rzecz.) shuttling
transportowac : transportować : (czas.) haul | : (czas.) transport
transportowiec : transportowiec : (rzecz.) carrier | : (rzecz.) freighter | : (rzecz.) troop-carrier
transpozycja : transpozycja : (rzecz.) contraposition | : (rzecz.) transposition
transwersalny : transwersalny : (przym.) transversal
transwestyta : transwestyta : (rzecz.) transvestite
transzeja : transzeja : (rzecz.) sap | : (rzecz.) trench
tranzystor : tranzystor : (rzecz.) transistor
tranzystorowy : tranzystorowy : (przym.) transistorized
tranzyt : tranzyt : (rzecz.) pass-through | : (rzecz.) transit
tranzytywnosc : tranzytywność : (rzecz.) transitivity
tranzytywny : tranzytywny : (przym.) transitive
trap : trap : (rzecz.) gangway
traper : traper : (rzecz.) trapper | : (rzecz.) woodcraftsman
trapez : trapez : (rzecz.) trapeze | : (rzecz.) trapezium | : (rzecz.) trapezoid
trapezoid : trapezoid : (rzecz.) trapezoids
trapezowy : trapezowy : (przym.) trapezoidal
trapienie : trapienie : (rzecz.) trap
trapic : trapić : (czas.) annoy | : (czas.) molest | : (czas.) pester | : (czas.) plague
trasa : trasa : (rzecz.) itinerary | : (rzecz.) path | : (rzecz.) rout | : (rzecz.) route | : (rzecz.) run | : (rzecz.) trajectory | : (rzecz.) way
trasant : trasant : (rzecz.) drawer | : (rzecz.) payer
traser : traser : (rzecz.) router
trasowanie : trasowanie : (rzecz.) flooding | : (rzecz.) marking-out | : (rzecz.) tracing
trasowac : trasować : (czas.) trace
traszka : traszka : (rzecz.) newt
tratowac : tratować : (czas.) tread
tratwa : tratwa : (rzecz.) boat | : (rzecz.) float | : (rzecz.) raft
tratwiarz : tratwiarz : (rzecz.) rafter
traumatyczny : traumatyczny : (przym.) traumatic
trawa : trawa : (rzecz.) grass | : (rzecz.) herbage
trawers : trawers : (rzecz.) beam | : (rzecz.) traverse
trawersowac : trawersować : (czas.) traverse
trawestacja : trawestacja : (rzecz.) travesty
trawestowac : trawestować : (czas.) travesty
trawiastozielony : trawiastozielony : (przym.) grass-green
trawiasty : trawiasty : (przym.) grassy
trawienie : trawienie : (rzecz.) digestion | : (rzecz.) etching
trawieniec : trawieniec : (rzecz.) maw
trawienny : trawienny : (przym.) digestive | : (przym.) peptic
trawic : trawić : (czas.) consume | : (czas.) digest | : (czas.) etch
trawka : trawka : (rzecz.) grass
trawler : trawler : (rzecz.) trawler
trawnik : trawnik : (rzecz.) greenery | : (rzecz.) lawn
trawojad : trawojad : (rzecz.) herbivore
trawozerny : trawożerny : (przym.) herbivorous
trawy : trawy : (rzecz.) herbage
tralowanie : trałowanie : (rzecz.) minesweeping
tralowac : trałować : (czas.) drag | : (czas.) trawl
tralowiec : trałowiec : (rzecz.) minesweeper | : (rzecz.) trawler
tref : tref : (rzecz.) curl
trefl : trefl : (rzecz.) club | : (rzecz.) clubs
trefny : trefny : (przym.) bent | : (przym.) unclean
trel : trel : (rzecz.) trill
trelowac : trelować : (czas.) trill
trema : trema : (rzecz.) fright | : (rzecz.) jimjams | : (rzecz.) jitter | : (rzecz.) jitters
tren : tren : (rzecz.) dirge | : (rzecz.) threnody | : (rzecz.) train
trenazer : trenażer : (rzecz.) link-trainer
trencz : trencz : (rzecz.) trench-coat
trener : trener : (rzecz.) coach | : (rzecz.) coachman | : (rzecz.) handler | : (rzecz.) trainer
trening : trening : (rzecz.) training
trenowanie : trenowanie : (rzecz.) coaching | : (rzecz.) training
trenowac : trenować : (czas.) coach | : (czas.) train
trepan : trepan : (rzecz.) trepan
trepanacja : trepanacja : (rzecz.) trepanation
trepanowac : trepanować : (czas.) trephine
trepek : trepek : (rzecz.) sandal
treser : treser : (rzecz.) handler | : (rzecz.) tamer | : (rzecz.) trainer
tresowanie : tresowanie : (rzecz.) training
tresowac : tresować : (czas.) drill | : (czas.) train
tresura : tresura : (rzecz.) training
tresciwie : treściwie : (przysł.) succinctly | : (przysł.) tersely
tresciwosc : treściwość : (rzecz.) brevity | : (rzecz.) conciseness
tresciwy : treściwy : (przym.) concise | : (przym.) meaty | : (przym.) pithy | : (przym.) succinct
tresc : treść : (rzecz.) body | : (rzecz.) content | : (rzecz.) essence | : (rzecz.) nitty-gritty | : (rzecz.) purport | : (rzecz.) purview | : (rzecz.) substance | : (rzecz.) sum | : (rzecz.) teaspoonful | : (rzecz.) tenor
tri : tri : (rzecz.) trichloroethylene
triada : triada : (rzecz.) triad
triangulacja : triangulacja : (rzecz.) triangulation
trik : trik : (rzecz.) trick
trioda : trioda : (rzecz.) triode
triola : triola : (rzecz.) triplet
triumf : triumf : (rzecz.) exultation | : (rzecz.) triumph
triumfalny : triumfalny : (przym.) joyous | : (przym.) jubilant | : (przym.) triumphal | : (przym.) triumphant
triumfator : triumfator : (rzecz.) victor
triumfowanie : triumfowanie : (rzecz.) jubilation
triumfowac : triumfować : (czas.) crow | : (czas.) exult | : (czas.) triumph
triumfujacy : triumfujący : (przym.) triumphant
triumwir : triumwir : (rzecz.) triumvir
triumwirat : triumwirat : (rzecz.) triumvirate
trocheiczny : trocheiczny : (przym.) trochaic
trochej : trochej : (rzecz.) trochee
troche : trochę : (rzecz.) bit | : (rzecz.) little
trofeum : trofeum : (rzecz.) trophy
troglodyta : troglodyta : (rzecz.) cave-dweller | : (rzecz.) caveman | : (rzecz.) cave-man | : (rzecz.) troglodyte
troisty : troisty : (przym.) treble
troic : troić : (czas.) triple
trojaczki : trojaczki : (rzecz.) triplets
trojak : trojak : (rzecz.) trilling
trojaki : trojaki : (przym.) three | : (przym.) threefold | : (przym.) triplex
trolejbus : trolejbus : (rzecz.) trolley | : (rzecz.) trolleybus
trolejbusowy : trolejbusowy : (przym.) trolleybus
trombina : trombina : (rzecz.) thrombin
tron : tron : (rzecz.) throne
trop : trop : (rzecz.) clue | : (rzecz.) lead | : (rzecz.) scent | : (rzecz.) spoor | : (rzecz.) trace | : (rzecz.) track | : (rzecz.) tracks | : (rzecz.) trail
tropiciel : tropiciel : (rzecz.) sleuth-hound | : (rzecz.) tracer | : (rzecz.) tracker | : (rzecz.) trailer
tropienie : tropienie : (rzecz.) tracing
tropik : tropik : (rzecz.) flysheet | : (rzecz.) tropic | : (rzecz.) tropics
tropikalizacja : tropikalizacja : (rzecz.) tropic-proofing
tropikalnie : tropikalnie : (przysł.) tropically
tropikalny : tropikalny : (przym.) equatorial | : (przym.) tropic | : (przym.) tropical
tropizm : tropizm : (rzecz.) tropism
tropic : tropić : (czas.) hound | : (czas.) hunt | : (czas.) sleuth | : (czas.) stalk | : (czas.) track | : (czas.) trail
troposfera : troposfera : (rzecz.) troposphere
tropowiec : tropowiec : (rzecz.) bloodhound
troska : troska : (rzecz.) attention | : (rzecz.) care | : (rzecz.) concern | : (rzecz.) pain | : (rzecz.) preoccupation | : (rzecz.) regard | : (rzecz.) solicitude | : (rzecz.) sorrow | : (rzecz.) trouble | : (rzecz.) worry
troskac : troskać : (czas.) worry
troskliwie : troskliwie : (przysł.) carefully | : (przysł.) mindfully
troskliwosc : troskliwość : (rzecz.) accuracy | : (rzecz.) attentiveness | : (rzecz.) care | : (rzecz.) solicitude
troskliwy : troskliwy : (przym.) attentive | : (przym.) careful | : (przym.) caring | : (przym.) considerate | : (przym.) doting | : (przym.) mindful | : (przym.) solicitous | : (przym.) thoughtful
troszczyc : troszczyć : (czas.) care
trotuar : trotuar : (rzecz.) pavement | : (rzecz.) sidewalk | : (rzecz.) side-walk
trotyl : trotyl : (rzecz.) trinitrotoluene
trubadur : trubadur : (rzecz.) troubadour
truchlec : truchleć : (czas.) blench | : (czas.) terrified
trucht : trucht : (rzecz.) jog | : (rzecz.) jogtrot | : (rzecz.) trot
truciciel : truciciel : (rzecz.) polluter
trucizna : trucizna : (rzecz.) bane | : (rzecz.) poison | : (rzecz.) venom
trud : trud : (rzecz.) fatigue | : (rzecz.) hardship | : (rzecz.) pain | : (rzecz.) sweat | : (rzecz.) toil | : (rzecz.) trouble
trudno : trudno : (przysł.) hard
trudnotopliwy : trudnotopliwy : (przym.) high-melting
trudnosc : trudność : (rzecz.) annoyance | : (rzecz.) difficulty | : (rzecz.) hardship | : (rzecz.) knot | : (rzecz.) obstacle | : (rzecz.) stickler | : (rzecz.) stumbling-block
trudny : trudny : (przym.) arduous | : (przym.) difficult | : (przym.) formidable | : (przym.) hard | : (przym.) intricate | : (przym.) knotty | : (przym.) tough
trudzenie : trudzenie : (rzecz.) bothering
trudzic : trudzić : (czas.) bother | : (czas.) sweat | : (czas.) toil | : (czas.) trouble
trufla : trufla : (rzecz.) truffle
truizm : truizm : (rzecz.) truism
trujacy : trujący : (przym.) poisonous | : (przym.) toxic
trumna : trumna : (rzecz.) casket | : (rzecz.) coffin
trunek : trunek : (rzecz.) beverage | : (rzecz.) booze | : (rzecz.) drink | : (rzecz.) intoxicant | : (rzecz.) liquor
trup : trup : (rzecz.) cadaver | : (rzecz.) corpse
trupa : trupa : (rzecz.) company | : (rzecz.) corpse | : (rzecz.) troop | : (rzecz.) troupe
trupi : trupi : (przym.) cadaverous | : (przym.) deathly
trupiarnia : trupiarnia : (rzecz.) morgue | : (rzecz.) mortuary
truposz : truposz : (rzecz.) corpse
truskawka : truskawka : (rzecz.) strawberry
trust : trust : (rzecz.) trust
truten : truteń : (rzecz.) drone | : (rzecz.) freeloader
trutka : trutka : (rzecz.) poison
truc : truć : (czas.) poison
trwale : trwale : (przysł.) fixedly | : (przysł.) permanently
trwanie : trwanie : (rzecz.) abidance | : (rzecz.) continuance | : (rzecz.) durability | : (rzecz.) duration | : (rzecz.) lifespan | : (rzecz.) standing
trwac : trwać : (czas.) abide | : (czas.) continue | : (czas.) endure | : (czas.) last | : (czas.) obtain | : (czas.) outlast | : (czas.) persevere | : (czas.) persist
trwalosc : trwałość : (rzecz.) constancy | : (rzecz.) durability | : (rzecz.) duration | : (rzecz.) endurance | : (rzecz.) fastness | : (rzecz.) indestructibility | : (rzecz.) life | : (rzecz.) life-period | : (rzecz.) lifespan | : (rzecz.) permanence | : (rzecz.) permanency | : (rzecz.) persistence | : (rzecz.) persistency | : (rzecz.) solidity | : (rzecz.) stability | : (rzecz.) tenacity
trwaly : trwały : (przym.) abiding | : (przym.) constant | : (przym.) continuous | : (przym.) durable | : (przym.) lasting | : (przym.) permanent | : (przym.) retentive | : (przym.) rooted | : (przym.) tenacious
trwoga : trwoga : (rzecz.) affright | : (rzecz.) alarm | : (rzecz.) anxiety | : (rzecz.) awe | : (rzecz.) fear | : (rzecz.) fright
trwonienie : trwonienie : (rzecz.) dilapidation | : (rzecz.) dissipation | : (rzecz.) squandering
trwonic : trwonić : (czas.) dissipate | : (czas.) ruin | : (czas.) squander | : (czas.) waste
trwozenie : trwożenie : (rzecz.) awing
trwozliwy : trwożliwy : (przym.) shy
trwoznie : trwożnie : (przysł.) shyly
trwozny : trwożny : (przym.) shy
trwozyc : trwożyć : (czas.) affright | : (czas.) awe | : (czas.) frighten | : (czas.) startle
tryb : tryb : (rzecz.) cog-wheel | : (rzecz.) mode | : (rzecz.) mood
trybula : trybula : (rzecz.) chervil
trybun : trybun : (rzecz.) stands | : (rzecz.) tribune
trybuna : trybuna : (rzecz.) platform | : (rzecz.) rostrum | : (rzecz.) tribune
trybunal : trybunał : (rzecz.) tribunal
trybut : trybut : (rzecz.) tribute
trychina : trychina : (rzecz.) hairworm | : (rzecz.) trichina
trychinoza : trychinoza : (rzecz.) trichinosis
trycykl : trycykl : (rzecz.) tricycle
trygonometria : trygonometria : (rzecz.) trigonometry
trygonometryczny : trygonometryczny : (przym.) trigonometric
tryk : tryk : (rzecz.) ram
trykotarstwo : trykotarstwo : (rzecz.) knitting
trykotaz : trykotaż : (rzecz.) hosiery | : (rzecz.) knitter
trykotaze : trykotaże : (rzecz.) hosiery
trykotowy : trykotowy : (przym.) knitted
trykoty : trykoty : (rzecz.) tights
tryktrak : tryktrak : (rzecz.) backgammon
tryl : tryl : (rzecz.) quaver | : (rzecz.) trill
tryliard : tryliard : (rzecz.) sextillion
trylion : trylion : (rzecz.) quintillion | : (rzecz.) trillion
trylogia : trylogia : (rzecz.) trilogy
trymer : trymer : (rzecz.) trimmer
trymestr : trymestr : (rzecz.) term | : (rzecz.) trimester
trymowac : trymować : (czas.) trim
tryper : tryper : (rzecz.) gonorrhoea
trypla : trypla : (rzecz.) rottenstone
tryplet : tryplet : (rzecz.) triplet
tryplikat : tryplikat : (rzecz.) triplicate
tryptyk : tryptyk : (rzecz.) triptych
trysekcja : trysekcja : (rzecz.) trisection
tryskacz : tryskacz : (rzecz.) sprinkler
tryskanie : tryskanie : (rzecz.) ejection
tryskac : tryskać : (czas.) ejaculate | : (czas.) gush | : (czas.) jet | : (czas.) splutter | : (czas.) spout | : (czas.) spurt | : (czas.) squirt | : (czas.) well
tryt : tryt : (rzecz.) tritium
tryton : tryton : (rzecz.) newt | : (rzecz.) triton
tryumf : tryumf : (rzecz.) triumph
tryumfalnie : tryumfalnie : (przysł.) triumphantly
tryumfalny : tryumfalny : (przym.) jubilant | : (przym.) triumphal
tryumfowac : tryumfować : (czas.) gloat | : (czas.) triumph
tryumfujaco : tryumfująco : (przysł.) triumphantly
trywializacja : trywializacja : (rzecz.) trivialization
trywialnie : trywialnie : (przysł.) trivially
trywialnosc : trywialność : (rzecz.) triteness | : (rzecz.) triviality
trywialny : trywialny : (przym.) foulmouthed | : (przym.) foul-mouthed | : (przym.) ordinary | : (przym.) trite | : (przym.) trivial | : (przym.) vulgar
trysniecie : tryśnięcie : (rzecz.) gush | : (rzecz.) squirt
trzask : trzask : (rzecz.) bang | : (rzecz.) clack | : (rzecz.) clap | : (rzecz.) clash | : (rzecz.) crack | : (rzecz.) crackle | : (rzecz.) crash | : (rzecz.) flick | : (rzecz.) pop | : (rzecz.) slam | : (rzecz.) smack | : (rzecz.) smash | : (rzecz.) snap
trzaskanie : trzaskanie : (rzecz.) cracking | : (rzecz.) crackle
trzaskac : trzaskać : (czas.) bang | : (czas.) clack | : (czas.) clap | : (czas.) click | : (czas.) crack | : (czas.) crackle | : (czas.) dash | : (czas.) hit | : (czas.) pop | : (czas.) rip | : (czas.) slam | : (czas.) smack
trzasnac : trzasnąć : (czas.) bang | : (czas.) snap
trzasniecie : trzaśnięcie : (rzecz.) flick | : (rzecz.) smack | : (rzecz.) snap | : (rzecz.) thwack
trzcina : trzcina : (rzecz.) cane | : (rzecz.) reed | : (rzecz.) reeve
trzcinka : trzcinka : (rzecz.) reed
trzcinowy : trzcinowy : (przym.) reedy
trzebienie : trzebienie : (rzecz.) castration | : (rzecz.) clearing | : (rzecz.) thinning
trzebiez : trzebież : (rzecz.) extirpation | : (rzecz.) thinning
trzebic : trzebić : (czas.) cut | : (czas.) exterminate | : (czas.) spay | : (czas.) stub
trzeci : trzeci : (przym.) third
trzeciorzedny : trzeciorzędny : (przym.) tertiary | : (przym.) third-rate
trzeciorzedowy : trzeciorzędowy : (przym.) tertiary
trzepaczka : trzepaczka : (rzecz.) carpet-beater
trzepak : trzepak : (rzecz.) beater | : (rzecz.) horse
trzepanie : trzepanie : (rzecz.) beating
trzepac : trzepać : (czas.) flip
trzepniecie : trzepnięcie : (rzecz.) clap | : (rzecz.) flick | : (rzecz.) flip | : (rzecz.) slap | : (rzecz.) smack
trzepot : trzepot : (rzecz.) flutter
trzepotanie : trzepotanie : (rzecz.) buffeting | : (rzecz.) flop | : (rzecz.) flutter | : (rzecz.) quiver | : (rzecz.) shimmy
trzepotac : trzepotać : (czas.) flap | : (czas.) flop | : (czas.) flutter | : (czas.) quiver
trzeszczenie : trzeszczenie : (rzecz.) cracking | : (rzecz.) creak
trzeszczec : trzeszczeć : (czas.) crack | : (czas.) crackle | : (czas.) creak | : (czas.) crepitate | : (czas.) crunch
trzewia : trzewia : (rzecz.) bowels | : (rzecz.) viscera
trzewik : trzewik : (rzecz.) shoe | : (rzecz.) slipper | : (rzecz.) sneaker
trzewny : trzewny : (przym.) visceral
trzec : trzeć : (czas.) chafe | : (czas.) grate | : (czas.) rub
trzezwiec : trzeźwieć : (czas.) sober
trzezwic : trzeźwić : (czas.) sober
trzezwo : trzeźwo : (przysł.) soberly
trzezwosc : trzeźwość : (rzecz.) abstinence | : (rzecz.) consciousness | : (rzecz.) soberness | : (rzecz.) sobriety | : (rzecz.) temperance
trzezwy : trzeźwy : (przym.) clearheaded | : (przym.) clear-headed | : (przym.) sober | : (przym.) temperate
trzmiel : trzmiel : (rzecz.) bumblebee | : (rzecz.) bumble-bee | : (rzecz.) humblebee | : (rzecz.) humble-bee
trznadel : trznadel : (rzecz.) bunting | : (rzecz.) buntings | : (rzecz.) yellowhammer | : (rzecz.) yellow-hammer
trzoda : trzoda : (rzecz.) drove | : (rzecz.) flock | : (rzecz.) herd
trzon : trzon : (rzecz.) backbone | : (rzecz.) hardcore | : (rzecz.) hearth | : (rzecz.) shaft | : (rzecz.) shank | : (rzecz.) stem | : (rzecz.) trunk
trzonek : trzonek : (rzecz.) handle | : (rzecz.) helve | : (rzecz.) shaft | : (rzecz.) shank
trzonowy : trzonowy : (przym.) molar
trzos : trzos : (rzecz.) money-belt
trzpien : trzpień : (rzecz.) mandrel | : (rzecz.) pivot | : (rzecz.) stem | : (rzecz.) tang
trzpiotka : trzpiotka : (rzecz.) flibbertigibbet
trzpiotowaty : trzpiotowaty : (przym.) airy | : (przym.) coltish | : (przym.) featherbrained | : (przym.) feather-brained
trzustka : trzustka : (rzecz.) pancreas
trzustkowy : trzustkowy : (przym.) pancreatic
trzydziesty : trzydziesty : (przym.) thirtieth
trzykrotka : trzykrotka : (rzecz.) spiderwort
trzykrotnie : trzykrotnie : (przysł.) threefold | : (przysł.) thrice
trzykrotny : trzykrotny : (przym.) threefold
trzylecie : trzylecie : (rzecz.) triennial
trzymacz : trzymacz : (rzecz.) holder
trzymanie : trzymanie : (rzecz.) hold | : (rzecz.) holding | : (rzecz.) keeping
trzymac : trzymać : (czas.) adhere | : (czas.) buoy | : (czas.) cleave | : (czas.) cling | : (czas.) clung | : (czas.) fumble | : (czas.) grip | : (czas.) hold | : (czas.) keep | : (czas.) stay
trzynasty : trzynasty : (przym.) thirteenth
trzasc : trząść : (czas.) jar | : (czas.) jolt | : (czas.) jounce | : (czas.) quake | : (czas.) shake | : (czas.) shiver | : (czas.) toss | : (czas.) totter | : (czas.) tremble | : (czas.) wobble
trzesawisko : trzęsawisko : (rzecz.) bog | : (rzecz.) fen | : (rzecz.) moor | : (rzecz.) morass | : (rzecz.) quagmire | : (rzecz.) slough | : (rzecz.) swamp
trzesienie : trzęsienie : (rzecz.) agitation | : (rzecz.) earthquake | : (rzecz.) quake | : (rzecz.) rumble-tumble | : (rzecz.) shudder
troja : trója : (rzecz.) fair | : (rzecz.) pass
trojbarwny : trójbarwny : (przym.) tricolour
trojboj : trójbój : (rzecz.) track-athletics
trojca : trójca : (rzecz.) trinity
trojchloroetylen : trójchloroetylen : (rzecz.) trichloroethylene
trojchlorometan : trójchlorometan : (rzecz.) chloroform
trojdzielny : trójdzielny : (przym.) treble | : (przym.) tripartite
trojdzwiek : trójdźwięk : (rzecz.) triad
trojka : trójka : (rzecz.) three | : (rzecz.) threesome | : (rzecz.) trey | : (rzecz.) triad | : (rzecz.) trinity | : (rzecz.) trio | : (rzecz.) tripe | : (rzecz.) triplet | : (rzecz.) troika
trojkat : trójkąt : (rzecz.) triangle
trojkatnie : trójkątnie : (przysł.) triangularly
trojkatny : trójkątny : (przym.) triangular
trojkatowanie : trójkątowanie : (rzecz.) triangles
trojlisc : trójliść : (rzecz.) trefoil
trojmasztowiec : trójmasztowiec : (rzecz.) three-master
trojmian : trójmian : (rzecz.) trinomial
trojnik : trójnik : (rzecz.) joint
trojnitka : trójnitka : (rzecz.) houseline
trojnitrotoluen : trójnitrotoluen : (rzecz.) trinitrotoluene
trojnog : trójnóg : (rzecz.) tripod | : (rzecz.) trivet
trojpokladowiec : trójpokładowiec : (rzecz.) three-decker
trojstanowy : trójstanowy : (przym.) tri-state
trojstronny : trójstronny : (przym.) trilateral
trojtlenek : trójtlenek : (rzecz.) trioxide
trojwartosciowy : trójwartościowy : (przym.) trivalent
trojwiersz : trójwiersz : (rzecz.) triplet
trojwymiarowy : trójwymiarowy : (przym.) three-dimensional
trojzab : trójząb : (rzecz.) herb | : (rzecz.) trident
trojscienny : trójścienny : (przym.) trihedral
traba : trąba : (rzecz.) horn | : (rzecz.) proboscis | : (rzecz.) trumpet | : (rzecz.) trunk
trabienie : trąbienie : (rzecz.) blare | : (rzecz.) toot
trabic : trąbić : (czas.) blare | : (czas.) honk | : (czas.) proclaim | : (czas.) roar | : (czas.) toot | : (czas.) trumpet
trabka : trąbka : (rzecz.) bugle | : (rzecz.) clarion | : (rzecz.) cornet | : (rzecz.) proboscis | : (rzecz.) trumpet
tracac : trącać : (czas.) jog | : (czas.) jostle | : (czas.) knock | : (czas.) tip
tracenie : trącenie : (rzecz.) nudge
tracic : trącić : (czas.) abate | : (czas.) nudge | : (czas.) smell
trad : trąd : (rzecz.) leprosy
tradzik : trądzik : (rzecz.) acne
trebacz : trębacz : (rzecz.) bugler | : (rzecz.) trumpeter
tredowaty : trędowaty : (przym.) leprous
tsunami : tsunami : (rzecz.) tsunami
tu : tu : (przysł.) here | : (przysł.) herein | : (przysł.) hither
tuba : tuba : (rzecz.) flare | : (rzecz.) horn | : (rzecz.) trumpet | : (rzecz.) tube
tubalny : tubalny : (przym.) stentorian
tubek : tubek : (rzecz.) fish
tuberkuliczny : tuberkuliczny : (przym.) tubercular
tuberkulina : tuberkulina : (rzecz.) tuberculin
tuberkuloza : tuberkuloza : (rzecz.) tuberculosis
tuberoza : tuberoza : (rzecz.) tuberose
tubing : tubing : (rzecz.) tubing
tubka : tubka : (rzecz.) tube
tubowy : tubowy : (przym.) tubular
tubus : tubus : (rzecz.) tube
tubylcy : tubylcy : (rzecz.) aborigines
tubylczo : tubylczo : (przysł.) natively
tubylczy : tubylczy : (przym.) autochthonous | : (przym.) indigenous | : (przym.) native | : (przym.) vernacular
tubylec : tubylec : (rzecz.) aboriginal | : (rzecz.) autochthon | : (rzecz.) native
tuczarnia : tuczarnia : (rzecz.) battery | : (rzecz.) feedlot
tucznik : tucznik : (rzecz.) hog | : (rzecz.) porker
tuczyc : tuczyć : (czas.) fat | : (czas.) fatten | : (czas.) feed | : (czas.) plump
tuf : tuf : (rzecz.) tuff
tukan : tukan : (rzecz.) toucan
tul : tul : (rzecz.) thulium
tuleja : tuleja : (rzecz.) bush | : (rzecz.) muff | : (rzecz.) quill | : (rzecz.) sleeve
tulejka : tulejka : (rzecz.) bush | : (rzecz.) bushing | : (rzecz.) ferrule | : (rzecz.) muff | : (rzecz.) socket
tulenie : tulenie : (rzecz.) cuddle
tulipan : tulipan : (rzecz.) tulip
tulic : tulić : (czas.) cuddle | : (czas.) fondle | : (czas.) hug | : (czas.) nestle
tuman : tuman : (rzecz.) blockhead | : (rzecz.) dunderhead | : (rzecz.) lummox | : (rzecz.) mist | : (rzecz.) nitwit | : (rzecz.) slowcoach | : (rzecz.) slow-coach | : (rzecz.) yuk | : (rzecz.) zombie
tumult : tumult : (rzecz.) tumult
tundra : tundra : (rzecz.) tundra
tunel : tunel : (rzecz.) cutting | : (rzecz.) subway | : (rzecz.) tunnel
tunika : tunika : (rzecz.) tunic
tupanie : tupanie : (rzecz.) patter
tupac : tupać : (czas.) stamp
tupet : tupet : (rzecz.) audacity | : (rzecz.) cheek | : (rzecz.) impudence | : (rzecz.) nerve | : (rzecz.) sauce | : (rzecz.) self-confidence
tupot : tupot : (rzecz.) patter
tupotac : tupotać : (czas.) stamp
tur : tur : (rzecz.) aurochs | : (rzecz.) bison
tura : tura : (rzecz.) cat-lap | : (rzecz.) round | : (rzecz.) run | : (rzecz.) tour | : (rzecz.) turn
turban : turban : (rzecz.) turban
turbina : turbina : (rzecz.) turbine
turbodoladowanie : turbodoładowanie : (rzecz.) turbocharger
turbogenerator : turbogenerator : (rzecz.) turbo-generator
turboodrzutowy : turboodrzutowy : (przym.) turbojet
turbosprezarka : turbosprężarka : (rzecz.) supercharger | : (rzecz.) turbocharger
turbowac : turbować : (czas.) trouble
turbosmiglowiec : turbośmigłowiec : (rzecz.) turboprop
turbosmiglowy : turbośmigłowy : (przym.) turboprop
turbulencja : turbulencja : (rzecz.) turbulence
turbulentny : turbulentny : (przym.) turbulent
turkawka : turkawka : (rzecz.) doves | : (rzecz.) turtledove | : (rzecz.) turtle-dove
turkot : turkot : (rzecz.) rattle | : (rzecz.) rumble
turkotac : turkotać : (czas.) bump | : (czas.) rattle | : (czas.) rumble
turkus : turkus : (rzecz.) turquoise
turkusowy : turkusowy : (przym.) cyan
turlac : turlać : (czas.) roll
turmalin : turmalin : (rzecz.) tourmaline
turnia : turnia : (rzecz.) alp | : (rzecz.) crag | : (rzecz.) peak
turniej : turniej : (rzecz.) tilts | : (rzecz.) tournament | : (rzecz.) tourney
turnikiet : turnikiet : (rzecz.) turnstile
turnus : turnus : (rzecz.) period
turysta : turysta : (rzecz.) excursionist | : (rzecz.) hiker | : (rzecz.) holidaymaker | : (rzecz.) sightseer | : (rzecz.) tourist
turystyka : turystyka : (rzecz.) tourism
tusz : tusz : (rzecz.) carcasses | : (rzecz.) douche | : (rzecz.) flourish | : (rzecz.) ink | : (rzecz.) mascara | : (rzecz.) shower-bath
tusza : tusza : (rzecz.) carcase | : (rzecz.) carcass | : (rzecz.) corpulence | : (rzecz.) fatness
tuszowac : tuszować : (czas.) efface | : (czas.) smother
tutaj : tutaj : (przysł.) here
tutka : tutka : (rzecz.) cornet
tuzin : tuzin : (rzecz.) dozen
tuzinkowy : tuzinkowy : (przym.) hackneyed | : (przym.) trite | : (przym.) trivial
tulactwo : tułactwo : (rzecz.) exile
tulacz : tułacz : (rzecz.) drifter | : (rzecz.) wanderer
tulaczy : tułaczy : (przym.) homeless
tulac : tułać : (czas.) wander
tulow : tułów : (rzecz.) body | : (rzecz.) thorax | : (rzecz.) torso | : (rzecz.) trunk
tunczyk : tuńczyk : (rzecz.) albacore | : (rzecz.) tuna
twardnienie : twardnienie : (rzecz.) hardening
twardniec : twardnieć : (czas.) fix | : (czas.) harden | : (czas.) set
twardo : twardo : (przysł.) hard | : (przysł.) sternly | : (przysł.) stiffly | : (przysł.) strictly | : (przysł.) toughly
twardoglowy : twardogłowy : (przym.) diehard
twardosc : twardość : (rzecz.) endurance | : (rzecz.) firmness | : (rzecz.) hardness | : (rzecz.) rigidity | : (rzecz.) toughness
twardy : twardy : (przym.) adamant | : (przym.) adamantine | : (przym.) callous | : (przym.) firm | : (przym.) hard | : (przym.) hardboiled | : (przym.) hard-boiled | : (przym.) hardcore | : (przym.) hard-core | : (przym.) landed | : (przym.) rigid | : (przym.) stiff | : (przym.) strong | : (przym.) tough
twardziel : twardziel : (rzecz.) heart-wood | : (rzecz.) toughie
twardowka : twardówka : (rzecz.) sclera
twarz : twarz : (rzecz.) countenance | : (rzecz.) face | : (rzecz.) mug
twarzowy : twarzowy : (przym.) appropriate | : (przym.) becoming | : (przym.) facial
twarog : twaróg : (rzecz.) bonnyclabber | : (rzecz.) clabber | : (rzecz.) curd
tweed : tweed : (rzecz.) tweed
twierdza : twierdza : (rzecz.) fastness | : (rzecz.) fort | : (rzecz.) fortress | : (rzecz.) stronghold | : (rzecz.) tower
twierdzenie : twierdzenie : (rzecz.) affirmation | : (rzecz.) assertion | : (rzecz.) asseveration | : (rzecz.) averment | : (rzecz.) axis | : (rzecz.) claim | : (rzecz.) contention | : (rzecz.) enunciation | : (rzecz.) maintenance | : (rzecz.) objection | : (rzecz.) predication | : (rzecz.) proposition | : (rzecz.) statement | : (rzecz.) theorem | : (rzecz.) word
twierdzic : twierdzić : (czas.) affirm | : (czas.) allege | : (czas.) assert | : (czas.) assure | : (czas.) claim | : (czas.) contend | : (czas.) declare | : (czas.) maintain | : (czas.) predicate | : (czas.) pretend | : (czas.) profess
twierdzaco : twierdząco : (przysł.) affirmatively
twierdzacy : twierdzący : (przym.) affirmative | : (przym.) positive
twist : twist : (rzecz.) twist
twornik : twornik : (rzecz.) armature | : (rzecz.) stator
tworzenie : tworzenie : (rzecz.) blocking | : (rzecz.) creation | : (rzecz.) formation | : (rzecz.) instantiation | : (rzecz.) making | : (rzecz.) origination
tworzywo : tworzywo : (rzecz.) material | : (rzecz.) stuff
tworzyc : tworzyć : (czas.) beget | : (czas.) choreograph | : (czas.) compose | : (czas.) constitute | : (czas.) create | : (czas.) develop | : (czas.) fabricate | : (czas.) figure | : (czas.) form | : (czas.) found | : (czas.) frame | : (czas.) generate | : (czas.) instantiate | : (czas.) make | : (czas.) materialize
twor : twór : (rzecz.) creation | : (rzecz.) creature | : (rzecz.) formation | : (rzecz.) port | : (rzecz.) spawn
tworca : twórca : (rzecz.) architect | : (rzecz.) artist | : (rzecz.) author | : (rzecz.) creator | : (rzecz.) founder | : (rzecz.) maker | : (rzecz.) originator | : (rzecz.) writer
tworcy : twórcy : (rzecz.) creators
tworczo : twórczo : (przysł.) creatively
tworczosc : twórczość : (rzecz.) creativity | : (rzecz.) output | : (rzecz.) work
tworczy : twórczy : (przym.) constructive | : (przym.) creative | : (przym.) imaginative
tyczka : tyczka : (rzecz.) perch | : (rzecz.) pole
tyczyc : tyczyć : (czas.) belong | : (czas.) refer
tydzien : tydzień : (rzecz.) week | : (rzecz.) weeks
tyfoidalny : tyfoidalny : (przym.) typhoid
tyfus : tyfus : (rzecz.) typhoid | : (rzecz.) typhus
tyfusowy : tyfusowy : (przym.) typhoid
tygiel : tygiel : (rzecz.) crucible | : (rzecz.) melting-pot
tygodnik : tygodnik : (rzecz.) weekly
tygodniowy : tygodniowy : (przym.) week's
tygrys : tygrys : (rzecz.) tiger
tyka : tyka : (rzecz.) beanpole
tykanie : tykanie : (rzecz.) tick
tykac : tykać : (czas.) strike | : (czas.) tick | : (czas.) touch
tykniecie : tyknięcie : (rzecz.) tick
tykwa : tykwa : (rzecz.) bottle-gourd | : (rzecz.) calabash | : (rzecz.) gourd
tylda : tylda : (rzecz.) tilde
tyle : tyle : (przysł.) so
tylec : tylec : (rzecz.) snag
tylko : tylko : (przysł.) alone | : (przysł.) barely | : (przysł.) but | : (przysł.) exclusively | : (przysł.) just | : (przysł.) merely | : (przysł.) only | : (przysł.) purely
tylni : tylni : (przym.) after | : (przym.) hind
tylnica : tylnica : (rzecz.) stern | : (rzecz.) sternpost
tylnojezykowy : tylnojęzykowy : (przym.) velar
tylnokolowiec : tylnokołowiec : (rzecz.) sternwheeler
tylny : tylny : (przym.) after | : (przym.) back | : (przym.) backward | : (przym.) hind | : (przym.) posterior | : (przym.) rearward
tymczasem : tymczasem : (przysł.) meantime | : (przysł.) meanwhile
tymczasowo : tymczasowo : (przysł.) provisionally | : (przysł.) temporarily
tymczasowosc : tymczasowość : (rzecz.) temporality
tymczasowy : tymczasowy : (przym.) interim | : (przym.) interlocutory | : (przym.) modifiable | : (przym.) provisional | : (przym.) temporal | : (przym.) temporary | : (przym.) volatile
tymianek : tymianek : (rzecz.) thyme | : (rzecz.) thymus
tymina : tymina : (rzecz.) thymine
tympanon : tympanon : (rzecz.) tympanum
tynk : tynk : (rzecz.) daub | : (rzecz.) grout | : (rzecz.) plaster | : (rzecz.) roughcast | : (rzecz.) rough-cast | : (rzecz.) stucco
tynkal : tynkal : (rzecz.) borax
tynkarski : tynkarski : (przym.) plasterer's
tynkarz : tynkarz : (rzecz.) plasterer
tynkowac : tynkować : (czas.) plaster
tynktura : tynktura : (rzecz.) tincture
typ : typ : (rzecz.) character | : (rzecz.) kind | : (rzecz.) nature | : (rzecz.) sort | : (rzecz.) type
typek : typek : (rzecz.) chap | : (rzecz.) character | : (rzecz.) joker
typograf : typograf : (rzecz.) typographer
typografia : typografia : (rzecz.) typography
typograficznie : typograficznie : (przysł.) typographically
typograficzny : typograficzny : (przym.) typographic | : (przym.) typographical
typologia : typologia : (rzecz.) typology
typooffset : typooffset : (rzecz.) letterset
typowac : typować : (czas.) designate | : (czas.) typecast
typowo : typowo : (przysł.) typically
typowosc : typowość : (rzecz.) typicality
typowy : typowy : (przym.) atypical | : (przym.) basal | : (przym.) classic | : (przym.) classical | : (przym.) conventional | : (przym.) quintessential | : (przym.) racy | : (przym.) typical
tyrada : tyrada : (rzecz.) rant | : (rzecz.) screed | : (rzecz.) tirade
tyran : tyran : (rzecz.) bully | : (rzecz.) taskmaster | : (rzecz.) tyrant
tyrania : tyrania : (rzecz.) tyranny
tyranizowac : tyranizować : (czas.) domineer | : (czas.) tyrannize
tyranozaur : tyranozaur : (rzecz.) tyrannosaur | : (rzecz.) tyrannosaurus
tyranski : tyrański : (przym.) tyrannical
tyrozyna : tyrozyna : (rzecz.) tyrosine
tysiac : tysiąc : (rzecz.) thousand
tysiaclecie : tysiąclecie : (rzecz.) millennium
tysiacletni : tysiącletni : (przym.) millenary | : (przym.) millennial
tysiaczny : tysiączny : (przym.) thousandth
tysieczny : tysięczny : (przym.) thousand | : (przym.) thousandth
tytan : tytan : (rzecz.) titan | : (rzecz.) titanium
tytaniczny : tytaniczny : (przym.) titanic
tytanowy : tytanowy : (przym.) titanic
tyton : tytoń : (rzecz.) tobacco | : (rzecz.) tobacco-plant
tytularny : tytularny : (przym.) nominal | : (przym.) titular
tytul : tytuł : (rzecz.) captain | : (rzecz.) caption | : (rzecz.) style | : (rzecz.) title
tytulowanie : tytułowanie : (rzecz.) title | : (rzecz.) titling
tytulowac : tytułować : (czas.) address | : (czas.) entitle | : (czas.) title
tytulowy : tytułowy : (przym.) eponymous | : (przym.) front-page
tyc : tyć : (czas.) fatten | : (czas.) plump
tyl : tył : (rzecz.) back | : (rzecz.) rear
tylek : tyłek : (rzecz.) ass | : (rzecz.) backside | : (rzecz.) behind | : (rzecz.) bottom | : (rzecz.) breech | : (rzecz.) bum
tylem : tyłem : (przysł.) backward | : (przysł.) backwards
tapniecie : tąpnięcie : (rzecz.) crump
tecza : tęcza : (rzecz.) iris | : (rzecz.) rainbow | : (rzecz.) screen
teczowka : tęczówka : (rzecz.) iris
tedy : tędy : (przysł.) here
tegi : tęgi : (przym.) burly | : (przym.) corpulent | : (przym.) doughty | : (przym.) lusty | : (przym.) portly | : (przym.) stalwart | : (przym.) stout | : (przym.) tough | : (przym.) virile
tego : tęgo : (przysł.) this
tegoryjec : tęgoryjec : (rzecz.) hookworm
tegosc : tęgość : (rzecz.) corpulence
tepak : tępak : (rzecz.) ass | : (rzecz.) blockhead | : (rzecz.) bonehead | : (rzecz.) booby | : (rzecz.) dullard | : (rzecz.) dunce | : (rzecz.) featherbrain | : (rzecz.) loggerhead | : (rzecz.) moron | : (rzecz.) slowcoach | : (rzecz.) slow-coach
tepiciel : tępiciel : (rzecz.) exterminator
tepienie : tępienie : (rzecz.) fight
tepiec : tępieć : (czas.) dull
tepic : tępić : (czas.) combat | : (czas.) destroy | : (czas.) dull | : (czas.) exterminate
tepota : tępota : (rzecz.) density | : (rzecz.) limitation | : (rzecz.) obtuseness | : (rzecz.) opacity | : (rzecz.) thickhead
teposc : tępość : (rzecz.) dullness
tepy : tępy : (przym.) blunt | : (przym.) clueless | : (przym.) crass | : (przym.) dull | : (przym.) insipid | : (przym.) logy | : (przym.) obtuse | : (przym.) pointless | : (przym.) slow | : (przym.) slow-witted | : (przym.) stupid | : (przym.) thick-headed | : (przym.) vacant | : (przym.) vapid | : (przym.) wooden
tesknica : tęsknica : (rzecz.) miss
teskniacy : tęskniący : (przym.) wistful
tesknic : tęsknić : (czas.) hanker | : (czas.) languish | : (czas.) long | : (czas.) miss | : (czas.) pine | : (czas.) yearn
tesknota : tęsknota : (rzecz.) hankering | : (rzecz.) homesickness | : (rzecz.) longing | : (rzecz.) nostalgia
teskny : tęskny : (przym.) languorous | : (przym.) wistful
tetent : tętent : (rzecz.) clip-clop | : (rzecz.) rattle
tetniak : tętniak : (rzecz.) aneurism | : (rzecz.) aneurysm
tetnica : tętnica : (rzecz.) artery
tetnicowy : tętnicowy : (przym.) arterial
tetniczy : tętniczy : (przym.) arterial
tetnienie : tętnienie : (rzecz.) pulsation | : (rzecz.) ripple
tetnic : tętnić : (czas.) pulsate | : (czas.) pulse | : (czas.) throb
tetno : tętno : (rzecz.) pulse
tezec : tężec : (rzecz.) lockjaw | : (rzecz.) tetanus
tezenie : tężenie : (rzecz.) coagulation | : (rzecz.) setting
tezec : tężeć : (czas.) coagulate | : (czas.) freeze
teznik : tężnik : (rzecz.) stay
tezyzna : tężyzna : (rzecz.) brawn | : (rzecz.) burliness | : (rzecz.) fitness
tlamsic : tłamsić : (czas.) smother
tlo : tło : (rzecz.) backcloth | : (rzecz.) backdrop | : (rzecz.) background | : (rzecz.) selling | : (rzecz.) setting
tloczek : tłoczek : (rzecz.) plunger | : (rzecz.) push-piece | : (rzecz.) side-push
tloczenie : tłoczenie : (rzecz.) pressing
tlocznia : tłocznia : (rzecz.) press
tlocznictwo : tłocznictwo : (rzecz.) presswork
tlocznik : tłocznik : (rzecz.) die
tloczyc : tłoczyć : (czas.) congest | : (czas.) cram | : (czas.) crowd | : (czas.) emboss | : (czas.) herd | : (czas.) hustle | : (czas.) press | : (czas.) push | : (czas.) squash | : (czas.) swarm | : (czas.) throng
tlok : tłok : (rzecz.) cram | : (rzecz.) crowd | : (rzecz.) hustle | : (rzecz.) jam | : (rzecz.) piston | : (rzecz.) plunger | : (rzecz.) press | : (rzecz.) squash | : (rzecz.) throng
tluc : tłuc : (czas.) batter | : (czas.) break | : (czas.) drub | : (czas.) mash | : (czas.) mingle | : (czas.) pestle | : (czas.) pound
tluczek : tłuczek : (rzecz.) beater | : (rzecz.) dolly | : (rzecz.) pestle
tluczenie : tłuczenie : (rzecz.) cracking
tluczen : tłuczeń : (rzecz.) rubble
tluczka : tłuczka : (rzecz.) cracker
tluk : tłuk : (rzecz.) moron | : (rzecz.) stamp
tluka : tłuka : (rzecz.) drift-ice
tlum : tłum : (rzecz.) concourse | : (rzecz.) crowd | : (rzecz.) flock | : (rzecz.) herd | : (rzecz.) host | : (rzecz.) jam | : (rzecz.) mob | : (rzecz.) multitude | : (rzecz.) populace | : (rzecz.) shoal | : (rzecz.) throng
tlumacz : tłumacz : (rzecz.) interpreter | : (rzecz.) translation | : (rzecz.) translator
tlumaczenie : tłumaczenie : (rzecz.) render | : (rzecz.) translation
tlumaczeniowy : tłumaczeniowy : (przym.) translational
tlumaczyc : tłumaczyć : (czas.) anglicize | : (czas.) assemble | : (czas.) construe | : (czas.) explain | : (czas.) expound | : (czas.) interpret | : (czas.) justify | : (czas.) plead | : (czas.) translate | : (czas.) turn
tlumienie : tłumienie : (rzecz.) attenuation | : (rzecz.) strangulation | : (rzecz.) suppression
tlumik : tłumik : (rzecz.) absorber | : (rzecz.) attenuator | : (rzecz.) damper | : (rzecz.) exhaust | : (rzecz.) muffler | : (rzecz.) mute | : (rzecz.) pad | : (rzecz.) silencer | : (rzecz.) suppressor
tlumiony : tłumiony : (przym.) dead-beat
tlumic : tłumić : (czas.) attenuate | : (czas.) blight | : (czas.) choke | : (czas.) damp | : (czas.) dampen | : (czas.) deaden | : (czas.) depress | : (czas.) extinguish | : (czas.) muffle | : (czas.) quash | : (czas.) quell | : (czas.) quench | : (czas.) repress | : (czas.) smother | : (czas.) stifle | : (czas.) suppress | : (czas.) throttle
tlumny : tłumny : (przym.) numerous
tlumok : tłumok : (rzecz.) bundle | : (rzecz.) truss
tlustosc : tłustość : (rzecz.) greasiness
tlusty : tłusty : (przym.) adipose | : (przym.) bold | : (przym.) fat | : (przym.) fatty | : (przym.) fleshy | : (przym.) greasy | : (przym.) gross | : (przym.) oily | : (przym.) plump | : (przym.) snotty | : (przym.) thick | : (przym.) unctuous
tluszcz : tłuszcz : (rzecz.) adipose | : (rzecz.) blubber | : (rzecz.) fat | : (rzecz.) grease | : (rzecz.) suet | : (rzecz.) tallow
tluszcza : tłuszcza : (rzecz.) rag-tag
tluszczenie : tłuszczenie : (rzecz.) fat
tluszczowiec : tłuszczowiec : (rzecz.) lipoid
tluszczowy : tłuszczowy : (przym.) fat | : (przym.) fatty
tluscioch : tłuścioch : (rzecz.) fatty
tluscic : tłuścić : (czas.) fat | : (czas.) grease | : (czas.) lubricate
