u-rurka : U-rurka : (rzecz.) u-tube
urszula : Urszula : (rzecz.) Ursula
u : u : (przyim.) at | : (przyim.) on | : (przyim.) upon | : (przyim.) with
uaktualniac : uaktualniać : (czas.) update | : (czas.) upgrade
uaktualnienie : uaktualnienie : (rzecz.) update
uaktualnic : uaktualnić : (czas.) upgrade
uaktywniac : uaktywniać : (czas.) activated | : (czas.) revitalize
uaktywnic : uaktywnić : (czas.) activate
uargumentowac : uargumentować : (czas.) plead
ubabrac : ubabrać : (czas.) dirty
ubarwienie : ubarwienie : (rzecz.) colouration
ubaw : ubaw : (rzecz.) fun
ubawic : ubawić : (czas.) amuse
ubezpieczalnia : ubezpieczalnia : (rzecz.) insurance
ubezpieczac : ubezpieczać : (czas.) assure | : (czas.) cover | : (czas.) insure | : (czas.) underwrite
ubezpieczenie : ubezpieczenie : (rzecz.) assertion | : (rzecz.) assurance | : (rzecz.) insurance
ubezpieczeniowy : ubezpieczeniowy : (przym.) actuarial
ubezpieczyciel : ubezpieczyciel : (rzecz.) insurer | : (rzecz.) underwriter
ubezpieczyc : ubezpieczyć : (czas.) ensure | : (czas.) insure
ubezwlasnowolnienie : ubezwłasnowolnienie : (rzecz.) disability | : (rzecz.) incapacitation | : (rzecz.) restraints
ubezwlasnowolnic : ubezwłasnowolnić : (czas.) incapacitate
ubiczowac : ubiczować : (czas.) flagellate
ubiegac : ubiegać : (czas.) apply | : (czas.) canvass | : (czas.) contest | : (czas.) request | : (czas.) solicit
ubieralnia : ubieralnia : (rzecz.) dressing-room
ubieranie : ubieranie : (rzecz.) dressing
ubierac : ubierać : (czas.) attire | : (czas.) clothe | : (czas.) dress | : (czas.) suit | : (czas.) wear
ubijacz : ubijacz : (rzecz.) beetle | : (rzecz.) rammer
ubijak : ubijak : (rzecz.) beater | : (rzecz.) beetle | : (rzecz.) compactor | : (rzecz.) rammer
ubijanie : ubijanie : (rzecz.) beating
ubijarka : ubijarka : (rzecz.) compactor
ubijac : ubijać : (czas.) beat | : (czas.) pun | : (czas.) slaughter | : (czas.) tamp | : (czas.) whip | : (czas.) whisk
ubikacja : ubikacja : (rzecz.) bathrooms | : (rzecz.) lavatory | : (rzecz.) loo | : (rzecz.) toilet | : (rzecz.) water-closet
ubior : ubiór : (rzecz.) attire | : (rzecz.) clothes | : (rzecz.) clothing | : (rzecz.) costume | : (rzecz.) dress | : (rzecz.) garb | : (rzecz.) habiliment | : (rzecz.) suit
ubic : ubić : (czas.) kill | : (czas.) tamp
ublizac : ubliżać : (czas.) disparage
ubocznie : ubocznie : (przysł.) incidentally
uboczny : uboczny : (przym.) accidental | : (przym.) adventitious | : (przym.) circumstantial | : (przym.) collateral | : (przym.) digressive | : (przym.) extraneous | : (przym.) incidental | : (przym.) peripheral
ubogacac : ubogacać : (czas.) enrich
ubogacic : ubogacić : (czas.) enrich
ubogi : ubogi : (przym.) hungry | : (przym.) impecunious | : (przym.) lean | : (przym.) meagre | : (przym.) penurious | : (przym.) poky | : (przym.) poor | : (przym.) scanty
ubogo : ubogo : (przysł.) meagrely | : (przysł.) poorly
ubojnia : ubojnia : (rzecz.) slaughterhouse
ubolewanie : ubolewanie : (rzecz.) condolence | : (rzecz.) regret | : (rzecz.) sympathy
ubolewac : ubolewać : (czas.) deplore | : (czas.) grieve | : (czas.) lament
ubrania : ubrania : (rzecz.) clothes
ubranie : ubranie : (rzecz.) attire | : (rzecz.) cloth | : (rzecz.) clothes | : (rzecz.) clothing | : (rzecz.) coat | : (rzecz.) dress | : (rzecz.) duds | : (rzecz.) iron | : (rzecz.) suit | : (rzecz.) thing
ubrac : ubrać : (czas.) attire | : (czas.) clothe | : (czas.) invest | : (czas.) wear
ubrudzenie : ubrudzenie : (rzecz.) muddying
ubrudzic : ubrudzić : (czas.) dirty
ubycie : ubycie : (rzecz.) loss | : (rzecz.) wane
ubytek : ubytek : (rzecz.) cavity | : (rzecz.) decrease | : (rzecz.) decrement | : (rzecz.) ebb | : (rzecz.) lessening | : (rzecz.) loss | : (rzecz.) shrinkage | : (rzecz.) wastage
ubywac : ubywać : (czas.) decrease | : (czas.) diminish | : (czas.) subside
uboj : ubój : (rzecz.) butchery | : (rzecz.) slaughter
ubostwianie : ubóstwianie : (rzecz.) adoration | : (rzecz.) deification
ubostwiac : ubóstwiać : (czas.) adore | : (czas.) deify | : (czas.) dote | : (czas.) idolise | : (czas.) idolize | : (czas.) love | : (czas.) worship
ubostwienie : ubóstwienie : (rzecz.) deification
ubostwo : ubóstwo : (rzecz.) bareness | : (rzecz.) destitution | : (rzecz.) penury | : (rzecz.) poverty
ucapic : ucapić : (czas.) catch
ucalowanie : ucałowanie : (rzecz.) kiss
ucalowac : ucałować : (czas.) kiss
ucha : ucha : (rzecz.) ear
ucharakteryzowanie : ucharakteryzowanie : (rzecz.) characterization
ucharakteryzowac : ucharakteryzować : (czas.) disguise
uchatka : uchatka : (rzecz.) sea-lion
ucho : ucho : (rzecz.) cringle | : (rzecz.) ear | : (rzecz.) handle | : (rzecz.) tab
uchodzenie : uchodzenie : (rzecz.) egression | : (rzecz.) ooze | : (rzecz.) passing
uchodzic : uchodzić : (czas.) bleed | : (czas.) escape | : (czas.) pass
uchodzca : uchodźca : (rzecz.) émigré | : (rzecz.) exile | : (rzecz.) expatriate | : (rzecz.) refugee
uchodzstwo : uchodźstwo : (rzecz.) exile
uchowac : uchować : (czas.) escape
uchronienie : uchronienie : (rzecz.) preservation
uchronic : uchronić : (czas.) save
uchwalac : uchwalać : (czas.) carry | : (czas.) decree | : (czas.) pass | : (czas.) vote
uchwalic : uchwalić : (czas.) adopt
uchwala : uchwała : (rzecz.) act | : (rzecz.) credit | : (rzecz.) decision | : (rzecz.) resolution | : (rzecz.) vote
uchwycenie : uchwycenie : (rzecz.) capturing | : (rzecz.) seizing
uchwycic : uchwycić : (czas.) apprehend | : (czas.) capture | : (czas.) grasp | : (czas.) grasped | : (czas.) seize
uchwyt : uchwyt : (rzecz.) catching | : (rzecz.) chuck | : (rzecz.) clamper | : (rzecz.) clip | : (rzecz.) fang | : (rzecz.) grasp | : (rzecz.) grip | : (rzecz.) handhold | : (rzecz.) handle | : (rzecz.) holder | : (rzecz.) nip | : (rzecz.) shank | : (rzecz.) tag
uchwytem : uchwytem : (rzecz.) platter
uchwytny : uchwytny : (przym.) attainable | : (przym.) audible | : (przym.) graspable | : (przym.) noticeable | : (przym.) perceptible | : (przym.) reachable | : (przym.) sensible | : (przym.) tangible
uchyb : uchyb : (rzecz.) deviation | : (rzecz.) error | : (rzecz.) offset
uchybiac : uchybiać : (czas.) offend
uchybienie : uchybienie : (rzecz.) default | : (rzecz.) failure | : (rzecz.) fault | : (rzecz.) inadvertence | : (rzecz.) inadvertency | : (rzecz.) indiscretion | : (rzecz.) lapse | : (rzecz.) offence | : (rzecz.) shortcoming | : (rzecz.) solecism | : (rzecz.) transgression
uchybic : uchybić : (czas.) fail | : (czas.) offend
uchylanie : uchylanie : (rzecz.) avoidance | : (rzecz.) evasion
uchylac : uchylać : (czas.) avoid | : (czas.) boggle | : (czas.) deactivate | : (czas.) deviate | : (czas.) disconnect | : (czas.) evade | : (czas.) flinch | : (czas.) lift | : (czas.) lurch | : (czas.) overrule | : (czas.) quash | : (czas.) raise | : (czas.) remove | : (czas.) repeal | : (czas.) revoke | : (czas.) shirk
uchylenie : uchylenie : (rzecz.) annulling | : (rzecz.) annulment | : (rzecz.) derogation | : (rzecz.) evasion | : (rzecz.) repeal | : (rzecz.) rescission | : (rzecz.) reversal | : (rzecz.) waiver
uchylic : uchylić : (czas.) defeat | : (czas.) repealed | : (czas.) waive
ucichac : ucichać : (czas.) subside
ucichniecie : ucichnięcie : (rzecz.) calm
ucichnac : ucichnąć : (czas.) hush
uciec : uciec : (rzecz.) escape
uciecha : uciecha : (rzecz.) delight | : (rzecz.) enjoyment | : (rzecz.) fun | : (rzecz.) glee | : (rzecz.) joy | : (rzecz.) merriment | : (rzecz.) merrymaking | : (rzecz.) merry-making | : (rzecz.) pleasance
ucieczka : ucieczka : (rzecz.) bolt | : (rzecz.) elopement | : (rzecz.) escape | : (rzecz.) flight | : (rzecz.) flit | : (rzecz.) getaway | : (rzecz.) recourse | : (rzecz.) resort | : (rzecz.) retreat | : (rzecz.) scamper | : (rzecz.) scud | : (rzecz.) scurry | : (rzecz.) scuttle
uciekanie : uciekanie : (rzecz.) recourse | : (rzecz.) resort
uciekac : uciekać : (czas.) abscond | : (czas.) appeal | : (czas.) decamp | : (czas.) defect | : (czas.) elapse | : (czas.) elope | : (czas.) elude | : (czas.) escape | : (czas.) flee | : (czas.) recur | : (czas.) resort | : (czas.) run | : (czas.) scurry
uciekinier : uciekinier : (rzecz.) absconder | : (rzecz.) defector | : (rzecz.) deserter | : (rzecz.) fugitive | : (rzecz.) refugee | : (rzecz.) runaway
ucielesniac : ucieleśniać : (czas.) embody | : (czas.) encarnalize | : (czas.) impersonate | : (czas.) personify
ucielesnienie : ucieleśnienie : (rzecz.) embodiment | : (rzecz.) epitome | : (rzecz.) impersonation
ucielesnic : ucieleśnić : (czas.) incorporate | : (czas.) materialize
uciemiezac : uciemiężać : (czas.) burden | : (czas.) burthen | : (czas.) oppress
ucieraczka : ucieraczka : (rzecz.) snuffer
ucieranie : ucieranie : (rzecz.) grating
ucierac : ucierać : (czas.) mix | : (czas.) pound
ucierpiec : ucierpieć : (czas.) suffered
ucieszny : ucieszny : (przym.) droll | : (przym.) funny
ucieszyc : ucieszyć : (czas.) cheer | : (czas.) gratify
ucinanie : ucinanie : (rzecz.) cut | : (rzecz.) cutting
ucinac : ucinać : (czas.) cut | : (czas.) decapitate | : (czas.) nip
ucisk : ucisk : (rzecz.) constriction | : (rzecz.) embrace | : (rzecz.) oppression | : (rzecz.) oppressiveness | : (rzecz.) pinch | : (rzecz.) pressure | : (rzecz.) repression
uciskajacy : uciskający : (przym.) oppressive
uciskanie : uciskanie : (rzecz.) constriction | : (rzecz.) pressing
uciskac : uciskać : (czas.) constrict | : (czas.) oppress | : (czas.) press | : (czas.) quell | : (czas.) repress | : (czas.) screw
uciszac : uciszać : (czas.) calm | : (czas.) hush | : (czas.) quieten | : (czas.) silence | : (czas.) silenced | : (czas.) subside
uciszenie : uciszenie : (rzecz.) appeasement | : (rzecz.) silence
uciszyc : uciszyć : (czas.) allay | : (czas.) appease | : (czas.) calm | : (czas.) hush | : (czas.) silence
uciulac : uciułać : (czas.) save
uciac : uciąć : (czas.) curtail | : (czas.) cut
uciazliwosc : uciążliwość : (rzecz.) arduousness
uciazliwy : uciążliwy : (przym.) acute | : (przym.) awkward | : (przym.) burdensome | : (przym.) cumbersome | : (przym.) inconvenient | : (przym.) onerous | : (przym.) oppressive | : (przym.) troublesome | : (przym.) uphill
ucywilizowanie : ucywilizowanie : (rzecz.) domestication
ucywilizowac : ucywilizować : (czas.) civilize
uczciwie : uczciwie : (przysł.) fair | : (przysł.) fairly | : (przysł.) honestly | : (przysł.) uprightly
uczciwosc : uczciwość : (rzecz.) candour | : (rzecz.) earnestness | : (rzecz.) honesty | : (rzecz.) integrity | : (rzecz.) rectitude
uczciwy : uczciwy : (przym.) aboveboard | : (przym.) clean-handed | : (przym.) fair | : (przym.) faithful | : (przym.) honest | : (przym.) honourable | : (przym.) outright | : (przym.) round | : (przym.) straight | : (przym.) upright
uczcic : uczcić : (czas.) celebrate | : (czas.) commemorate | : (czas.) dignify
uczczenie : uczczenie : (rzecz.) celebration
uczelnia : uczelnia : (rzecz.) academy | : (rzecz.) college | : (rzecz.) school | : (rzecz.) university
uczenie : uczenie : (przysł.) learnedly
uczennica : uczennica : (rzecz.) scholar | : (rzecz.) schoolgirl
uczep : uczep : (rzecz.) hitch
uczepic : uczepić : (czas.) hitch
uczesanie : uczesanie : (rzecz.) dressing | : (rzecz.) hairdo | : (rzecz.) hair-do | : (rzecz.) hairstyle
uczesac : uczesać : (czas.) comb
uczestnictwo : uczestnictwo : (rzecz.) entry | : (rzecz.) participation
uczestniczyc : uczestniczyć : (czas.) enter | : (czas.) part | : (czas.) partake | : (czas.) participate | : (czas.) partook | : (czas.) share
uczestnik : uczestnik : (rzecz.) attendee | : (rzecz.) competitor | : (rzecz.) contender | : (rzecz.) contestant | : (rzecz.) partaker | : (rzecz.) participant | : (rzecz.) participator | : (rzecz.) partner | : (rzecz.) party
uczen : uczeń : (rzecz.) apprentice | : (rzecz.) disciple | : (rzecz.) learner | : (rzecz.) pupil | : (rzecz.) scholar | : (rzecz.) schoolboy | : (rzecz.) schoolchild | : (rzecz.) student
uczniak : uczniak : (rzecz.) schoolboy
uczonosc : uczoność : (rzecz.) learning | : (rzecz.) scholarship
uczta : uczta : (rzecz.) banquet | : (rzecz.) feast | : (rzecz.) regale | : (rzecz.) revel | : (rzecz.) revelry | : (rzecz.) treat | : (rzecz.) wassail
ucztowanie : ucztowanie : (rzecz.) revelry
ucztowac : ucztować : (czas.) banquet | : (czas.) feast | : (czas.) quaff | : (czas.) revel
uczucie : uczucie : (rzecz.) affection | : (rzecz.) emotion | : (rzecz.) feeling | : (rzecz.) guilt | : (rzecz.) sensation | : (rzecz.) sense | : (rzecz.) sentiment
uczuciowo : uczuciowo : (przysł.) emotionally
uczuciowosc : uczuciowość : (rzecz.) emotionality | : (rzecz.) sensibility
uczuciowy : uczuciowy : (przym.) affectionate | : (przym.) emotional | : (przym.) emotive | : (przym.) intense | : (przym.) sensible | : (przym.) sensitive | : (przym.) sensual | : (przym.) sentimental
uczulacz : uczulacz : (rzecz.) sensitizer
uczulac : uczulać : (czas.) sensitize
uczulenie : uczulenie : (rzecz.) allergy | : (rzecz.) idiosyncrasy | : (rzecz.) sensitization
uczuleniowy : uczuleniowy : (przym.) allergic | : (przym.) idiosyncratic
uczulic : uczulić : (czas.) sensitize
uczulony : uczulony : (przym.) allergic
uczynek : uczynek : (rzecz.) act | : (rzecz.) deed
uczynic : uczynić : (czas.) done | : (czas.) make
uczynnie : uczynnie : (przysł.) helpfully | : (przysł.) obligingly
uczynnosc : uczynność : (rzecz.) helpfulness | : (rzecz.) kindness
uczynny : uczynny : (przym.) cooperative | : (przym.) co-operative | : (przym.) helpful | : (przym.) obliging
uczyc : uczyć : (czas.) educe | : (czas.) instruct | : (czas.) learn | : (czas.) school | : (czas.) study | : (czas.) taught | : (czas.) teach | : (czas.) train | : (czas.) undeceive
uczeszczanie : uczęszczanie : (rzecz.) attendance
uczeszczac : uczęszczać : (czas.) attend | : (czas.) frequent | : (czas.) resort
uczlowieczac : uczłowieczać : (czas.) ennoble | : (czas.) humanize
udany : udany : (przym.) successful
udar : udar : (rzecz.) apoplexy | : (rzecz.) ictus | : (rzecz.) inrush | : (rzecz.) stroke | : (rzecz.) surge
udaremniac : udaremniać : (czas.) baffle | : (czas.) balk | : (czas.) blight | : (czas.) confute | : (czas.) countermine | : (czas.) discomfit | : (czas.) foil | : (czas.) frustrate | : (czas.) pre-empt | : (czas.) scotch | : (czas.) stultify | : (czas.) thwart
udaremnienie : udaremnienie : (rzecz.) frustration
udaremnic : udaremnić : (czas.) balk | : (czas.) countermine | : (czas.) discomfit | : (czas.) foil | : (czas.) frustrate | : (czas.) stultify
udarowy : udarowy : (przym.) percussive
udatnosc : udatność : (rzecz.) adroitness | : (rzecz.) deftness
udatny : udatny : (przym.) deft | : (przym.) fine | : (przym.) good
udawanie : udawanie : (rzecz.) affectation | : (rzecz.) assumption | : (rzecz.) dissimulation | : (rzecz.) falseness | : (rzecz.) feint | : (rzecz.) game | : (rzecz.) pretence | : (rzecz.) pretender | : (rzecz.) sham | : (rzecz.) simulation
udawac : udawać : (czas.) affect | : (czas.) assume | : (czas.) betake | : (czas.) dissemble | : (czas.) dissimulate | : (czas.) feign | : (czas.) go | : (czas.) imitate | : (czas.) playact | : (czas.) play-act | : (czas.) pose | : (czas.) pretend | : (czas.) repair | : (czas.) sham | : (czas.) simulate | : (czas.) thrive
udekorowac : udekorować : (czas.) decorate
udeptac : udeptać : (czas.) tread
udeptywac : udeptywać : (czas.) tread
uderzajaco : uderzająco : (przysł.) strikingly
uderzajacy : uderzający : (przym.) striking
uderzak : uderzak : (rzecz.) go-devil
uderzanie : uderzanie : (rzecz.) percussion
uderzac : uderzać : (czas.) bang | : (czas.) beat | : (czas.) box | : (czas.) bump | : (czas.) butt | : (czas.) hammer | : (czas.) hit | : (czas.) hurtle | : (czas.) impinge | : (czas.) knock | : (czas.) pluck | : (czas.) poke | : (czas.) slap | : (czas.) smite | : (czas.) strike
uderzenie : uderzenie : (rzecz.) backhand | : (rzecz.) bang | : (rzecz.) beat | : (rzecz.) blow | : (rzecz.) box | : (rzecz.) buffet | : (rzecz.) bump | : (rzecz.) flap | : (rzecz.) flapping | : (rzecz.) heartbeat | : (rzecz.) hit | : (rzecz.) impact | : (rzecz.) impingement | : (rzecz.) inrush | : (rzecz.) knock | : (rzecz.) percussion | : (rzecz.) ping | : (rzecz.) punch | : (rzecz.) putt | : (rzecz.) shot | : (rzecz.) slap | : (rzecz.) smash | : (rzecz.) strike | : (rzecz.) stroke | : (rzecz.) swipe | : (rzecz.) swoop | : (rzecz.) thump
uderzeniowy : uderzeniowy : (przym.) percussive | : (przym.) striking
uderzyc : uderzyć : (czas.) bash | : (czas.) bump | : (czas.) clobber | : (czas.) hit | : (czas.) hurtle | : (czas.) knock | : (czas.) punch | : (czas.) slap | : (czas.) slog | : (czas.) smack | : (czas.) smash | : (czas.) smite | : (czas.) snap | : (czas.) strike | : (czas.) swat | : (czas.) tomahawk | : (czas.) wipe
udo : udo : (rzecz.) thigh
udobruchanie : udobruchanie : (rzecz.) appeasement | : (rzecz.) conciliation
udobruchac : udobruchać : (czas.) coax
udogodnienie : udogodnienie : (rzecz.) convenience | : (rzecz.) ease | : (rzecz.) easement | : (rzecz.) facility
udogodnic : udogodnić : (czas.) facilitate
udokumentowany : udokumentowany : (przym.) documentaries
udokumentowac : udokumentować : (czas.) documented
udomawiac : udomawiać : (czas.) domesticate
udomowic : udomowić : (czas.) domesticate
udoskonalac : udoskonalać : (czas.) advance | : (czas.) ameliorate | : (czas.) improve | : (czas.) improved | : (czas.) upgrade
udoskonalenie : udoskonalenie : (rzecz.) amelioration | : (rzecz.) enrichment | : (rzecz.) improvement | : (rzecz.) perfection
udoskonalic : udoskonalić : (czas.) ameliorate | : (czas.) improve | : (czas.) upgrade
udostepniac : udostępniać : (czas.) expose | : (czas.) facilitate | : (czas.) share | : (czas.) support
udostepnienie : udostępnienie : (rzecz.) provision | : (rzecz.) release
udostepnic : udostępnić : (czas.) facilitate | : (czas.) share
udowadniac : udowadniać : (czas.) argue | : (czas.) convict | : (czas.) demonstrate | : (czas.) prove | : (czas.) proven
udowodnienie : udowodnienie : (rzecz.) manifestation | : (rzecz.) proof | : (rzecz.) substantiation
udowodnic : udowodnić : (czas.) convict | : (czas.) prove | : (czas.) substantiate
udowy : udowy : (przym.) femoral
udramatyzowac : udramatyzować : (czas.) dramatize
udrapowac : udrapować : (czas.) drape
udreczac : udręczać : (czas.) distress
udreczenie : udręczenie : (rzecz.) anguish | : (rzecz.) torment
udreczyc : udręczyć : (czas.) torment
udreka : udręka : (rzecz.) agony | : (rzecz.) anguish | : (rzecz.) distress | : (rzecz.) incubus | : (rzecz.) suffering | : (rzecz.) torment | : (rzecz.) vexation
uduchowienie : uduchowienie : (rzecz.) soulfulness | : (rzecz.) spiritualization
uduchowic : uduchowić : (czas.) spiritualize
udusic : udusić : (czas.) asphyxiate | : (czas.) quash | : (czas.) stew | : (czas.) stifle | : (czas.) strangle | : (czas.) suffocate | : (czas.) throttle
uduszenie : uduszenie : (rzecz.) asphyxia | : (rzecz.) asphyxiation | : (rzecz.) strangulation | : (rzecz.) suffocation
udzial : udział : (rzecz.) appearance | : (rzecz.) contribution | : (rzecz.) hand | : (rzecz.) input | : (rzecz.) interest | : (rzecz.) lot | : (rzecz.) part | : (rzecz.) participation | : (rzecz.) quota | : (rzecz.) rake-off | : (rzecz.) share | : (rzecz.) snack | : (rzecz.) stake
udzialowiec : udziałowiec : (rzecz.) contributor | : (rzecz.) partner | : (rzecz.) shareholder | : (rzecz.) sharer | : (rzecz.) stakeholder | : (rzecz.) stockholder
udzialowy : udziałowy : (przym.) joint
udziec : udziec : (rzecz.) cutlet | : (rzecz.) haunch | : (rzecz.) hind | : (rzecz.) leg | : (rzecz.) round
udzielac : udzielać : (czas.) accord | : (czas.) allot | : (czas.) dispense | : (czas.) grant | : (czas.) impart | : (czas.) lecture | : (czas.) lend | : (czas.) socialize | : (czas.) vest | : (czas.) vouchsafe
udzielenie : udzielenie : (rzecz.) grant | : (rzecz.) impartment
udzielic : udzielić : (czas.) accord | : (czas.) grant | : (czas.) lecture | : (czas.) vest | : (czas.) vouchsafe
udzielny : udzielny : (przym.) sovereign
udoj : udój : (rzecz.) dairy
udlawic : udławić : (czas.) choke
udzwig : udźwig : (rzecz.) capacity
udzwieczniac : udźwięczniać : (czas.) voiced
udzwiekowienie : udźwiękowienie : (rzecz.) sound
ufac : ufać : (czas.) confide | : (czas.) credit | : (czas.) trust
ufetowac : ufetować : (czas.) fete
ufnie : ufnie : (przysł.) confidentially | : (przysł.) confidently | : (przysł.) trustfully | : (przysł.) trustingly
ufnosc : ufność : (rzecz.) affiance | : (rzecz.) confidence | : (rzecz.) faith | : (rzecz.) trust | : (rzecz.) trustfulness
ufny : ufny : (przym.) bold | : (przym.) confident | : (przym.) reliant | : (przym.) sanguine | : (przym.) trustful
uformowac : uformować : (czas.) form
ufortyfikowac : ufortyfikować : (czas.) fortify
ufryzowanie : ufryzowanie : (rzecz.) coiffure | : (rzecz.) headdress | : (rzecz.) head-dress
ufryzowac : ufryzować : (czas.) curl
ufundowanie : ufundowanie : (rzecz.) foundation
ufundowac : ufundować : (czas.) found
uganiac : uganiać : (czas.) seek
ugarnirowac : ugarnirować : (czas.) trim
ugasic : ugasić : (czas.) extinguish | : (czas.) quench | : (czas.) quenched
ugaszac : ugaszać : (czas.) extinguish | : (czas.) quench
ugaszczac : ugaszczać : (czas.) entertain
ugaszenie : ugaszenie : (rzecz.) extinction
ugier : ugier : (rzecz.) ochre
uginanie : uginanie : (rzecz.) bending | : (rzecz.) cambering | : (rzecz.) deflection | : (rzecz.) diffraction
uginac : uginać : (czas.) bend | : (czas.) sag
ugiac : ugiąć : (czas.) bow
ugiecie : ugięcie : (rzecz.) deflection
ugniatacz : ugniatacz : (rzecz.) kneader
ugniatanie : ugniatanie : (rzecz.) crushing | : (rzecz.) kneading | : (rzecz.) pressure
ugniatarka : ugniatarka : (rzecz.) kneader
ugniatac : ugniatać : (czas.) knead | : (czas.) pinch | : (czas.) screw
ugoda : ugoda : (rzecz.) accommodation | : (rzecz.) agreement | : (rzecz.) compromise | : (rzecz.) conciliation | : (rzecz.) concord
ugodowosc : ugodowość : (rzecz.) amicability
ugodowy : ugodowy : (przym.) amicable | : (przym.) conciliatory | : (przym.) consensual
ugorowy : ugorowy : (przym.) fallow
ugoszczenie : ugoszczenie : (rzecz.) entertainment
ugotowac : ugotować : (czas.) cook
ugoscic : ugościć : (czas.) seat
ugruntowac : ugruntować : (czas.) base
ugruntowywac : ugruntowywać : (czas.) enhance
ugrupowanie : ugrupowanie : (rzecz.) formation | : (rzecz.) group
ugrupowac : ugrupować : (czas.) arrange
ugryzienie : ugryzienie : (rzecz.) bite
ugryzc : ugryźć : (czas.) bite | : (czas.) snap
ugrzeczniony : ugrzeczniony : (przym.) urbane
ugrzeznac : ugrzęznąć : (czas.) stall
ugor : ugór : (rzecz.) fallow
uglaskac : ugłaskać : (czas.) coax | : (czas.) tame
uiszczac : uiszczać : (czas.) acquit | : (czas.) pay
uiszczenie : uiszczenie : (rzecz.) payment
uiscic : uiścić : (czas.) pay
ujadanie : ujadanie : (rzecz.) bay | : (rzecz.) bicker | : (rzecz.) gulf | : (rzecz.) yap
ujadac : ujadać : (czas.) bay | : (czas.) yap | : (czas.) yip
ujarzmiac : ujarzmiać : (czas.) enchain | : (czas.) enslave | : (czas.) subdue | : (czas.) subjugate | : (czas.) yoke
ujarzmienie : ujarzmienie : (rzecz.) enslavement | : (rzecz.) subjection | : (rzecz.) subjugation
ujarzmic : ujarzmić : (czas.) enslave | : (czas.) harnessed | : (czas.) subdue | : (czas.) subjugate | : (czas.) yoke
ujawnianie : ujawnianie : (rzecz.) disclosure | : (rzecz.) exposure
ujawniac : ujawniać : (czas.) betray | : (czas.) declassify | : (czas.) disclose | : (czas.) display | : (czas.) elicit | : (czas.) emerge | : (czas.) evince | : (czas.) expose | : (czas.) leak | : (czas.) reveal | : (czas.) share | : (czas.) support | : (czas.) trickle | : (czas.) unfold | : (czas.) unmask
ujawnienie : ujawnienie : (rzecz.) betrayal | : (rzecz.) disclosure | : (rzecz.) discovery | : (rzecz.) exposure
ujawnic : ujawnić : (czas.) declassify | : (czas.) disclose | : (czas.) display | : (czas.) expose | : (czas.) reveal | : (czas.) trickle
ujechac : ujechać : (czas.) travel
ujednolicac : ujednolicać : (czas.) harmonize | : (czas.) make | : (czas.) standardise | : (czas.) standardize | : (czas.) unify
ujednolicenie : ujednolicenie : (rzecz.) unification
ujednolicic : ujednolicić : (czas.) align | : (czas.) make
ujednorodnianie : ujednorodnianie : (rzecz.) homogenizing
ujednorodnienie : ujednorodnienie : (rzecz.) homogenisation
ujednostajnianie : ujednostajnianie : (rzecz.) regulation
ujednostajnienie : ujednostajnienie : (rzecz.) regulation
ujednoznaczniac : ujednoznaczniać : (czas.) disambiguate | : (czas.) disambiguated | : (czas.) disambiguates | : (czas.) disambiguating
ujednoznacznienie : ujednoznacznienie : (rzecz.) disambiguate | : (rzecz.) disambiguation
ujemnie : ujemnie : (przysł.) negatively
ujemny : ujemny : (przym.) deleterious | : (przym.) dyslogistic | : (przym.) harmful | : (przym.) negative
ujezdzic : ujeździć : (czas.) break
ujezdzacz : ujeżdżacz : (rzecz.) horse-breaker | : (rzecz.) roughrider | : (rzecz.) trainer
ujma : ujma : (rzecz.) detriment | : (rzecz.) disparagement | : (rzecz.) outrage | : (rzecz.) prejudice
ujmowanie : ujmowanie : (rzecz.) capturing | : (rzecz.) recognition
ujmowac : ujmować : (czas.) account | : (czas.) detract | : (czas.) plead | : (czas.) take
ujmujaco : ujmująco : (przysł.) engagingly | : (przysł.) insinuatingly
ujmujacy : ujmujący : (przym.) captivating | : (przym.) pleasing
ujrzec : ujrzeć : (czas.) beheld | : (czas.) behold | : (czas.) descry | : (czas.) glimpse | : (czas.) see
ujac : ująć : (czas.) captivate | : (czas.) formulate | : (czas.) grip | : (czas.) include | : (czas.) seize
ujecie : ujęcie : (rzecz.) conceptualization | : (rzecz.) expression | : (rzecz.) grasp | : (rzecz.) shot | : (rzecz.) snap
ujscie : ujście : (rzecz.) entrance | : (rzecz.) estuary | : (rzecz.) influx | : (rzecz.) mouth | : (rzecz.) orifice | : (rzecz.) outfall | : (rzecz.) outlet | : (rzecz.) vent
ukajac : ukajać : (czas.) appease | : (czas.) soothe
ukamienowac : ukamienować : (czas.) lapidate | : (czas.) stone
ukaranie : ukaranie : (rzecz.) infliction | : (rzecz.) punishment
ukarac : ukarać : (czas.) chasten | : (czas.) chastise | : (czas.) punish
ukartowac : ukartować : (czas.) contrive | : (czas.) plot
ukaz : ukaz : (rzecz.) ukase
ukazanie : ukazanie : (rzecz.) apparition | : (rzecz.) appearance | : (rzecz.) exhibition | : (rzecz.) manifestation | : (rzecz.) show
ukazac : ukazać : (czas.) appear | : (czas.) arise | : (czas.) show
ukazywac : ukazywać : (czas.) appear | : (czas.) reappear | : (czas.) show
ukierunkowac : ukierunkować : (czas.) canalize
ukierunkowywanie : ukierunkowywanie : (rzecz.) orientation | : (rzecz.) steering
ukleknac : uklęknąć : (czas.) genuflect | : (czas.) kneel
uknuc : uknuć : (czas.) frame
ukochana : ukochana : (rzecz.) sweetheart
ukoic : ukoić : (czas.) appease | : (czas.) soothe
ukojenie : ukojenie : (rzecz.) alleviation | : (rzecz.) comfort | : (rzecz.) consolation | : (rzecz.) relief | : (rzecz.) solace
ukonstytuowac : ukonstytuować : (czas.) constitute
ukop : ukop : (rzecz.) diggings
ukoronowac : ukoronować : (czas.) crown
ukorzeniac : ukorzeniać : (czas.) root
ukorzenie : ukorzenie : (rzecz.) abasement
ukos : ukos : (rzecz.) betel | : (rzecz.) bevel | : (rzecz.) bias | : (rzecz.) incline | : (rzecz.) scarf | : (rzecz.) slant
ukosowanie : ukosowanie : (rzecz.) bevelling
ukolysac : ukołysać : (czas.) lull
ukonczenie : ukończenie : (rzecz.) completion | : (rzecz.) gradation
ukonczyc : ukończyć : (czas.) complete
ukosnie : ukośnie : (przysł.) agley | : (przysł.) askance | : (przysł.) aslant | : (przysł.) atilt | : (przysł.) diagonally | : (przysł.) obliquely
ukosnik : ukośnik : (rzecz.) rhomb | : (rzecz.) slash
ukosnosc : ukośność : (rzecz.) obliquity
ukosny : ukośny : (przym.) atilt | : (przym.) diagonal | : (przym.) oblique | : (przym.) skew
ukracac : ukracać : (czas.) curb
ukradkiem : ukradkiem : (przysł.) furtively | : (przysł.) stealthily | : (przysł.) surreptitiously
ukradkowo : ukradkowo : (przysł.) furtively | : (przysł.) stealthily
ukradkowy : ukradkowy : (przym.) covert | : (przym.) furtive | : (przym.) sidelong | : (przym.) slinky | : (przym.) sneaky | : (przym.) stealthy | : (przym.) surreptitious
ukrasc : ukraść : (czas.) filch | : (czas.) pinch | : (czas.) purloin | : (czas.) snaffle | : (czas.) snoop | : (czas.) steal | : (czas.) thieve
ukruszyc : ukruszyć : (czas.) crumble
ukrycie : ukrycie : (rzecz.) concealment | : (rzecz.) hide | : (rzecz.) hiding-place | : (rzecz.) stealth
ukryty : ukryty : (przym.) implicit | : (przym.) latent | : (przym.) underlying
ukrywanie : ukrywanie : (rzecz.) concealment | : (rzecz.) cover-up | : (rzecz.) hide | : (rzecz.) hiding | : (rzecz.) shelter
ukrywac : ukrywać : (czas.) calfskin | : (czas.) conceal | : (czas.) dissemble | : (czas.) dissimulate | : (czas.) hid | : (czas.) hidden | : (czas.) hide | : (czas.) hoodwink | : (czas.) mask | : (czas.) obscure | : (czas.) secrete | : (czas.) shroud | : (czas.) skulk | : (czas.) suppress
ukryc : ukryć : (czas.) blind | : (czas.) cloak | : (czas.) conceal | : (czas.) ensconce | : (czas.) hide
ukrzyzowanie : ukrzyżowanie : (rzecz.) crucifixion
ukrzyzowac : ukrzyżować : (czas.) crucify
ukrocenie : ukrócenie : (rzecz.) suppression
ukrocic : ukrócić : (czas.) suppress
ukrecic : ukręcić : (czas.) tear | : (czas.) wring
uksztaltowanie : ukształtowanie : (rzecz.) configuration | : (rzecz.) shape
uksztaltowac : ukształtować : (czas.) formalize | : (czas.) shape
ukuc : ukuć : (czas.) coin
ukasic : ukąsić : (czas.) bite | : (czas.) snap | : (czas.) sting
ukaszenie : ukąszenie : (rzecz.) bite | : (rzecz.) sting
uklad : układ : (rzecz.) agreement | : (rzecz.) arrangement | : (rzecz.) array | : (rzecz.) circuit | : (rzecz.) complex | : (rzecz.) configuration | : (rzecz.) layout | : (rzecz.) lay-out | : (rzecz.) makeup | : (rzecz.) make-up | : (rzecz.) network | : (rzecz.) ordination | : (rzecz.) pact | : (rzecz.) scheme | : (rzecz.) selling | : (rzecz.) setting | : (rzecz.) setup | : (rzecz.) stipulation | : (rzecz.) system
ukladacz : układacz : (rzecz.) layer
ukladanie : układanie : (rzecz.) alignment | : (rzecz.) conditioning | : (rzecz.) formation | : (rzecz.) stagger | : (rzecz.) tiling
ukladanka : układanka : (rzecz.) jigsaw | : (rzecz.) puzzle
ukladac : układać : (czas.) arrange | : (czas.) cast | : (czas.) clump | : (czas.) collocate | : (czas.) compose | : (czas.) file | : (czas.) lay | : (czas.) stipulate | : (czas.) transact
ukladny : układny : (przym.) courteous | : (przym.) polite | : (przym.) sleek | : (przym.) smooth-faced | : (przym.) suave | : (przym.) urbane
ukladowy : układowy : (przym.) hard-wired | : (przym.) systemic | : (przym.) wired-in
uklon : ukłon : (rzecz.) bow | : (rzecz.) compliment | : (rzecz.) curtsey | : (rzecz.) curtsy | : (rzecz.) dipping | : (rzecz.) nod | : (rzecz.) obeisance | : (rzecz.) regard | : (rzecz.) salute
uklonic : ukłonić : (czas.) bow | : (czas.) nod
uklucie : ukłucie : (rzecz.) prick | : (rzecz.) sting
ukluc : ukłuć : (czas.) jab | : (czas.) pique | : (czas.) prick | : (czas.) stab | : (czas.) sting
ul : ul : (rzecz.) beehive | : (rzecz.) hive
ulatac : ulatać : (czas.) soar
ulatnianie : ulatnianie : (rzecz.) evaporation | : (rzecz.) leakage
ulatniac : ulatniać : (czas.) evaporate | : (czas.) leak | : (czas.) melt | : (czas.) volatilize
ulatywac : ulatywać : (czas.) escape
ulac : ulać : (czas.) cast | : (czas.) mould
uleczalnosc : uleczalność : (rzecz.) curability
uleczalny : uleczalny : (przym.) curable | : (przym.) remediable | : (przym.) treatable
uleczyc : uleczyć : (czas.) heal
uleganie : uleganie : (rzecz.) compliance | : (rzecz.) deference
ulegac : ulegać : (czas.) defer | : (czas.) subject | : (czas.) succumb | : (czas.) undergo | : (czas.) yield
uleglosc : uległość : (rzecz.) deference | : (rzecz.) docility | : (rzecz.) submersion | : (rzecz.) submission | : (rzecz.) submissiveness | : (rzecz.) subordination | : (rzecz.) tameness
ulegly : uległy : (przym.) obsequious | : (przym.) submissive | : (przym.) tame
ulepek : ulepek : (rzecz.) julep | : (rzecz.) syrup
ulepszanie : ulepszanie : (rzecz.) better | : (rzecz.) improvement
ulepszac : ulepszać : (czas.) ameliorate | : (czas.) amend | : (czas.) enhance | : (czas.) improve | : (czas.) meliorate | : (czas.) revamped | : (czas.) upgrade
ulepszenie : ulepszenie : (rzecz.) amelioration | : (rzecz.) enhancement | : (rzecz.) improvement | : (rzecz.) melioration
ulepszyc : ulepszyć : (czas.) ameliorate | : (czas.) enrich | : (czas.) improved | : (czas.) streamline
ulewa : ulewa : (rzecz.) downpour | : (rzecz.) gush | : (rzecz.) rain | : (rzecz.) rainstorm | : (rzecz.) shower | : (rzecz.) storm | : (rzecz.) torrent
ulewny : ulewny : (przym.) pouring | : (przym.) rainy | : (przym.) showery | : (przym.) torrential
ulga : ulga : (rzecz.) abatement | : (rzecz.) alleviation | : (rzecz.) allowance | : (rzecz.) comfort | : (rzecz.) relief | : (rzecz.) remission | : (rzecz.) respite | : (rzecz.) solace
ulgowo : ulgowo : (przysł.) indulgently
ulgowy : ulgowy : (przym.) cheap | : (przym.) concessionary | : (przym.) reduced
ulica : ulica : (rzecz.) alley | : (rzecz.) avenue | : (rzecz.) boulevard | : (rzecz.) crescent | : (rzecz.) road | : (rzecz.) street | : (rzecz.) thoroughfare
uliczka : uliczka : (rzecz.) alley | : (rzecz.) avenue | : (rzecz.) backstreet | : (rzecz.) bystreet | : (rzecz.) lane | : (rzecz.) mew
ulicznik : ulicznik : (rzecz.) gamin | : (rzecz.) guttersnipe | : (rzecz.) nipper | : (rzecz.) urchin
ulistnienie : ulistnienie : (rzecz.) foliage | : (rzecz.) leafage
ulokowac : ulokować : (czas.) accommodate | : (czas.) house | : (czas.) place
ulot : ulot : (rzecz.) corona
ulotka : ulotka : (rzecz.) airman | : (rzecz.) bill | : (rzecz.) flier | : (rzecz.) flyer | : (rzecz.) flysheet | : (rzecz.) folder | : (rzecz.) handbill | : (rzecz.) hand-bill | : (rzecz.) handout | : (rzecz.) leaflet | : (rzecz.) pamphlet
ulotnosc : ulotność : (rzecz.) elusiveness | : (rzecz.) fleetness | : (rzecz.) volatility
ulotny : ulotny : (przym.) elusive | : (przym.) faint | : (przym.) transient | : (przym.) volatile
ultimatum : ultimatum : (rzecz.) ultimatum
ultradzwiek : ultradźwięk : (rzecz.) ultrasound
ultradzwiekowy : ultradźwiękowy : (przym.) supersonic | : (przym.) ultrasonic
ultrafiolet : ultrafiolet : (rzecz.) ultraviolet
ultrafioletowy : ultrafioletowy : (przym.) ultra-violet
ultrakonserwatywny : ultrakonserwatywny : (przym.) ultraconservative
ultramaryna : ultramaryna : (rzecz.) blue
ultramikroskopowy : ultramikroskopowy : (przym.) ultramicroscopic
ultranowoczesny : ultranowoczesny : (przym.) ultramodern
ultrasonograf : ultrasonograf : (rzecz.) ultrasound
ultrasonografia : ultrasonografia : (rzecz.) ultrasound
ultrawirowka : ultrawirówka : (rzecz.) ultracentrifuge
ulubieniec : ulubieniec : (rzecz.) darling | : (rzecz.) favourite | : (rzecz.) minion | : (rzecz.) pet
ulubiony : ulubiony : (przym.) favourite
ulegac : ulęgać : (czas.) subject
ulzyc : ulżyć : (czas.) alleviate | : (czas.) lighten | : (czas.) relieve | : (czas.) relive | : (czas.) unburden
umacniac : umacniać : (czas.) cement | : (czas.) confirm | : (czas.) fortify | : (czas.) harden | : (czas.) reinforce | : (czas.) strengthen | : (czas.) strengthened
umalowac : umalować : (czas.) paint
umartwianie : umartwianie : (rzecz.) mortification
umartwiac : umartwiać : (czas.) mortify
umartwienie : umartwienie : (rzecz.) mortification
umarzalny : umarzalny : (przym.) redeemable
umarzac : umarzać : (czas.) amortise | : (czas.) redeem
umawiac : umawiać : (czas.) appoint | : (czas.) arrange | : (czas.) bargain | : (czas.) treat
umazac : umazać : (czas.) smear
umeblowanie : umeblowanie : (rzecz.) furnishings | : (rzecz.) furniture
umeblowany : umeblowany : (przym.) furnished
umeblowac : umeblować : (czas.) fit
umiar : umiar : (rzecz.) moderation | : (rzecz.) temperance
umiarkowanie : umiarkowanie : (przysł.) moderately | : (przysł.) temperately
umiarkowany : umiarkowany : (przym.) moderate | : (przym.) reasonable | : (przym.) temperate
umiejscawiac : umiejscawiać : (czas.) localize | : (czas.) locate | : (czas.) occur | : (czas.) situate
umiejscowienie : umiejscowienie : (rzecz.) localization | : (rzecz.) location | : (rzecz.) locus | : (rzecz.) position | : (rzecz.) putting
umiejscowic : umiejscowić : (czas.) localize | : (czas.) locate | : (czas.) occur | : (czas.) place | : (czas.) situate
umiejetnie : umiejętnie : (przysł.) ably | : (przysł.) competently
umiejetnosci : umiejętności : (rzecz.) incompetence
umiejetnosc : umiejętność : (rzecz.) ability | : (rzecz.) art | : (rzecz.) capability | : (rzecz.) expertise | : (rzecz.) know-how | : (rzecz.) literacy | : (rzecz.) prowess | : (rzecz.) skill | : (rzecz.) technique
umiejetny : umiejętny : (przym.) able | : (przym.) expert | : (przym.) scientific | : (przym.) skilful
umieralnosc : umieralność : (rzecz.) mortality
umieranie : umieranie : (rzecz.) dying
umierac : umierać : (czas.) decease | : (czas.) die | : (czas.) expire
umieszczanie : umieszczanie : (rzecz.) placement | : (rzecz.) placing
umieszczac : umieszczać : (czas.) adapt | : (czas.) deputize | : (czas.) install | : (czas.) locate | : (czas.) lodge | : (czas.) place | : (czas.) plant | : (czas.) put | : (czas.) putt | : (czas.) set | : (czas.) situate | : (czas.) stow
umieszczenie : umieszczenie : (rzecz.) accommodation | : (rzecz.) affixation | : (rzecz.) allocation | : (rzecz.) location | : (rzecz.) placement
umieszczony : umieszczony : (przym.) situated
umiec : umieć : (czas.) can | : (czas.) know
umiescic : umieścić : (czas.) deputize | : (czas.) house | : (czas.) locate | : (czas.) lodge | : (czas.) place | : (czas.) put | : (czas.) putt | : (czas.) set | : (czas.) situate | : (czas.) stow
umiesc : umieść : (czas.) place
umilic : umilić : (czas.) make
umizgac : umizgać : (czas.) spoon
umiedzynarodowienie : umiędzynarodowienie : (rzecz.) internationalization
umiedzynarodowic : umiędzynarodowić : (czas.) internationalize
umiesnienie : umięśnienie : (rzecz.) musculature
umilowanie : umiłowanie : (rzecz.) love
umilowac : umiłować : (czas.) cherish
umniejszanie : umniejszanie : (rzecz.) detraction
umniejszac : umniejszać : (czas.) belittle | : (czas.) derogate | : (czas.) detract | : (czas.) extenuate | : (czas.) lessen | : (czas.) underplay | : (czas.) understate
umniejszyc : umniejszyć : (czas.) undermine
umocnienia : umocnienia : (rzecz.) defences
umocnienie : umocnienie : (rzecz.) confirmation | : (rzecz.) consolidation | : (rzecz.) fortification | : (rzecz.) overwork
umocnic : umocnić : (czas.) harden | : (czas.) reinforce | : (czas.) strengthen
umocowanie : umocowanie : (rzecz.) clamp | : (rzecz.) empowerment
umocowac : umocować : (czas.) anchor | : (czas.) attach | : (czas.) fasten | : (czas.) hitch | : (czas.) secure
umocowywac : umocowywać : (czas.) hitch | : (czas.) moor
umoczyc : umoczyć : (czas.) dip | : (czas.) soak
umodelowac : umodelować : (czas.) mould
umoralnianie : umoralnianie : (rzecz.) elevation
umoralniac : umoralniać : (czas.) elevate | : (czas.) moralize
umorusac : umorusać : (czas.) soil
umorzenie : umorzenie : (rzecz.) discontinuance | : (rzecz.) remission
umorzyc : umorzyć : (czas.) closed | : (czas.) remit
umotywowac : umotywować : (czas.) justify | : (czas.) unmotivated
umowa : umowa : (rzecz.) agreement | : (rzecz.) arrangement | : (rzecz.) bargain | : (rzecz.) bargaining | : (rzecz.) bet | : (rzecz.) contract | : (rzecz.) convention | : (rzecz.) covenant | : (rzecz.) engagement | : (rzecz.) indenture | : (rzecz.) pact | : (rzecz.) settlement | : (rzecz.) treaty
umownie : umownie : (przysł.) conventionally
umownosc : umowność : (rzecz.) conventionality
umowny : umowny : (przym.) arbitrary | : (przym.) collusive | : (przym.) conventional
umozliwiac : umożliwiać : (czas.) enable | : (czas.) facilitate | : (czas.) let
umozliwienie : umożliwienie : (rzecz.) capacitance
umozliwic : umożliwić : (czas.) enable
umrzec : umrzeć : (czas.) decease | : (czas.) die
umrzyk : umrzyk : (rzecz.) corpse
umundurowanie : umundurowanie : (rzecz.) uniform
umycie : umycie : (rzecz.) ablution | : (rzecz.) washing
umykanie : umykanie : (rzecz.) scamper
umykac : umykać : (czas.) elude | : (czas.) escape | : (czas.) evade
umysl : umysł : (rzecz.) brain | : (rzecz.) head | : (rzecz.) intellect | : (rzecz.) memory | : (rzecz.) mind | : (rzecz.) spirit
umyslowo : umysłowo : (przysł.) intellectually | : (przysł.) mentally
umyslowosc : umysłowość : (rzecz.) mentality
umyslowy : umysłowy : (przym.) intellectual | : (przym.) mental | : (przym.) spiritual | : (przym.) white-collar
umywalka : umywalka : (rzecz.) basin | : (rzecz.) commode | : (rzecz.) sink | : (rzecz.) washbasin | : (rzecz.) wash-basin | : (rzecz.) washbowl | : (rzecz.) washstand | : (rzecz.) wash-stand
umywalnia : umywalnia : (rzecz.) basin | : (rzecz.) lavatory | : (rzecz.) laver | : (rzecz.) sink | : (rzecz.) washbasin | : (rzecz.) washroom | : (rzecz.) wash-room | : (rzecz.) washstand | : (rzecz.) wash-stand
umywac : umywać : (czas.) wash
umyc : umyć : (czas.) lave | : (czas.) wash
umyslic : umyślić : (czas.) decide
umyslnie : umyślnie : (przysł.) deliberately | : (przysł.) designedly | : (przysł.) intentionally | : (przysł.) knowingly | : (przysł.) presumably | : (przysł.) purposely
umyslnosc : umyślność : (rzecz.) intent
umyslny : umyślny : (przym.) deliberate | : (przym.) deliberateness | : (przym.) intentional | : (przym.) wilful
umowic : umówić : (czas.) arrange
umeczyc : umęczyć : (czas.) crucify
unaoczniac : unaoczniać : (czas.) confront | : (czas.) demonstrate | : (czas.) evidence | : (czas.) visualize
unaocznic : unaocznić : (czas.) demonstrate | : (czas.) evidence | : (czas.) highlight | : (czas.) visualize
unarodowienie : unarodowienie : (rzecz.) nationalization
unarodowic : unarodowić : (czas.) nationalize
uncja : uncja : (rzecz.) ounce | : (rzecz.) ounces
unerwiac : unerwiać : (czas.) innervate
unerwienie : unerwienie : (rzecz.) nervure
unia : unia : (rzecz.) union
unicestwiac : unicestwiać : (czas.) annihilate
unicestwienie : unicestwienie : (rzecz.) annihilation | : (rzecz.) frustration
unicestwic : unicestwić : (czas.) annihilate | : (czas.) kill
uniemozliwiac : uniemożliwiać : (czas.) disenable | : (czas.) prevent | : (czas.) stymie
uniemozliwic : uniemożliwić : (czas.) prevent
unieruchamiac : unieruchamiać : (czas.) arrest | : (czas.) immobilise | : (czas.) immobilize | : (czas.) inactivate | : (czas.) transfix
unieruchomienie : unieruchomienie : (rzecz.) arrestment | : (rzecz.) immobilisation | : (rzecz.) immobilization | : (rzecz.) standstill
unieruchomiony : unieruchomiony : (przym.) stranded
unieruchomic : unieruchomić : (czas.) disable | : (czas.) immobilize | : (czas.) inactivate | : (czas.) transfix
uniesienie : uniesienie : (rzecz.) elation | : (rzecz.) exultation | : (rzecz.) lift | : (rzecz.) passion | : (rzecz.) rapture
unieszczesliwiac : unieszczęśliwiać : (czas.) distress
unieszkodliwiac : unieszkodliwiać : (czas.) disable
unieszkodliwienie : unieszkodliwienie : (rzecz.) disposal
unieszkodliwic : unieszkodliwić : (czas.) disable | : (czas.) disposed
uniewazniac : unieważniać : (czas.) annul | : (czas.) cancel | : (czas.) disannul | : (czas.) invalidate | : (czas.) nullify | : (czas.) quash | : (czas.) repeal | : (czas.) rescind | : (czas.) revoke | : (czas.) void
uniewaznienie : unieważnienie : (rzecz.) annulling | : (rzecz.) annulment | : (rzecz.) cancellation | : (rzecz.) defeasance | : (rzecz.) invalidation | : (rzecz.) nullification | : (rzecz.) nullity | : (rzecz.) rescission | : (rzecz.) reversal | : (rzecz.) revocation
uniewaznic : unieważnić : (czas.) annul | : (czas.) cancel | : (czas.) invalidate | : (czas.) rescind | : (czas.) undo | : (czas.) void
uniewinniac : uniewinniać : (czas.) acquit | : (czas.) exculpate | : (czas.) exonerate
uniewinnienie : uniewinnienie : (rzecz.) acquittal | : (rzecz.) exculpation
uniewinnic : uniewinnić : (czas.) acquit | : (czas.) exculpate | : (czas.) excuse | : (czas.) exonerate
uniesmiertelniac : unieśmiertelniać : (czas.) immortalize
uniesmiertelnienie : unieśmiertelnienie : (rzecz.) immortality
uniesc : unieść : (czas.) carry | : (czas.) rhapsodize
unifikacja : unifikacja : (rzecz.) unification
unifikator : unifikator : (rzecz.) unifier
unifikowac : unifikować : (czas.) unify
uniform : uniform : (rzecz.) uniform
uniformizacja : uniformizacja : (rzecz.) standardization
unik : unik : (rzecz.) dodge | : (rzecz.) hedge
unikalnie : unikalnie : (przysł.) uniquely
unikalny : unikalny : (przym.) quaint | : (przym.) unique
unikanie : unikanie : (rzecz.) avoidance | : (rzecz.) elusion | : (rzecz.) evasion
unikat : unikat : (rzecz.) curiosity | : (rzecz.) nonpareil | : (rzecz.) rarity
unikatowy : unikatowy : (przym.) unique
unikac : unikać : (czas.) avoid | : (czas.) avoided | : (czas.) burke | : (czas.) elude | : (czas.) escape | : (czas.) eschew | : (czas.) evade | : (czas.) parry | : (czas.) pussyfoot | : (czas.) shirk | : (czas.) shun
unikniecie : uniknięcie : (rzecz.) evasion
uniknac : uniknąć : (czas.) escape
unionista : unionista : (rzecz.) unionist
uniwerek : uniwerek : (rzecz.) varsity
uniwersalia : uniwersalia : (rzecz.) universals
uniwersalizm : uniwersalizm : (rzecz.) universalism
uniwersalnosc : uniwersalność : (rzecz.) universality | : (rzecz.) versatility
uniwersalny : uniwersalny : (przym.) all-around | : (przym.) all-purpose | : (przym.) all-round | : (przym.) catholic | : (przym.) generalized | : (przym.) general-purpose | : (przym.) multipurpose | : (przym.) universal | : (przym.) versatile
uniwersytet : uniwersytet : (rzecz.) school | : (rzecz.) university
unizonosc : uniżoność : (rzecz.) humbleness | : (rzecz.) humility
unormowac : unormować : (czas.) normalize
unosic : unosić : (czas.) bear | : (czas.) float | : (czas.) hoist | : (czas.) hover | : (czas.) rave | : (czas.) soar | : (czas.) waft
unoszenie : unoszenie : (rzecz.) convection | : (rzecz.) lifting
unowoczesniac : unowocześniać : (czas.) innovate | : (czas.) update | : (czas.) upgrade
unowoczesnienie : unowocześnienie : (rzecz.) modernization
unowoczesnic : unowocześnić : (czas.) upgrade
uobecnienie : uobecnienie : (rzecz.) actuation
uodpornianie : uodpornianie : (rzecz.) immunization
uodporniac : uodporniać : (czas.) immunize | : (czas.) proof
uodpornienie : uodpornienie : (rzecz.) immunization | : (rzecz.) robustness
uodpornic : uodpornić : (czas.) harden | : (czas.) immunize | : (czas.) proof
uogolnianie : uogólnianie : (rzecz.) generalization
uogolniac : uogólniać : (czas.) generalize
uogolnienie : uogólnienie : (rzecz.) generalisation | : (rzecz.) generalization
uogolnic : uogólnić : (czas.) generalized
uosabianie : uosabianie : (rzecz.) impersonation
uosabiac : uosabiać : (czas.) embody | : (czas.) impersonate | : (czas.) personalize | : (czas.) personify | : (czas.) typify
uosobienie : uosobienie : (rzecz.) embodiment | : (rzecz.) epitome | : (rzecz.) impersonation | : (rzecz.) incarnation | : (rzecz.) paragon | : (rzecz.) personification
upad : upad : (rzecz.) bankruptcy
upadanie : upadanie : (rzecz.) falling | : (rzecz.) falls
upadac : upadać : (czas.) drop | : (czas.) fall | : (czas.) fell | : (czas.) rain | : (czas.) sag | : (czas.) wince
upadek : upadek : (rzecz.) breakdown | : (rzecz.) break-up | : (rzecz.) burst-up | : (rzecz.) collapse | : (rzecz.) crash | : (rzecz.) decadence | : (rzecz.) decadency | : (rzecz.) decay | : (rzecz.) degeneracy | : (rzecz.) degradation | : (rzecz.) downfall | : (rzecz.) ebb | : (rzecz.) fall | : (rzecz.) flop | : (rzecz.) labefaction | : (rzecz.) ruin | : (rzecz.) ruination | : (rzecz.) tumble
upadlac : upadlać : (czas.) degrade
upadlosc : upadłość : (rzecz.) bankruptcy | : (rzecz.) insolvency
upajac : upajać : (czas.) intoxicate
upakowanie : upakowanie : (rzecz.) compaction
upakowac : upakować : (czas.) pack
upakowywanie : upakowywanie : (rzecz.) packing
upalny : upalny : (przym.) hot | : (przym.) sweltering | : (przym.) torrid
upamietniac : upamiętniać : (czas.) commemorate | : (czas.) memorialize
upamietnic : upamiętnić : (czas.) commemorate | : (czas.) memorialize
uparcie : uparcie : (przysł.) doggedly | : (przysł.) insistently | : (przysł.) obstinately | : (przysł.) persistently | : (przysł.) stubbornly
uparciuch : uparciuch : (rzecz.) mule
upartosc : upartość : (rzecz.) stubbornness
uparty : uparty : (przym.) hardboiled | : (przym.) intractable | : (przym.) obdurate | : (przym.) obstinate | : (przym.) refractory | : (przym.) stubborn | : (przym.) wilful
upatrywac : upatrywać : (czas.) found
upal : upał : (rzecz.) heat
upanstwawiac : upaństwawiać : (czas.) nationalize | : (czas.) socialize
upanstwowienie : upaństwowienie : (rzecz.) nationalisation | : (rzecz.) nationalization
upanstwowic : upaństwowić : (czas.) nationalize | : (czas.) socialize
upasc : upaść : (czas.) collapse | : (czas.) drop | : (czas.) fall | : (czas.) tumble
upewniac : upewniać : (czas.) ascertain | : (czas.) assure | : (czas.) insure | : (czas.) satisfy | : (czas.) secure | : (czas.) warrant
upewnienie : upewnienie : (rzecz.) ascertainment | : (rzecz.) assurance | : (rzecz.) dependability
upewnic : upewnić : (czas.) ascertain | : (czas.) ensure | : (czas.) secure | : (czas.) warrant
upelnomocniac : upełnomocniać : (czas.) accredit | : (czas.) commission | : (czas.) delegate | : (czas.) depute
upelnomocnienie : upełnomocnienie : (rzecz.) empowerment
upelnomocnic : upełnomocnić : (czas.) accredit | : (czas.) commission | : (czas.) delegate | : (czas.) depute | : (czas.) empower
upicie : upicie : (rzecz.) intoxication
upierac : upierać : (czas.) insist | : (czas.) persevere | : (czas.) persist
upierzenie : upierzenie : (rzecz.) feathers | : (rzecz.) plumage
upierzyc : upierzyć : (czas.) feather
upijac : upijać : (czas.) intoxicate
upilnowac : upilnować : (czas.) look
upiorny : upiorny : (przym.) ghastly | : (przym.) ghostlike | : (przym.) ghostly | : (przym.) lurid | : (przym.) shadowy | : (przym.) spectral | : (przym.) spooky | : (przym.) weird
upior : upiór : (rzecz.) apparition | : (rzecz.) ghost | : (rzecz.) ghoul | : (rzecz.) revenant | : (rzecz.) vampire
upic : upić : (czas.) booze | : (czas.) intoxicate
upiekszanie : upiększanie : (rzecz.) adornment
upiekszac : upiększać : (czas.) adorn | : (czas.) beautify | : (czas.) brighten | : (czas.) deck | : (czas.) embellish | : (czas.) garnish | : (czas.) ornament | : (czas.) prettify | : (czas.) streamline
upiekszenie : upiększenie : (rzecz.) embellishment | : (rzecz.) figuration | : (rzecz.) titivation
upiekszyc : upiększyć : (czas.) beautify
uplastycznianie : uplastycznianie : (rzecz.) fluxing
uplastyczniac : uplastyczniać : (czas.) plasticize
uplastycznic : uplastycznić : (czas.) plasticize
uplesc : upleść : (czas.) plait
upodabniac : upodabniać : (czas.) assimilate | : (czas.) liken
upodlac : upodlać : (czas.) vilify
upodlenie : upodlenie : (rzecz.) abjection | : (rzecz.) debasement | : (rzecz.) degradation
upodlic : upodlić : (czas.) debase | : (czas.) vilify
upodobanie : upodobanie : (rzecz.) fancy | : (rzecz.) inclination | : (rzecz.) liking | : (rzecz.) partiality | : (rzecz.) penchant | : (rzecz.) pleasure | : (rzecz.) relish
upodobac : upodobać : (czas.) fancy | : (czas.) like | : (czas.) liking | : (czas.) please
upodobnienie : upodobnienie : (rzecz.) assimilation
upojenie : upojenie : (rzecz.) ecstasy | : (rzecz.) inebriation | : (rzecz.) intoxication | : (rzecz.) rapture
upojny : upojny : (przym.) heady | : (przym.) intoxicating
upokarzac : upokarzać : (czas.) abase | : (czas.) humble | : (czas.) humiliate | : (czas.) mortify
upokorzenie : upokorzenie : (rzecz.) abasement | : (rzecz.) humiliation
upokorzyc : upokorzyć : (czas.) abase | : (czas.) humble | : (czas.) humiliate | : (czas.) snub
upolowac : upolować : (czas.) shoot
upominanie : upominanie : (rzecz.) admonition | : (rzecz.) calls
upominac : upominać : (czas.) admonish | : (czas.) exhort | : (czas.) rebuke | : (czas.) remonstrate | : (czas.) warn
upominek : upominek : (rzecz.) freebie | : (rzecz.) gift | : (rzecz.) keepsake | : (rzecz.) souvenir | : (rzecz.) testimonial
upomnienie : upomnienie : (rzecz.) admonishment | : (rzecz.) admonition | : (rzecz.) censure | : (rzecz.) exhortation | : (rzecz.) reminder | : (rzecz.) warning
uporanie : uporanie : (rzecz.) coping | : (rzecz.) dealing | : (rzecz.) tackling
uporac : uporać : (czas.) deal | : (czas.) manage | : (czas.) tackle
uporczywie : uporczywie : (przysł.) insistently | : (przysł.) obstinately | : (przysł.) persistently | : (przysł.) stubbornly
uporczywosc : uporczywość : (rzecz.) insistence | : (rzecz.) obstinacy | : (rzecz.) persistence | : (rzecz.) persistency | : (rzecz.) pertinacity
uporczywy : uporczywy : (przym.) insistent | : (przym.) inveterate | : (przym.) obstinate | : (przym.) persistent | : (przym.) pertinacious | : (przym.) severe | : (przym.) stubborn | : (przym.) tenacious | : (przym.) unrelenting | : (przym.) wrongheaded | : (przym.) wrong-headed
uporzadkowanie : uporządkowanie : (rzecz.) adjustment | : (rzecz.) alignment | : (rzecz.) arrangement | : (rzecz.) orderliness | : (rzecz.) regularization | : (rzecz.) sequencing | : (rzecz.) setup | : (rzecz.) trimming
uporzadkowac : uporządkować : (czas.) adjust | : (czas.) fix | : (czas.) rearrange | : (czas.) regularize | : (czas.) sort | : (czas.) straighten | : (czas.) trim
uporzadkowywac : uporządkowywać : (czas.) regularize
uposazenie : uposażenie : (rzecz.) emolument | : (rzecz.) pay | : (rzecz.) salary
uposazyc : uposażyć : (czas.) dower
upowazniac : upoważniać : (czas.) authorize | : (czas.) empower | : (czas.) enable | : (czas.) entitle | : (czas.) license | : (czas.) qualify
upowaznienie : upoważnienie : (rzecz.) authorization | : (rzecz.) empowerment | : (rzecz.) entitlement | : (rzecz.) warrant
upowaznic : upoważnić : (czas.) authorize
upowszechnianie : upowszechnianie : (rzecz.) promotion
upowszechniac : upowszechniać : (czas.) publicize | : (czas.) spread
upowszechnic : upowszechnić : (czas.) spread
upozorowac : upozorować : (czas.) simulate
upozorowywac : upozorowywać : (czas.) fake
uposledzac : upośledzać : (czas.) impair
uposledzenie : upośledzenie : (rzecz.) disability | : (rzecz.) handicap | : (rzecz.) impairment
uposledzony : upośledzony : (przym.) disabled
upraszanie : upraszanie : (rzecz.) requests
upraszac : upraszać : (czas.) ask
upraszczanie : upraszczanie : (rzecz.) simplification
upraszczac : upraszczać : (czas.) abbreviate | : (czas.) oversimplify | : (czas.) simplify
uprawa : uprawa : (rzecz.) arboriculture | : (rzecz.) crop | : (rzecz.) cultivation | : (rzecz.) culture | : (rzecz.) tillage
uprawianie : uprawianie : (rzecz.) growing | : (rzecz.) practicing | : (rzecz.) pursuance
uprawiac : uprawiać : (czas.) addict | : (czas.) cultivate | : (czas.) exercise | : (czas.) grow | : (czas.) pursue | : (czas.) till
uprawnianie : uprawnianie : (rzecz.) authorization
uprawniac : uprawniać : (czas.) authorise | : (czas.) entitle | : (czas.) entitling | : (czas.) warrant
uprawnienie : uprawnienie : (rzecz.) authorisation | : (rzecz.) authority | : (rzecz.) capability | : (rzecz.) freedom | : (rzecz.) power | : (rzecz.) right | : (rzecz.) title | : (rzecz.) warrant
uprawniony : uprawniony : (przym.) qualified
uprawnic : uprawnić : (czas.) authorise | : (czas.) delegate | : (czas.) entitle | : (czas.) warrant
uprawny : uprawny : (przym.) arable | : (przym.) cultivable | : (przym.) cultivated
uprawomocniac : uprawomocniać : (czas.) validate
uprawomocnienie : uprawomocnienie : (rzecz.) legalization | : (rzecz.) validation
uprawomocnic : uprawomocnić : (czas.) validate
uprawowy : uprawowy : (przym.) agricultural | : (przym.) cultivated
uprac : uprać : (czas.) wash
uprazyc : uprażyć : (czas.) roast
uprosic : uprosić : (czas.) ask
uproszczenie : uproszczenie : (rzecz.) oversimplification | : (rzecz.) simplification
uprowadzac : uprowadzać : (czas.) abduct | : (czas.) kidnap
uprowadzenie : uprowadzenie : (rzecz.) abduction | : (rzecz.) hijacking | : (rzecz.) ravishment
uprowadzic : uprowadzić : (czas.) abduct | : (czas.) kidnap
uproscic : uprościć : (czas.) simplify | : (czas.) streamline
uprzedmiotowienie : uprzedmiotowienie : (rzecz.) reification
uprzedni : uprzedni : (przym.) anterior | : (przym.) perfect | : (przym.) previous | : (przym.) prior
uprzednio : uprzednio : (przysł.) beforehand | : (przysł.) previously
uprzedzajaco : uprzedzająco : (przysł.) extremely | : (przysł.) suspiciously
uprzedzac : uprzedzać : (czas.) anticipate | : (czas.) forestall | : (czas.) preconceive | : (czas.) predict | : (czas.) pre-empt | : (czas.) preoccupy | : (czas.) prepossess | : (czas.) warn
uprzedzenie : uprzedzenie : (rzecz.) anticipation | : (rzecz.) bias | : (rzecz.) preconception | : (rzecz.) prejudice | : (rzecz.) preoccupation | : (rzecz.) warning
uprzedzic : uprzedzić : (czas.) preconceive | : (czas.) warned
uprzedzony : uprzedzony : (przym.) prejudiced
uprzejmie : uprzejmie : (przysł.) affably | : (przysł.) blandly | : (przysł.) civilly | : (przysł.) courteously | : (przysł.) gently | : (przysł.) graciously | : (przysł.) kindly | : (przysł.) nicely | : (przysł.) obligingly | : (przysł.) politely
uprzejmosc : uprzejmość : (rzecz.) affability | : (rzecz.) amenity | : (rzecz.) amiability | : (rzecz.) attention | : (rzecz.) blandness | : (rzecz.) civility | : (rzecz.) complaisance | : (rzecz.) courtesy | : (rzecz.) goodness | : (rzecz.) kindliness | : (rzecz.) kindness | : (rzecz.) politeness | : (rzecz.) urbanity
uprzejmy : uprzejmy : (przym.) accommodating | : (przym.) affable | : (przym.) amiable | : (przym.) attentive | : (przym.) complaisant | : (przym.) considerate | : (przym.) courteous | : (przym.) gallant | : (przym.) genial | : (przym.) good-natured | : (przym.) kind | : (przym.) kindly | : (przym.) obliging | : (przym.) officious | : (przym.) polite | : (przym.) suave | : (przym.) unprecedented | : (przym.) urbane
uprzemyslawiac : uprzemysławiać : (czas.) industrialize
uprzemyslowienie : uprzemysłowienie : (rzecz.) industrialization
uprzemyslowic : uprzemysłowić : (czas.) industrialize
uprzec : uprzeć : (czas.) stiffen
uprzykrzac : uprzykrzać : (czas.) bedevil | : (czas.) molest | : (czas.) resent | : (czas.) spoil
uprzywilejowanie : uprzywilejowanie : (rzecz.) charter | : (rzecz.) preference | : (rzecz.) privilege
uprzywilejowany : uprzywilejowany : (przym.) privileged
uprzatac : uprzątać : (czas.) remove | : (czas.) tidy
uprzasc : uprząść : (czas.) spin
uprzaz : uprząż : (rzecz.) harness | : (rzecz.) tackling
upstrzenie : upstrzenie : (rzecz.) specking
upstrzyc : upstrzyć : (czas.) speckle | : (czas.) variegate
upudrowac : upudrować : (czas.) powder
upust : upust : (rzecz.) bleeder | : (rzecz.) discount | : (rzecz.) floodgate | : (rzecz.) vent
upuszczac : upuszczać : (czas.) drop
upuscic : upuścić : (czas.) drop
upychacz : upychacz : (rzecz.) plumper
upychac : upychać : (czas.) stuff
upoj : upój : (rzecz.) intoxication
upor : upór : (rzecz.) doggedness | : (rzecz.) obduracy | : (rzecz.) obstinacy | : (rzecz.) persistence | : (rzecz.) persistency | : (rzecz.) pertinacity | : (rzecz.) perverseness | : (rzecz.) recalcitrance | : (rzecz.) stubbornness | : (rzecz.) tenacity
uplyniecie : upłynięcie : (rzecz.) expiration | : (rzecz.) expiry
uplynniac : upłynniać : (czas.) fluidize | : (czas.) sell
uplynnienie : upłynnienie : (rzecz.) realisation
uplynnic : upłynnić : (czas.) fluidize | : (czas.) liquidate
uplyw : upływ : (rzecz.) expiration | : (rzecz.) extinction | : (rzecz.) flux | : (rzecz.) lapse | : (rzecz.) passage
uplywac : upływać : (czas.) elapse | : (czas.) expire | : (czas.) pass
uplywnosc : upływność : (rzecz.) leakage
urabialny : urabialny : (przym.) workable
urabianie : urabianie : (rzecz.) breaking | : (rzecz.) mining
urabiarka : urabiarka : (rzecz.) getter
urabiac : urabiać : (czas.) knead | : (czas.) mould | : (czas.) shape | : (czas.) win
uraczyc : uraczyć : (czas.) regale
uradowanie : uradowanie : (rzecz.) joy | : (rzecz.) rejoicing
uradowac : uradować : (czas.) exult | : (czas.) gladden
uradzac : uradzać : (czas.) decide
uradzic : uradzić : (czas.) decide
uran : uran : (rzecz.) uranium
uraninit : uraninit : (rzecz.) pitchblende
urastac : urastać : (czas.) grow
uratowac : uratować : (czas.) redeem | : (czas.) rescue | : (czas.) salvage | : (czas.) save
uraz : uraz : (rzecz.) injury | : (rzecz.) trauma
uraza : uraza : (rzecz.) animosity | : (rzecz.) bitterness | : (rzecz.) grievance | : (rzecz.) grudge | : (rzecz.) ill-feeling | : (rzecz.) pique | : (rzecz.) rancour | : (rzecz.) resentment | : (rzecz.) spite | : (rzecz.) umbrage
urazic : urazić : (czas.) offend
urazowosc : urazowość : (rzecz.) traumatism
urazowy : urazowy : (przym.) traumatic
urazac : urażać : (czas.) displease | : (czas.) offend
urazenie : urażenie : (rzecz.) injury
urazony : urażony : (przym.) resentful
urbanista : urbanista : (rzecz.) planner | : (rzecz.) town-planner
urbanistyczny : urbanistyczny : (przym.) urban
urbanistyka : urbanistyka : (rzecz.) town-planning
urbanizacja : urbanizacja : (rzecz.) urbanization
urbanizowac : urbanizować : (czas.) urbanize
uregulowanie : uregulowanie : (rzecz.) regulation | : (rzecz.) settlement
uregulowac : uregulować : (czas.) adjust | : (czas.) regularize | : (czas.) regulate | : (czas.) settle
uremia : uremia : (rzecz.) uraemia
uretan : uretan : (rzecz.) urethane
urlop : urlop : (rzecz.) break | : (rzecz.) furlough | : (rzecz.) holidays | : (rzecz.) leave | : (rzecz.) vacation
urlopowicz : urlopowicz : (rzecz.) holidaymaker | : (rzecz.) holiday-maker | : (rzecz.) vacationer
urna : urna : (rzecz.) ballot-box | : (rzecz.) urn
urobek : urobek : (rzecz.) output
uroczo : uroczo : (przysł.) charmingly
uroczy : uroczy : (przym.) adorable | : (przym.) charming | : (przym.) cute | : (przym.) lovely | : (przym.) sweet | : (przym.) winsome
uroczysko : uroczysko : (rzecz.) range
uroczystosc : uroczystość : (rzecz.) celebration | : (rzecz.) ceremony | : (rzecz.) feast | : (rzecz.) festivity | : (rzecz.) occasion | : (rzecz.) solemnity | : (rzecz.) state
uroczysty : uroczysty : (przym.) ceremonial | : (przym.) ceremonious | : (przym.) festive | : (przym.) grand | : (przym.) solemn | : (przym.) unctuous
uroczyscie : uroczyście : (przysł.) solemnly
uroda : uroda : (rzecz.) beauty | : (rzecz.) comeliness | : (rzecz.) prettiness | : (rzecz.) pulchritude
urodzaj : urodzaj : (rzecz.) abundance | : (rzecz.) crop | : (rzecz.) harvest
urodzajnosc : urodzajność : (rzecz.) fertilely | : (rzecz.) fertility
urodzajny : urodzajny : (przym.) fertile | : (przym.) good
urodzenie : urodzenie : (rzecz.) birth
urodzinowy : urodzinowy : (przym.) natal
urodziny : urodziny : (rzecz.) birthday | : (rzecz.) birthdays
urodziwy : urodziwy : (przym.) bonny | : (przym.) comely | : (przym.) good-looking | : (przym.) handsome
urodzic : urodzić : (czas.) born | : (czas.) yean
uroic : uroić : (czas.) dream | : (czas.) imagine
urojenie : urojenie : (rzecz.) conceit | : (rzecz.) fantasise | : (rzecz.) fiction | : (rzecz.) illusion | : (rzecz.) maggot | : (rzecz.) presumption | : (rzecz.) whimsy
urojeniowy : urojeniowy : (przym.) delusional
urojony : urojony : (przym.) imaginary
urok : urok : (rzecz.) appeal | : (rzecz.) attraction | : (rzecz.) beauty | : (rzecz.) captivation | : (rzecz.) charm | : (rzecz.) fascination | : (rzecz.) glamour | : (rzecz.) hex | : (rzecz.) spell
urokliwy : urokliwy : (przym.) captivating | : (przym.) charming
urolog : urolog : (rzecz.) urologist
urologia : urologia : (rzecz.) urology
urologiczny : urologiczny : (przym.) urinary | : (przym.) urological
uronic : uronić : (czas.) shed
urotropina : urotropina : (rzecz.) hexamethylenetetramine
urozmaicac : urozmaicać : (czas.) diversify | : (czas.) intersperse | : (czas.) vary
urozmaicenie : urozmaicenie : (rzecz.) diversification | : (rzecz.) diversity | : (rzecz.) variety
urozmaicic : urozmaicić : (czas.) intersperse | : (czas.) make
urozmaicony : urozmaicony : (przym.) variegated
uruchamiac : uruchamiać : (czas.) activate | : (czas.) actuate | : (czas.) debug | : (czas.) execute | : (czas.) liberate | : (czas.) run | : (czas.) start
uruchomienie : uruchomienie : (rzecz.) actuation | : (rzecz.) flotation | : (rzecz.) mobilization | : (rzecz.) takeoff
uruchomic : uruchomić : (czas.) execute | : (czas.) start
urwac : urwać : (czas.) intermit | : (czas.) snap
urwipolec : urwipołeć : (rzecz.) scapegrace
urwis : urwis : (rzecz.) dickens | : (rzecz.) jackanapes | : (rzecz.) rascal | : (rzecz.) scapegrace | : (rzecz.) tomboy | : (rzecz.) tyke | : (rzecz.) urchin
urwisko : urwisko : (rzecz.) bluff | : (rzecz.) cliff | : (rzecz.) crag | : (rzecz.) precipice | : (rzecz.) scarp
urwisowski : urwisowski : (przym.) arch | : (przym.) prankish
urwisty : urwisty : (przym.) cliffy | : (przym.) craggy | : (przym.) precipitous | : (przym.) rugged | : (przym.) steep
uryna : uryna : (rzecz.) urine
urynal : urynał : (rzecz.) urinal
urywac : urywać : (czas.) sever
urywek : urywek : (rzecz.) excerpt | : (rzecz.) fragment | : (rzecz.) movement | : (rzecz.) paragraph | : (rzecz.) passage | : (rzecz.) scrap | : (rzecz.) snatch | : (rzecz.) snippet
urywkowy : urywkowy : (przym.) discursive | : (przym.) fragmentary
urzeczenie : urzeczenie : (rzecz.) bewitchment | : (rzecz.) captivation | : (rzecz.) charm
urzeczony : urzeczony : (przym.) spellbound
urzeczowienie : urzeczowienie : (rzecz.) reification
urzeczywistniac : urzeczywistniać : (czas.) actualize | : (czas.) materialize | : (czas.) realize | : (czas.) seek
urzeczywistnienie : urzeczywistnienie : (rzecz.) fruition | : (rzecz.) realisation | : (rzecz.) realization
urzeczywistnic : urzeczywistnić : (czas.) actualize | : (czas.) materialize
urzekac : urzekać : (czas.) bewitch | : (czas.) captivate
urzad : urząd : (rzecz.) agency | : (rzecz.) bureau | : (rzecz.) clerkship | : (rzecz.) commission | : (rzecz.) department | : (rzecz.) magistracy | : (rzecz.) office | : (rzecz.) ordinary | : (rzecz.) post | : (rzecz.) station | : (rzecz.) status
urzadzac : urządzać : (czas.) arrange | : (czas.) furnish | : (czas.) institute | : (czas.) mount | : (czas.) nestle | : (czas.) organize | : (czas.) plant
urzadzenia : urządzenia : (rzecz.) facilities | : (rzecz.) trouble
urzadzenie : urządzenie : (rzecz.) apparatus | : (rzecz.) appliance | : (rzecz.) arrangement | : (rzecz.) attachment | : (rzecz.) contraption | : (rzecz.) contrivance | : (rzecz.) device | : (rzecz.) equipment | : (rzecz.) establishment | : (rzecz.) fitment | : (rzecz.) fitting | : (rzecz.) fixture | : (rzecz.) furnishings | : (rzecz.) gadget | : (rzecz.) gimmick | : (rzecz.) installation | : (rzecz.) opener
urzadzic : urządzić : (czas.) fit | : (czas.) nestle
urzedniczy : urzędniczy : (przym.) clerical
urzednik : urzędnik : (rzecz.) clerk | : (rzecz.) magistrate | : (rzecz.) officer | : (rzecz.) official | : (rzecz.) registrar | : (rzecz.) serviceman
urzedowanie : urzędowanie : (rzecz.) office | : (rzecz.) tenure
urzedowac : urzędować : (czas.) officiate | : (czas.) serve
urzedowo : urzędowo : (przysł.) officially
urzedowy : urzędowy : (przym.) formal | : (przym.) official | : (przym.) standard
uraganie : urąganie : (rzecz.) outrage
uragac : urągać : (czas.) baffle | : (czas.) insult | : (czas.) revile
uragliwy : urągliwy : (przym.) derisive
uragowisko : urągowisko : (rzecz.) mockery
usadowic : usadowić : (czas.) settle
usadzac : usadzać : (czas.) seat | : (czas.) station
usadzic : usadzić : (czas.) station
usamowolniac : usamowolniać : (czas.) emancipate
usankcjonowac : usankcjonować : (czas.) assent | : (czas.) legitimize
usatysfakcjonowac : usatysfakcjonować : (czas.) satisfied | : (czas.) satisfy
uschniecie : uschnięcie : (rzecz.) withers
usiac : usiać : (czas.) stud
usidlac : usidlać : (czas.) ensnare | : (czas.) entrap | : (czas.) snare
usidlic : usidlić : (czas.) ensnare | : (czas.) entrap | : (czas.) noose | : (czas.) snare
usiedziec : usiedzieć : (czas.) sit
usilnie : usilnie : (przysł.) insistently | : (przysł.) strongly
usilny : usilny : (przym.) hard | : (przym.) insistent | : (przym.) intense | : (przym.) strenuous | : (przym.) urgent
usiasc : usiąść : (czas.) sit
usilowanie : usiłowanie : (rzecz.) attempt | : (rzecz.) striving
usilowac : usiłować : (czas.) attempt | : (czas.) endeavour | : (czas.) seek | : (czas.) strive
uskakiwac : uskakiwać : (czas.) dodge
uskarzac : uskarżać : (czas.) complain
uskok : uskok : (rzecz.) horst | : (rzecz.) jump
uskuteczniac : uskuteczniać : (czas.) render
uskladac : uskładać : (czas.) save
usmarowac : usmarować : (czas.) dirty | : (czas.) grime | : (czas.) smear
usmazyc : usmażyć : (czas.) frizzle | : (czas.) fry
usnuc : usnuć : (czas.) spin
uspakajac : uspakajać : (czas.) allay | : (czas.) calm | : (czas.) conciliate | : (czas.) pacify | : (czas.) quiet | : (czas.) settle | : (czas.) soothe | : (czas.) steady
uspokajajaco : uspokajająco : (przysł.) reassuringly
uspokajajacy : uspokajający : (przym.) ataractic
uspokajac : uspokajać : (czas.) appease | : (czas.) assuage | : (czas.) becalm | : (czas.) calm | : (czas.) compose | : (czas.) ease | : (czas.) heal | : (czas.) lull | : (czas.) mitigate | : (czas.) moderate | : (czas.) pacify | : (czas.) placate | : (czas.) quiet | : (czas.) quieten | : (czas.) reassure | : (czas.) salve | : (czas.) silence | : (czas.) sober | : (czas.) steady | : (czas.) tranquillize
uspokoic : uspokoić : (czas.) allay | : (czas.) appease | : (czas.) calm | : (czas.) conciliate | : (czas.) pacify | : (czas.) quiet | : (czas.) reassure | : (czas.) settle | : (czas.) soothe | : (czas.) steady
uspokojenie : uspokojenie : (rzecz.) assuagement | : (rzecz.) calm | : (rzecz.) sedation
uspokojony : uspokojony : (przym.) relieved
usposabiac : usposabiać : (czas.) prepossess
usposobienie : usposobienie : (rzecz.) disposition | : (rzecz.) mettle | : (rzecz.) mood | : (rzecz.) nature | : (rzecz.) temper
uspoleczniac : uspołeczniać : (czas.) socialize
uspolecznic : uspołecznić : (czas.) civilize | : (czas.) socialize
usprawiedliwiac : usprawiedliwiać : (czas.) apologize | : (czas.) excuse | : (czas.) exonerate | : (czas.) justify | : (czas.) legitimize | : (czas.) warrant
usprawiedliwienie : usprawiedliwienie : (rzecz.) alibi | : (rzecz.) apology | : (rzecz.) exculpation | : (rzecz.) excuse | : (rzecz.) justification | : (rzecz.) plea | : (rzecz.) vindication
usprawiedliwic : usprawiedliwić : (czas.) apologize | : (czas.) exonerate | : (czas.) justify | : (czas.) warrant
usprawnianie : usprawnianie : (rzecz.) perfection | : (rzecz.) streamlining
usprawniac : usprawniać : (czas.) amend | : (czas.) enrich | : (czas.) improved | : (czas.) modify | : (czas.) rationalise | : (czas.) revamped | : (czas.) streamline
usprawnienie : usprawnienie : (rzecz.) enhancement | : (rzecz.) improvement | : (rzecz.) innovation
usprawnic : usprawnić : (czas.) improved | : (czas.) modify | : (czas.) streamline
usta : usta : (rzecz.) kisser | : (rzecz.) mouth | : (rzecz.) mouths | : (rzecz.) stoma
ustabilizowac : ustabilizować : (czas.) stabilize
ustalanie : ustalanie : (rzecz.) ranking | : (rzecz.) setting
ustalac : ustalać : (czas.) adjust | : (czas.) arrange | : (czas.) ascertain | : (czas.) assign | : (czas.) determine | : (czas.) establish | : (czas.) fix | : (czas.) predetermine | : (czas.) set | : (czas.) solidify | : (czas.) state | : (czas.) steady | : (czas.) stipulate
ustalenie : ustalenie : (rzecz.) decision | : (rzecz.) finding | : (rzecz.) fix | : (rzecz.) settlement
ustalic : ustalić : (czas.) ascertain | : (czas.) establish | : (czas.) fix | : (czas.) set | : (czas.) solidify | : (czas.) steady
ustalony : ustalony : (przym.) appointed | : (przym.) fixed | : (przym.) hard-coded | : (przym.) steady
ustanawianie : ustanawianie : (rzecz.) setting
ustanawiac : ustanawiać : (czas.) constitute | : (czas.) establish | : (czas.) form | : (czas.) institute | : (czas.) legislate | : (czas.) settle | : (czas.) start
ustanowienie : ustanowienie : (rzecz.) constitution | : (rzecz.) establishment | : (rzecz.) institution
ustanowic : ustanowić : (czas.) establish | : (czas.) form | : (czas.) settle | : (czas.) start
ustawa : ustawa : (rzecz.) act | : (rzecz.) constitution | : (rzecz.) copyright | : (rzecz.) law | : (rzecz.) statute
ustawac : ustawać : (czas.) cease | : (czas.) discontinue | : (czas.) stop | : (czas.) subside
ustawiacz : ustawiacz : (rzecz.) adjuster
ustawianie : ustawianie : (rzecz.) placing | : (rzecz.) ranking | : (rzecz.) set | : (rzecz.) setting | : (rzecz.) setup | : (rzecz.) setups
ustawiac : ustawiać : (czas.) align | : (czas.) arrange | : (czas.) array | : (czas.) attune | : (czas.) determine | : (czas.) dispose | : (czas.) juxtapose | : (czas.) marshal | : (czas.) plant | : (czas.) preset | : (czas.) set | : (czas.) situate
ustawicznie : ustawicznie : (przysł.) constantly | : (przysł.) persistently
ustawiczny : ustawiczny : (przym.) constant | : (przym.) endless | : (przym.) incessant | : (przym.) persistent
ustawienia : ustawienia : (rzecz.) preferences | : (rzecz.) settings
ustawienie : ustawienie : (rzecz.) alignment | : (rzecz.) arrangement | : (rzecz.) aspect | : (rzecz.) configuration | : (rzecz.) line-up | : (rzecz.) setting | : (rzecz.) setup
ustawic : ustawić : (czas.) array | : (czas.) attune | : (czas.) juxtapose | : (czas.) set | : (czas.) situate
ustawny : ustawny : (przym.) well-designed
ustawodawca : ustawodawca : (rzecz.) lawmaker | : (rzecz.) legislator | : (rzecz.) legislature
ustawodawczy : ustawodawczy : (przym.) constitutive | : (przym.) legislative
ustawodawstwo : ustawodawstwo : (rzecz.) lawmaking | : (rzecz.) legislation
ustawowy : ustawowy : (przym.) legal | : (przym.) statutory
ustac : ustać : (czas.) intermit
usterka : usterka : (rzecz.) defect | : (rzecz.) fault | : (rzecz.) glitch | : (rzecz.) imperfection | : (rzecz.) shortcoming
usterzenie : usterzenie : (rzecz.) tail
ustnie : ustnie : (przysł.) orally | : (przysł.) verbally
ustnik : ustnik : (rzecz.) embouchure | : (rzecz.) mouthpiece
ustny : ustny : (przym.) oral | : (przym.) spoken | : (przym.) verbal
ustokrotnic : ustokrotnić : (czas.) centuplicate
ustosunkowanie : ustosunkowanie : (rzecz.) answer | : (rzecz.) attitude
ustosunkowac : ustosunkować : (czas.) comment
ustosunkowywac : ustosunkowywać : (czas.) respond
ustrajac : ustrajać : (czas.) attire
ustroic : ustroić : (czas.) array | : (czas.) attire
ustrojenie : ustrojenie : (rzecz.) deck
ustrojowy : ustrojowy : (przym.) constitutional | : (przym.) political
ustrojstwo : ustrojstwo : (rzecz.) contraption | : (rzecz.) gizmo
ustronie : ustronie : (rzecz.) retreat | : (rzecz.) seclusion
ustronny : ustronny : (przym.) outlandish | : (przym.) private | : (przym.) retired | : (przym.) secluded | : (przym.) solitary
ustrzec : ustrzec : (czas.) obviate
ustrzelic : ustrzelić : (czas.) pot
ustroj : ustrój : (rzecz.) government | : (rzecz.) polity | : (rzecz.) regime | : (rzecz.) system
ustapienie : ustąpienie : (rzecz.) abdication | : (rzecz.) resignation | : (rzecz.) resolution
ustapic : ustąpić : (czas.) abate | : (czas.) cede | : (czas.) concede | : (czas.) relent | : (czas.) resign | : (czas.) surrender
ustep : ustęp : (rzecz.) closet | : (rzecz.) latrine | : (rzecz.) paragraph | : (rzecz.) passage | : (rzecz.) subhead | : (rzecz.) toilet
ustepliwosc : ustępliwość : (rzecz.) compliance | : (rzecz.) tractability
ustepliwy : ustępliwy : (przym.) amenable | : (przym.) compliant | : (przym.) pliable | : (przym.) pliant | : (przym.) resilient
ustepowanie : ustępowanie : (rzecz.) abating | : (rzecz.) paragraphs
ustepowac : ustępować : (czas.) abate | : (czas.) cede | : (czas.) concede | : (czas.) ground | : (czas.) relent | : (czas.) resign | : (czas.) retreat | : (czas.) yield
ustepstwo : ustępstwo : (rzecz.) appeasement | : (rzecz.) climb-down | : (rzecz.) concession
usuniecie : usunięcie : (rzecz.) abstraction | : (rzecz.) deletion | : (rzecz.) deposition | : (rzecz.) dislodgement | : (rzecz.) disposal | : (rzecz.) removal | : (rzecz.) remove | : (rzecz.) solution
usunac : usunąć : (czas.) delete | : (czas.) obviate | : (czas.) remove
ususzyc : ususzyć : (czas.) dry
usuwalny : usuwalny : (przym.) removable
usuwanie : usuwanie : (rzecz.) aborting | : (rzecz.) deletion | : (rzecz.) disposal | : (rzecz.) expulsion | : (rzecz.) pop | : (rzecz.) removal
usuwac : usuwać : (czas.) abolish | : (czas.) debug | : (czas.) delete | : (czas.) deplete | : (czas.) dislodge | : (czas.) eject | : (czas.) eliminate | : (czas.) empty | : (czas.) erase | : (czas.) exorcize | : (czas.) lift | : (czas.) obliterate | : (czas.) oust | : (czas.) purge | : (czas.) remove | : (czas.) retire | : (czas.) sidle | : (czas.) sink | : (czas.) unload | : (czas.) winkle | : (czas.) withdraw
usuwisko : usuwisko : (rzecz.) landslip
usychac : usychać : (czas.) shrivel | : (czas.) wither
usypac : usypać : (czas.) slip
usypiac : usypiać : (czas.) advertise | : (czas.) anaesthetize | : (czas.) lull
usypisko : usypisko : (rzecz.) dump | : (rzecz.) heap
usystematyzowac : usystematyzować : (czas.) systematize | : (czas.) systemize
usytuowanie : usytuowanie : (rzecz.) location
usytuowac : usytuować : (czas.) place
uszanowanie : uszanowanie : (rzecz.) respect
uszanowac : uszanować : (czas.) respect | : (czas.) spare
uszczegolawianie : uszczegóławianie : (rzecz.) drilldown | : (rzecz.) drill-down
uszczegolowianie : uszczegółowianie : (rzecz.) precision | : (rzecz.) specialization
uszczegolowic : uszczegółowić : (czas.) detail
uszczelka : uszczelka : (rzecz.) gasket | : (rzecz.) seal | : (rzecz.) washer
uszczelniacz : uszczelniacz : (rzecz.) sealant
uszczelnianie : uszczelnianie : (rzecz.) sealing
uszczelniac : uszczelniać : (czas.) caulk | : (czas.) pack | : (czas.) seal | : (czas.) tighten
uszczelnienie : uszczelnienie : (rzecz.) packing | : (rzecz.) seal
uszczelnic : uszczelnić : (czas.) caulk | : (czas.) sealed
uszczerbek : uszczerbek : (rzecz.) damage | : (rzecz.) dent | : (rzecz.) detriment | : (rzecz.) disservice | : (rzecz.) injury | : (rzecz.) prejudice
uszczuplac : uszczuplać : (czas.) deplete | : (czas.) detract | : (czas.) hole | : (czas.) reduce
uszczuplenie : uszczuplenie : (rzecz.) depletion | : (rzecz.) diminution
uszczypliwosc : uszczypliwość : (rzecz.) acerbity | : (rzecz.) causticity | : (rzecz.) poignancy
uszczypliwy : uszczypliwy : (przym.) acrimonious | : (przym.) biting | : (przym.) catty | : (przym.) poignant | : (przym.) pointed | : (przym.) snappish | : (przym.) tart
uszczypniecie : uszczypniecie : (rzecz.) nip
uszczypniecie : uszczypnięcie : (rzecz.) nip | : (rzecz.) pinch | : (rzecz.) tweak
uszczesliwienie : uszczęśliwienie : (rzecz.) happiness
uszeregowanie : uszeregowanie : (rzecz.) priority
uszeregowac : uszeregować : (czas.) serialize | : (czas.) sort
uszkadzac : uszkadzać : (czas.) cripple | : (czas.) damage | : (czas.) impair | : (czas.) injure
uszko : uszko : (rzecz.) damage | : (rzecz.) handle | : (rzecz.) ravioli
uszkodzenie : uszkodzenie : (rzecz.) corruption | : (rzecz.) damage | : (rzecz.) decay | : (rzecz.) failure | : (rzecz.) fault | : (rzecz.) injury | : (rzecz.) lesion
uszkodzic : uszkodzić : (czas.) cripple | : (czas.) damage | : (czas.) impair | : (czas.) injure
uszlachetniac : uszlachetniać : (czas.) dignify | : (czas.) dress | : (czas.) ennoble | : (czas.) meliorate | : (czas.) refine
uszlachetnienie : uszlachetnienie : (rzecz.) ennoblement
uszlachetnic : uszlachetnić : (czas.) dignify | : (czas.) ennoble
uszny : uszny : (przym.) aural | : (przym.) auricular
usztywniacz : usztywniacz : (rzecz.) stiffener | : (rzecz.) stiffeners
usztywnianie : usztywnianie : (rzecz.) bracing
usztywniac : usztywniać : (czas.) stay | : (czas.) stiffen
usztywnienie : usztywnienie : (rzecz.) backstay | : (rzecz.) stiffener
usztywnic : usztywnić : (czas.) stiffen
uszykowac : uszykować : (czas.) marshal
uszyc : uszyć : (czas.) sew
uslac : usłać : (czas.) lie
uslonecznienie : usłonecznienie : (rzecz.) sunshine
usluchac : usłuchać : (czas.) listen | : (czas.) obey
usluga : usługa : (rzecz.) service
uslugiwac : usługiwać : (czas.) expect | : (czas.) serve | : (czas.) valet | : (czas.) wait
uslugobiorca : usługobiorca : (rzecz.) recipient
uslugodawca : usługodawca : (rzecz.) provider
usluznie : usłużnie : (przysł.) obligingly
usluznosc : usłużność : (rzecz.) complaisance
usluzny : usłużny : (przym.) accommodating | : (przym.) attentive | : (przym.) complaisant | : (przym.) ministerial | : (przym.) officious
uslyszec : usłyszeć : (czas.) hear
utaic : utaić : (czas.) conceal | : (czas.) suppress
utajac : utajać : (czas.) conceal
utajenie : utajenie : (rzecz.) latency
utajnianie : utajnianie : (rzecz.) encryption
utajniac : utajniać : (czas.) encrypt
utajony : utajony : (przym.) latent
utalentowany : utalentowany : (przym.) accomplished | : (przym.) gifted | : (przym.) talented
utapirowac : utapirować : (czas.) backcomb | : (czas.) back-comb
utarczka : utarczka : (rzecz.) brush | : (rzecz.) melee | : (rzecz.) skirmish | : (rzecz.) squabble
utarg : utarg : (rzecz.) taking | : (rzecz.) takings
utargowac : utargować : (czas.) gain
utemperowac : utemperować : (czas.) chasten | : (czas.) curb
utensylia : utensylia : (rzecz.) utensils
utkac : utkać : (czas.) intertwine | : (czas.) unwoven
utknac : utknąć : (czas.) stall | : (czas.) stop
utkwic : utkwić : (czas.) balk | : (czas.) fix | : (czas.) inhere | : (czas.) rivet | : (czas.) stick
utleniacz : utleniacz : (rzecz.) oxidant | : (rzecz.) oxidiser | : (rzecz.) oxidizer
utlenianie : utlenianie : (rzecz.) oxidation | : (rzecz.) oxygenation
utleniac : utleniać : (czas.) oxidize | : (czas.) oxygenate | : (czas.) ventilate
utlenienie : utlenienie : (rzecz.) oxidation | : (rzecz.) oxygenation
utlenic : utlenić : (czas.) oxygenize
utonac : utonąć : (czas.) drown | : (czas.) sink
utopia : utopia : (rzecz.) utopia
utopista : utopista : (rzecz.) utopian
utopic : utopić : (czas.) drown | : (czas.) melt
utorowac : utorować : (czas.) pave
utozsamianie : utożsamianie : (rzecz.) aliasing | : (rzecz.) identification
utozsamiac : utożsamiać : (czas.) confused | : (czas.) identify
utozsamienie : utożsamienie : (rzecz.) identification
utozsamic : utożsamić : (czas.) identify
utracenie : utracenie : (rzecz.) losing
utracic : utracić : (czas.) loose
utracjusz : utracjusz : (rzecz.) prodigal | : (rzecz.) spender | : (rzecz.) spendthrift
utracony : utracony : (przym.) lost
utrapienie : utrapienie : (rzecz.) nuisance | : (rzecz.) peeve | : (rzecz.) plague | : (rzecz.) trouble | : (rzecz.) vexation
utrata : utrata : (rzecz.) deprivation | : (rzecz.) drop | : (rzecz.) forfeiture | : (rzecz.) loss | : (rzecz.) privation
utrudnianie : utrudnianie : (rzecz.) hindrance | : (rzecz.) obstruction
utrudniac : utrudniać : (czas.) aggravate | : (czas.) encumber | : (czas.) hamper | : (czas.) impede | : (czas.) obstruct | : (czas.) stymie
utrudnienie : utrudnienie : (rzecz.) aggravation | : (rzecz.) bind | : (rzecz.) difficulty | : (rzecz.) encumbrance | : (rzecz.) handicap | : (rzecz.) hindrance | : (rzecz.) impediment
utrudnic : utrudnić : (czas.) aggravate | : (czas.) obstruct
utrudzenie : utrudzenie : (rzecz.) fatigue
utrwalacz : utrwalacz : (rzecz.) fixative | : (rzecz.) fixer
utrwalanie : utrwalanie : (rzecz.) recording
utrwalac : utrwalać : (czas.) entrench | : (czas.) fix | : (czas.) preserve | : (czas.) solidify | : (czas.) strengthen
utrwalenie : utrwalenie : (rzecz.) consolidation | : (rzecz.) fixation | : (rzecz.) refresher
utrwalic : utrwalić : (czas.) entrench | : (czas.) fix
utrwalony : utrwalony : (przym.) fixed
utrzymanie : utrzymanie : (rzecz.) aliment | : (rzecz.) bread | : (rzecz.) keep | : (rzecz.) keeping | : (rzecz.) livelihood | : (rzecz.) living | : (rzecz.) maintenance | : (rzecz.) subsistence | : (rzecz.) sustenance | : (rzecz.) upkeep
utrzymac : utrzymać : (czas.) maintain | : (czas.) retain
utrzymywanie : utrzymywanie : (rzecz.) maintenance | : (rzecz.) support
utrzymywac : utrzymywać : (czas.) affirm | : (czas.) allege | : (czas.) continue | : (czas.) detain | : (czas.) earn | : (czas.) entertain | : (czas.) keep | : (czas.) maintain | : (czas.) obtain | : (czas.) persist | : (czas.) retain | : (czas.) support | : (czas.) sustain
utracic : utrącić : (czas.) abate | : (czas.) overthrow
utuczyc : utuczyć : (czas.) fatten
utulic : utulić : (czas.) comfort | : (czas.) console | : (czas.) nestle
utwardzacz : utwardzacz : (rzecz.) hardener
utwardzanie : utwardzanie : (rzecz.) cure | : (rzecz.) curing | : (rzecz.) hardening
utwardzac : utwardzać : (czas.) harden | : (czas.) indurate | : (czas.) stiffen | : (czas.) toughen
utwardzenie : utwardzenie : (rzecz.) hardening
utwardzic : utwardzić : (czas.) toughen
utwierdzanie : utwierdzanie : (rzecz.) fastening
utwierdzac : utwierdzać : (czas.) cement | : (czas.) confirm | : (czas.) consolidate | : (czas.) reassure | : (czas.) restrain | : (czas.) steady | : (czas.) vindicate
utwierdzenie : utwierdzenie : (rzecz.) anchoring | : (rzecz.) restraint
utwierdzic : utwierdzić : (czas.) assert | : (czas.) reassure | : (czas.) steady
utworzenie : utworzenie : (rzecz.) creation | : (rzecz.) rise
utworzyc : utworzyć : (czas.) compose | : (czas.) constitute | : (czas.) create | : (czas.) develop
utwor : utwór : (rzecz.) composition | : (rzecz.) poem | : (rzecz.) track | : (rzecz.) work
utykanie : utykanie : (rzecz.) halt | : (rzecz.) hobble
utykac : utykać : (czas.) hobble | : (czas.) limp | : (czas.) tamp
utylitarnosc : utylitarność : (rzecz.) utilitarianism
utylitarny : utylitarny : (przym.) useful | : (przym.) utilitarian
utylitarysta : utylitarysta : (rzecz.) utilitarian
utylitarystyczny : utylitarystyczny : (przym.) utilitarian
utylitaryzm : utylitaryzm : (rzecz.) utilitarianism
utylizacja : utylizacja : (rzecz.) disposal | : (rzecz.) utilisation | : (rzecz.) utilization
utylizowanie : utylizowanie : (rzecz.) disposal
utylizowac : utylizować : (czas.) disposed | : (czas.) utilize
utyskiwanie : utyskiwanie : (rzecz.) complaints
utyskiwac : utyskiwać : (czas.) grumble | : (czas.) scold
utytlac : utytłać : (czas.) smear
utyc : utyć : (czas.) fatten
uwadniac : uwadniać : (czas.) hydrate
uwaga : uwaga : (rzecz.) annotation | : (rzecz.) application | : (rzecz.) attendance | : (rzecz.) attention | : (rzecz.) caution | : (rzecz.) cautiousness | : (rzecz.) comment | : (rzecz.) consideration | : (rzecz.) heed | : (rzecz.) note | : (rzecz.) notice | : (rzecz.) observation | : (rzecz.) oyez | : (rzecz.) reflection | : (rzecz.) regard | : (rzecz.) remark
uwalac : uwalać : (czas.) dirty
uwalniac : uwalniać : (czas.) absolve | : (czas.) acquit | : (czas.) affranchise | : (czas.) assoil | : (czas.) disencumber | : (czas.) disengage | : (czas.) divest | : (czas.) enfranchise | : (czas.) exempt | : (czas.) free | : (czas.) justify | : (czas.) liberate | : (czas.) loosen | : (czas.) redeem | : (czas.) release | : (czas.) rid | : (czas.) shelve | : (czas.) unchain | : (czas.) unleash | : (czas.) unshackle
uwarstwienia : uwarstwienia : (rzecz.) stratification
uwarstwienie : uwarstwienie : (rzecz.) lamination | : (rzecz.) stratification
uwarunkowanie : uwarunkowanie : (rzecz.) conditionality | : (rzecz.) conditioning
uwarunkowany : uwarunkowany : (przym.) provisory
uwalowac : uwałować : (czas.) roll
uwazanie : uważanie : (rzecz.) treatment
uwazac : uważać : (czas.) account | : (czas.) believe | : (czas.) count | : (czas.) deem | : (czas.) heed | : (czas.) judge | : (czas.) mind | : (czas.) overlook | : (czas.) reckon | : (czas.) repute | : (czas.) think | : (czas.) treat | : (czas.) watch
uwaznie : uważnie : (przysł.) attentively | : (przysł.) carefully | : (przysł.) closely | : (przysł.) intently | : (przysł.) studiously
uwazny : uważny : (przym.) attentive | : (przym.) careful | : (przym.) cautious | : (przym.) chary | : (przym.) considerate | : (przym.) heedful | : (przym.) intent | : (przym.) mindful | : (przym.) observant | : (przym.) particular | : (przym.) watchful
uwertura : uwertura : (rzecz.) overtone | : (rzecz.) overture
uwiarygodniac : uwiarygodniać : (czas.) authenticate
uwiarygodnic : uwiarygodnić : (czas.) authenticate
uwidaczniac : uwidaczniać : (czas.) demonstrate | : (czas.) show
uwidocznienie : uwidocznienie : (rzecz.) visibility | : (rzecz.) visualization
uwidocznic : uwidocznić : (czas.) show
uwiecznianie : uwiecznianie : (rzecz.) immortalise | : (rzecz.) immortalization
uwieczniac : uwieczniać : (czas.) immortalize | : (czas.) perpetuate | : (czas.) record
uwiecznienie : uwiecznienie : (rzecz.) immortalization | : (rzecz.) perpetuation
uwiecznic : uwiecznić : (czas.) eternize
uwiedzenie : uwiedzenie : (rzecz.) seduction
uwielbiac : uwielbiać : (czas.) admire | : (czas.) adore | : (czas.) idolize | : (czas.) love | : (czas.) worship
uwielbienie : uwielbienie : (rzecz.) adoration | : (rzecz.) reverence | : (rzecz.) worshipfulness
uwielbic : uwielbić : (czas.) praise
uwielokrotniac : uwielokrotniać : (czas.) multiply
uwierac : uwierać : (czas.) rub
uwierzytelniac : uwierzytelniać : (czas.) authenticate
uwierzytelnienie : uwierzytelnienie : (rzecz.) accreditation | : (rzecz.) authentication | : (rzecz.) certification | : (rzecz.) credential
uwierzytelnic : uwierzytelnić : (czas.) authenticate
uwierzyc : uwierzyć : (czas.) believe
uwienczenie : uwieńczenie : (rzecz.) consummation
uwienczyc : uwieńczyć : (czas.) consummate | : (czas.) crown
uwiesc : uwieść : (czas.) seduce | : (czas.) seduced
uwijanie : uwijanie : (rzecz.) bustling
uwijac : uwijać : (czas.) spin
uwiklanie : uwikłanie : (rzecz.) entanglement | : (rzecz.) implication | : (rzecz.) involvement
uwiklac : uwikłać : (czas.) embroil | : (czas.) entangle | : (czas.) evade | : (czas.) involve | : (czas.) mesh | : (czas.) noose
uwiad : uwiąd : (rzecz.) decay | : (rzecz.) decrepitude
uwiazanie : uwiązanie : (rzecz.) affection | : (rzecz.) attachment
uwiazac : uwiązać : (czas.) tie
uwiednac : uwiędnąć : (czas.) wither
uwiezienie : uwięzienie : (rzecz.) confinement | : (rzecz.) detention | : (rzecz.) durance | : (rzecz.) imprisonment
uwieziony : uwięziony : (przym.) captive
uwiezic : uwięzić : (czas.) confine | : (czas.) gaol | : (czas.) immure | : (czas.) imprison | : (czas.) incarcerate | : (czas.) jail
uwiez : uwięź : (rzecz.) tether
uwiezniecie : uwięźnięcie : (rzecz.) incarceration
uwodnienie : uwodnienie : (rzecz.) hydration
uwodniony : uwodniony : (przym.) hydrated
uwodornianie : uwodornianie : (rzecz.) hydrogenation | : (rzecz.) hydrogenize
uwodorniac : uwodorniać : (czas.) hydrogenate
uwodornienie : uwodornienie : (rzecz.) hydrogenize
uwodzenie : uwodzenie : (rzecz.) seduction
uwodziciel : uwodziciel : (rzecz.) charmer | : (rzecz.) seducer
uwodzicielski : uwodzicielski : (przym.) alluring | : (przym.) seductive
uwodzicielsko : uwodzicielsko : (przysł.) seductively
uwodzic : uwodzić : (czas.) abduct | : (czas.) allure | : (czas.) cajole | : (czas.) entice | : (czas.) inveigle | : (czas.) rape | : (czas.) ravish | : (czas.) seduce | : (czas.) woo
uwolnienie : uwolnienie : (rzecz.) disengagement | : (rzecz.) exemption | : (rzecz.) exoneration | : (rzecz.) liberation | : (rzecz.) quittance | : (rzecz.) redemption | : (rzecz.) release | : (rzecz.) riddance
uwolnic : uwolnić : (czas.) absolve | : (czas.) acquit | : (czas.) disencumber | : (czas.) disengage | : (czas.) enfranchise | : (czas.) exempt | : (czas.) free | : (czas.) justify | : (czas.) liberate | : (czas.) loosen | : (czas.) redeem | : (czas.) release | : (czas.) rid | : (czas.) shelve | : (czas.) unchain | : (czas.) unclasp
uwrazliwiac : uwrażliwiać : (czas.) sensitize
uwrazliwic : uwrażliwić : (czas.) sensitize
uwularny : uwularny : (przym.) uvular
uwydatnianie : uwydatnianie : (rzecz.) emphasis | : (rzecz.) emphasising
uwydatniac : uwydatniać : (czas.) accentuate | : (czas.) emphasise | : (czas.) enhance | : (czas.) feature | : (czas.) highlight
uwydatnienie : uwydatnienie : (rzecz.) enhancement | : (rzecz.) prominence
uwydatnic : uwydatnić : (czas.) accentuate | : (czas.) enhance | : (czas.) feature | : (czas.) highlight
uwypuklac : uwypuklać : (czas.) accentuate | : (czas.) emboss | : (czas.) emphasise | : (czas.) emphasize | : (czas.) enhance | : (czas.) feature | : (czas.) highlight
uwypuklenie : uwypuklenie : (rzecz.) emphasis | : (rzecz.) emphasising
uwypuklic : uwypuklić : (czas.) emboss | : (czas.) enhance | : (czas.) feature | : (czas.) highlight
uwzgledniac : uwzględniać : (czas.) account | : (czas.) allow | : (czas.) embody
uwzglednic : uwzględnić : (czas.) include
uwznioslac : uwznioślać : (czas.) idealize
uwedzic : uwędzić : (czas.) bloat
uwlaczac : uwłaczać : (czas.) belittle | : (czas.) defame | : (czas.) derogate | : (czas.) insult | : (czas.) outrage
uwlaszczac : uwłaszczać : (czas.) enfranchise
uwlaszczenie : uwłaszczenie : (rzecz.) enfranchisement
uwlosienie : uwłosienie : (rzecz.) pelage
uzaleznianie : uzależnianie : (rzecz.) addicting | : (rzecz.) making
uzalezniac : uzależniać : (czas.) make | : (czas.) necessitate
uzaleznienie : uzależnienie : (rzecz.) addiction | : (rzecz.) dependence | : (rzecz.) dependency
uzaleznic : uzależnić : (czas.) subject
uzasadniac : uzasadniać : (czas.) excuse | : (czas.) found | : (czas.) guarantee | : (czas.) justify | : (czas.) legitimize | : (czas.) substantiate
uzasadnienie : uzasadnienie : (rzecz.) justification | : (rzecz.) reason
uzasadnic : uzasadnić : (czas.) justify | : (czas.) substantiate
uzbierac : uzbierać : (czas.) donated
uzbrajanie : uzbrajanie : (rzecz.) arming
uzbrajac : uzbrajać : (czas.) arm | : (czas.) prime
uzbroic : uzbroić : (czas.) arm
uzbrojenie : uzbrojenie : (rzecz.) actuation | : (rzecz.) armament | : (rzecz.) armature | : (rzecz.) arming | : (rzecz.) arms | : (rzecz.) equipment | : (rzecz.) ordnance
uzda : uzda : (rzecz.) bridle | : (rzecz.) curb
uzdalniac : uzdalniać : (czas.) enable
uzdatniac : uzdatniać : (czas.) debug
uzdatnic : uzdatnić : (czas.) treated
uzdolnienie : uzdolnienie : (rzecz.) abilities | : (rzecz.) accomplishment | : (rzecz.) aptitude | : (rzecz.) aptness | : (rzecz.) faculty | : (rzecz.) gift | : (rzecz.) proclivity | : (rzecz.) talent
uzdolnic : uzdolnić : (czas.) enable | : (czas.) qualify
uzdrawiacz : uzdrawiacz : (rzecz.) healer
uzdrawianie : uzdrawianie : (rzecz.) healing
uzdrawiac : uzdrawiać : (czas.) cure | : (czas.) heal
uzdrowiciel : uzdrowiciel : (rzecz.) healer
uzdrowienie : uzdrowienie : (rzecz.) healing
uzdrowisko : uzdrowisko : (rzecz.) sanatorium | : (rzecz.) spa
uzdrowic : uzdrowić : (czas.) heal
uzewnetrznic : uzewnętrznić : (czas.) externalise
uzgadnianie : uzgadnianie : (rzecz.) co-ordinating | : (rzecz.) handshaking | : (rzecz.) transfer
uzgadniac : uzgadniać : (czas.) accord | : (czas.) agree | : (czas.) negotiate | : (czas.) reconcile
uzgodnienie : uzgodnienie : (rzecz.) accord | : (rzecz.) adjustment | : (rzecz.) agreement | : (rzecz.) co-ordination | : (rzecz.) handshake | : (rzecz.) reconciliation | : (rzecz.) stipulation
uzgodniony : uzgodniony : (przym.) agreed-upon
uzgodnic : uzgodnić : (czas.) agree | : (czas.) reconcile
uziemianie : uziemianie : (rzecz.) grounding
uziemiac : uziemiać : (czas.) earth
uziemienie : uziemienie : (rzecz.) earth | : (rzecz.) ground
uziemic : uziemić : (czas.) ground
uziom : uziom : (rzecz.) earth
uzmyslawiac : uzmysławiać : (czas.) visualize
uzmyslowic : uzmysłowić : (czas.) illustrate | : (czas.) visualize
uznanie : uznanie : (rzecz.) acclaim | : (rzecz.) accolade | : (rzecz.) acknowledgement | : (rzecz.) acknowledgment | : (rzecz.) allowance | : (rzecz.) appreciation | : (rzecz.) approbation | : (rzecz.) approval | : (rzecz.) credit | : (rzecz.) discretion | : (rzecz.) recognition
uznaniowosc : uznaniowość : (rzecz.) discretion
uznany : uznany : (przym.) reputed
uznawanie : uznawanie : (rzecz.) acclaiming | : (rzecz.) recognition
uznawac : uznawać : (czas.) acknowledge | : (czas.) allow | : (czas.) approve | : (czas.) assent | : (czas.) receive | : (czas.) recognize
uznac : uznać : (czas.) acknowledge | : (czas.) allot | : (czas.) appreciate | : (czas.) considered | : (czas.) recognize
uzupelniajacy : uzupełniający : (przym.) complementary
uzupelnianie : uzupełnianie : (rzecz.) addition | : (rzecz.) complement | : (rzecz.) topping-up
uzupelniac : uzupełniać : (czas.) complement | : (czas.) complete | : (czas.) eke | : (czas.) elaborate | : (czas.) integrate | : (czas.) replenish | : (czas.) restock | : (czas.) supplement
uzupelnienie : uzupełnienie : (rzecz.) addendum | : (rzecz.) adjunct | : (rzecz.) appendage | : (rzecz.) appendix | : (rzecz.) attachment | : (rzecz.) complement | : (rzecz.) completion | : (rzecz.) integration | : (rzecz.) replenishment | : (rzecz.) supplement
uzupelnic : uzupełnić : (czas.) complement | : (czas.) complete | : (czas.) fill | : (czas.) integrate | : (czas.) restock | : (czas.) supplement
uzurpacja : uzurpacja : (rzecz.) usurpation
uzurpator : uzurpator : (rzecz.) usurper
uzurpowac : uzurpować : (czas.) usurp
uzysk : uzysk : (rzecz.) efficiency | : (rzecz.) output
uzyskanie : uzyskanie : (rzecz.) gain | : (rzecz.) obtainment
uzyskac : uzyskać : (czas.) acquire | : (czas.) attain | : (czas.) extract | : (czas.) gain | : (czas.) obtain | : (czas.) qualify
uzyskiwanie : uzyskiwanie : (rzecz.) gain | : (rzecz.) obtainment
uzyskiwac : uzyskiwać : (czas.) acquire | : (czas.) derive | : (czas.) gain | : (czas.) obtain
uzebienie : uzębienie : (rzecz.) dentition | : (rzecz.) teeth
ulagodzic : ułagodzić : (czas.) placate
ulamek : ułamek : (rzecz.) fractal | : (rzecz.) fraction | : (rzecz.) fragment | : (rzecz.) scrap | : (rzecz.) shiver
ulamkowy : ułamkowy : (przym.) fractional | : (przym.) fragmentary | : (przym.) horizontal
ulan : ułan : (rzecz.) lancer
ulaskawiac : ułaskawiać : (czas.) pardon
ulaskawienie : ułaskawienie : (rzecz.) clemency | : (rzecz.) pardon
ulaskawic : ułaskawić : (czas.) patronize
ulatwiac : ułatwiać : (czas.) ease | : (czas.) expose | : (czas.) facilitate | : (czas.) simplify | : (czas.) streamline
ulatwienie : ułatwienie : (rzecz.) facilitation | : (rzecz.) facility
ulatwic : ułatwić : (czas.) facilitate | : (czas.) help | : (czas.) streamline
ulomnie : ułomnie : (przysł.) defectively
ulomnosc : ułomność : (rzecz.) disability | : (rzecz.) flaw | : (rzecz.) frailty | : (rzecz.) handicap | : (rzecz.) infirmity | : (rzecz.) lameness | : (rzecz.) vice
ulomny : ułomny : (przym.) cripple | : (przym.) defective | : (przym.) disabled | : (przym.) handicapped | : (przym.) invalid | : (przym.) lame
ulozenie : ułożenie : (rzecz.) arrangement | : (rzecz.) position | : (rzecz.) selling
ulozyc : ułożyć : (czas.) arrange | : (czas.) sort | : (czas.) stack | : (czas.) transact
uluda : ułuda : (rzecz.) delusion | : (rzecz.) illusion | : (rzecz.) phantom
uludny : ułudny : (przym.) delusory
uscisk : uścisk : (rzecz.) clutch | : (rzecz.) embrace | : (rzecz.) grasp | : (rzecz.) grip | : (rzecz.) handshake | : (rzecz.) hug | : (rzecz.) squeeze
usciskac : uściskać : (czas.) clamp | : (czas.) clasp | : (czas.) embrace | : (czas.) hug
uscislanie : uściślanie : (rzecz.) clarification | : (rzecz.) reification
uscislac : uściślać : (czas.) qualify | : (czas.) specify
uscislenie : uściślenie : (rzecz.) clarification | : (rzecz.) refinement
uscislic : uściślić : (czas.) refine
uscisniecie : uściśnięcie : (rzecz.) squeeze
usmiac : uśmiać : (czas.) laugh
usmiech : uśmiech : (rzecz.) grin | : (rzecz.) smile
usmiechac : uśmiechać : (czas.) beam | : (czas.) grin | : (czas.) smile
usmiercac : uśmiercać : (czas.) destroy | : (czas.) kill | : (czas.) slay
usmiercic : uśmiercić : (czas.) killed
usmierzac : uśmierzać : (czas.) allay | : (czas.) assuage | : (czas.) extinguish | : (czas.) kill | : (czas.) lull | : (czas.) mitigate | : (czas.) quell | : (czas.) relieve | : (czas.) soothe
usmierzenie : uśmierzenie : (rzecz.) assuagement
usmierzyc : uśmierzyć : (czas.) allay | : (czas.) appease | : (czas.) heal | : (czas.) palliate | : (czas.) soothe
uspienie : uśpienie : (rzecz.) hibernation | : (rzecz.) narcosis | : (rzecz.) sleep
uspic : uśpić : (czas.) anaesthetize | : (czas.) snooze
usredniac : uśredniać : (czas.) average
usredniony : uśredniony : (przym.) averaging
usrednic : uśrednić : (czas.) averaged
uswiadamiac : uświadamiać : (czas.) awake | : (czas.) educate | : (czas.) enlighten | : (czas.) imagine | : (czas.) impress | : (czas.) realize | : (czas.) visualize
uswiadomienie : uświadomienie : (rzecz.) awareness | : (rzecz.) consciousness | : (rzecz.) information | : (rzecz.) realization
uswiadomic : uświadomić : (czas.) awake | : (czas.) enlighten | : (czas.) imagine | : (czas.) impress | : (czas.) visualize
uswietniac : uświetniać : (czas.) signalize
uswietnienie : uświetnienie : (rzecz.) make
uswietnic : uświetnić : (czas.) celebrate | : (czas.) signalize
uswinic : uświnić : (czas.) dirty
uswiecac : uświęcać : (czas.) hallow | : (czas.) sanctify
uswiecenie : uświęcenie : (rzecz.) sanctification
uswiecic : uświęcić : (czas.) sanctify
uzdzienica : uździenica : (rzecz.) halter
uzalac : użalać : (czas.) bewail
uzebrowanie : użebrowanie : (rzecz.) ribbing
uzebrowany : użebrowany : (przym.) filmed
uzerac : użerać : (czas.) squabble | : (czas.) wrangle
uzycie : użycie : (rzecz.) appliance | : (rzecz.) application | : (rzecz.) consumption | : (rzecz.) employment | : (rzecz.) exercise | : (rzecz.) usage | : (rzecz.) use
uzyczac : użyczać : (czas.) grant | : (czas.) lend | : (czas.) vest
uzyczyc : użyczyć : (czas.) afford | : (czas.) bestow | : (czas.) impart | : (czas.) spare
uzytecznie : użytecznie : (przysł.) helpfully | : (przysł.) usefully
uzytecznosc : użyteczność : (rzecz.) helpfulness | : (rzecz.) usability | : (rzecz.) usefulness | : (rzecz.) utility
uzyteczny : użyteczny : (przym.) employable | : (przym.) helpful | : (przym.) serviceable | : (przym.) usable | : (przym.) useful | : (przym.) utilitarian | : (przym.) viewable
uzytek : użytek : (rzecz.) employ | : (rzecz.) use
uzytkowanie : użytkowanie : (rzecz.) operation | : (rzecz.) usage | : (rzecz.) use | : (rzecz.) utilization
uzytkowac : użytkować : (czas.) use | : (czas.) utilize
uzytkownik : użytkownik : (rzecz.) occupant | : (rzecz.) occupier | : (rzecz.) resident | : (rzecz.) user
uzytkowosc : użytkowość : (rzecz.) usefulness
uzytkowy : użytkowy : (przym.) applied | : (przym.) utilitarian
uzywalnosc : używalność : (rzecz.) reusability | : (rzecz.) usability
uzywalny : używalny : (przym.) usable
uzywanie : używanie : (rzecz.) use
uzywany : używany : (przym.) second-hand
uzywac : używać : (czas.) apply | : (czas.) employ | : (czas.) enjoy | : (czas.) exercise | : (czas.) exert | : (czas.) use
uzywka : używka : (rzecz.) stimulant
uzywki : używki : (rzecz.) stimulants
uzyc : użyć : (czas.) use
uzyznianie : użyźnianie : (rzecz.) fertilization
uzyzniac : użyźniać : (czas.) enrich | : (czas.) fatten | : (czas.) fertilise | : (czas.) fertilize
uzyznienie : użyźnienie : (rzecz.) fertilization
uzadlenie : użądlenie : (rzecz.) sting
uzadlic : użądlić : (czas.) sting
