quinquevalvular : (a.) Having five valves, as a pericarp.
quarantining : (p. pr. & vb. n.) of Quarantine
quaquaversal : (a.) Turning or dipping in any or every direction. | : (a.) Dipping toward all points of the compass round a center, as beds of lava round a crater.
quidnunc : (n.) One who is curious to know everything that passes; one who knows, or pretends to know, all that is going on.
quinidine : (n.) An alkaloid isomeric with, and resembling, quinine, found in certain species of cinchona, from which it is extracted as a bitter white crystalline substance; conchinine. It is used somewhat as a febrifuge.
quinoidine : (n.) A brownish resinous substance obtained as a by-product in the treatment of cinchona bark. It consists of a mixture of several alkaloids.
quadrumane : (n.) One of the Quadrumana.
quanta : (pl. ) of Quantum
quadrumana : (n. pl.) A division of the Primates comprising the apes and monkeys; -- so called because the hind foot is usually prehensile, and the great toe opposable somewhat like a thumb. Formerly the Quadrumana were considered an order distinct from the Bimana, which last included man alone.
quadrennium : (n.) A space or period of four years.
quicken tree : ( ) The European rowan tree; -- called also quickbeam, and quickenbeam. See Rowan tree.
quadrille : (n.) A dance having five figures, in common time, four couples of dancers being in each set. | : (n.) The appropriate music for a quadrille. | : (n.) A game played by four persons with forty cards, being the remainder of an ordinary pack after the tens, nines, and eights are discarded.
quoth : (v. t.) Said; spoke; uttered; -- used only in the first and third persons in the past tenses, and always followed by its nominative, the word or words said being the object; as, quoth I. quoth he.
quinquennial : (a.) Occurring once in five years, or at the end of every five years; also, lasting five years. A quinquennial event.
quote : (v. t.) To cite, as a passage from some author; to name, repeat, or adduce, as a passage from an author or speaker, by way of authority or illustration; as, to quote a passage from Homer. | : (v. t.) To cite a passage from; to name as the authority for a statement or an opinion; as, to quote Shakespeare. | : (v. t.) To name the current price of. | : (v. t.) To notice; to observe; to examine. | : (v. t.) To set down, as in writing. | : (n.) A note upon an author.
qualitative : (a.) Relating to quality; having the character of quality.
quadricorn : (n.) Any quadricornous animal.
quota : (n.) A proportional part or share; the share or proportion assigned to each in a division.
quadrifoil : (a.) Alt. of Quadrifoliate
quartane : (n.) Butane, each molecule of which has four carbon atoms.
quotum : (n.) Part or proportion; quota.
quercitannic : (a.) Pertaining to, or designating, a tannic acid found in oak bark and extracted as a yellowish brown amorphous substance.
quoifffure : (n.) See Coiffure.
quindecagon : (n.) A plane figure with fifteen angles, and consequently fifteen sides.
quitted : ( ) of Quit
quinquenerved : (a.) Having five nerves; -- said of a leaf with five nearly equal nerves or ribs rising from the end of the petiole.
quinizine : (n.) any one of a series of nitrogenous bases, certain of which are used as antipyretics.
quizzism : (n.) The act or habit of quizzing.
quavering : (p. pr. & vb. n.) of Quaver
quadruplicated : (imp. & p. p.) of Quadruplicate
quinquevir : (n.) One of five commissioners appointed for some special object.
quadrupling : (p. pr. & vb. n.) of Quadruple
quadragesimals : (n. pl.) Offerings formerly made to the mother church of a diocese on Mid-Lent Sunday.
quaternion : (n.) The number four. | : (n.) A set of four parts, things, or person; four things taken collectively; a group of four words, phrases, circumstances, facts, or the like. | : (n.) A word of four syllables; a quadrisyllable. | : (n.) The quotient of two vectors, or of two directed right lines in space, considered as depending on four geometrical elements, and as expressible by an algebraic symbol of quadrinomial form. | : (v. t.) To divide into quaternions, files, or companies.
quitter : (n.) One who quits. | : (n.) A deliverer.
quadrijugous : (a.) Pinnate, with four pairs of leaflets; as, a quadrijugous leaf.
quadroxide : (n.) A tetroxide.
quadrigae : (pl. ) of Quadriga
quiescing : (p. pr. & vb. n.) of Quiesce
quinary : (a.) Consisting of five; arranged by fives.
quadrigeminal : (a.) Alt. of Quadrigeminous
quartered : (imp. & p. p.) of Quartter
quinone : (n.) A crystalline substance, C6H4O2 (called also benzoketone), first obtained by the oxidation of quinic acid and regarded as a double ketone; also, by extension, any one of the series of which quinone proper is the type.
quartermaster : (n.) An officer whose duty is to provide quarters, provisions, storage, clothing, fuel, stationery, and transportation for a regiment or other body of troops, and superintend the supplies. | : (n.) A petty officer who attends to the helm, binnacle, signals, and the like, under the direction of the master.
quittuple-nerved : (a.) Alt. of Quintuple-ribbed
quinze : (n.) A game at cards in which the object is to make fifteen points.
quave : (n.) See Quaver. | : (v. i.) To quaver.
quelquechose : (n.) A trifle; a kickshaw.
quinquefid : (a.) Sharply cut about halfway to the middle or base into five segments; as, a quinquefid leaf or corolla.
queintise : (n.) See Quaintise.
quicksilvering : (n.) The mercury and foil on the back of a looking-glass.
quinquefoliate : (a.) Alt. of Quinquefoliated
queest : (n.) The European ringdove (Columba palumbus); the cushat.
quietsome : (a.) Calm; still.
quickness : (n.) The condition or quality of being quick or living; life. | : (n.) Activity; briskness; especially, rapidity of motion; speed; celerity; as, quickness of wit. | : (n.) Acuteness of perception; keen sensibility. | : (n.) Sharpness; pungency of taste.
quiet : (a.) In a state of rest or calm; without stir, motion, or agitation; still; as, a quiet sea; quiet air. | : (a.) Free from noise or disturbance; hushed; still. | : (a.) Not excited or anxious; calm; peaceful; placid; settled; as, a quiet life; a quiet conscience. | : (a.) Not giving offense; not exciting disorder or trouble; not turbulent; gentle; mild; meek; contented. | : (a.) Not showy; not such as to attract attention; undemonstrative; as, a quiet dress; quiet colors; a quiet movement. | : (a.) The quality or state of being quiet, or in repose; as an hour or a time of quiet. | : (a.) Freedom from disturbance, noise, or alarm; stillness; tranquillity; peace; security. | : (v. t.) To stop motion in; to still; to reduce to a state of rest, or of silence. | : (v. t.) To calm; to appease; to pacify; to lull; to allay; to tranquillize; as, to quiet the passions; to quiet clamors or disorders; to quiet pain or grief. | : (v. i.) To become still, silent, or calm; -- often with down; as, be soon quieted down.
queried : (imp. & p. p.) of Query
quinquennalia : (n. pl.) Public games celebrated every five years.
quaigh : (n.) Alt. of Quaich
quartzite : (n.) Massive quartz occurring as a rock; a metamorphosed sandstone; -- called also quartz rock.
quadrennially : (adv.) Once in four years.
queendom : (n.) The dominion, condition, or character of a queen.
quercitin : (n.) A yellow crystalline substance, occurring quite widely distributed in the vegetable kingdom, as is apple-tree bark, horse-chestnut leaves, etc., but originally obtained by the decomposition of quercitrin. Called also meletin.
quarrying : (p. pr. & vb. n.) of Quarry
quibbling : (p. pr. & vb. n.) of Quibble
quadratojugal : (a.) Of or pertaining to the quadrate and jugal bones. | : (a.) Of or pertaining to the quadratojugal bone. | : (n.) The quadratojugal bone.
quarries : (pl. ) of Quarry
quarrier : (n.) A worker in a stone quarry.
quinqueviri : (pl. ) of Quinquevir
questmonger : (n.) One who lays informations, and encourages petty lawsuits.
quinquevirs : (pl. ) of Quinquevir
quirite : (n.) One of the Quirites.
qualitied : (a.) Furnished with qualities; endowed.
quicken : (a.) To make alive; to vivify; to revive or resuscitate, as from death or an inanimate state; hence, to excite; to, stimulate; to incite. | : (a.) To make lively, active, or sprightly; to impart additional energy to; to stimulate; to make quick or rapid; to hasten; to accelerate; as, to quicken one's steps or thoughts; to quicken one's departure or speed. | : (a.) To shorten the radius of (a curve); to make (a curve) sharper; as, to quicken the sheer, that is, to make its curve more pronounced. | : (v. i.) To come to life; to become alive; to become vivified or enlivened; hence, to exhibit signs of life; to move, as the fetus in the womb. | : (v. i.) To move with rapidity or activity; to become accelerated; as, his pulse quickened.
querying : (p. pr. & vb. n.) of Query
queries : (pl. ) of Query
q : ( ) the seventeenth letter of the English alphabet, has but one sound (that of k), and is always followed by u, the two letters together being sounded like kw, except in some words in which the u is silent. Q is not found in Anglo-Saxon, cw being used instead of qu; as in cwic, quick; cwen, queen. The name (k/) is from the French ku, which is from the Latin name of the same letter; its form is from the Latin, which derived it, through a Greek alphabet, from the Phenician, the ultimate origin being Egyptian.
quadrinomial : (n.) A polynomial of four terms connected by the signs plus or minus.
quaffing : (p. pr. & vb. n.) of Quaff
quarried : (a.) Provided with prey. | : (imp. & p. p.) of Quarry
quadroon : (n.) The offspring of a mulatto and a white person; a person quarter-blooded.
qualities : (pl. ) of Quality
quarantine : (n.) A space of forty days; -- used of Lent. | : (n.) Specifically, the term, originally of forty days, during which a ship arriving in port, and suspected of being infected a malignant contagious disease, is obliged to forbear all intercourse with the shore; hence, such restraint or inhibition of intercourse; also, the place where infected or prohibited vessels are stationed. | : (n.) The period of forty days during which the widow had the privilege of remaining in the mansion house of which her husband died seized. | : (v. t.) To compel to remain at a distance, or in a given place, without intercourse, when suspected of having contagious disease; to put under, or in, quarantine.
quotable : (a.) Capable or worthy of being quoted; as, a quotable writer; a quotable sentence.
quadrate : (a.) Having four equal sides, the opposite sides parallel, and four right angles; square. | : (a.) Produced by multiplying a number by itself; square. | : (a.) Square; even; balanced; equal; exact. | : (a.) Squared; suited; correspondent. | : (a.) A plane surface with four equal sides and four right angles; a square; hence, figuratively, anything having the outline of a square. | : (a.) An aspect of the heavenly bodies in which they are distant from each other 90!, or the quarter of a circle; quartile. See the Note under Aspect, 6. | : (a.) The quadrate bone. | : (a.) To square; to agree; to suit; to correspond; -- followed by with. | : (v. t.) To adjust (a gun) on its carriage; also, to train (a gun) for horizontal firing.
quannet : (n.) A flat file having the handle at one side, so as to be used like a plane.
quartet : (n.) Alt. of Quartette
quartziferous : (a.) Consisting chiefly of quartz; containing quartz.
quarter : (n.) One of four equal parts into which anything is divided, or is regarded as divided; a fourth part or portion; as, a quarter of a dollar, of a pound, of a yard, of an hour, etc. | : (n.) The fourth of a hundred-weight, being 25 or 28 pounds, according as the hundredweight is reckoned at 100 or 112 pounds. | : (n.) The fourth of a ton in weight, or eight bushels of grain; as, a quarter of wheat; also, the fourth part of a chaldron of coal. | : (n.) The fourth part of the moon's period, or monthly revolution; as, the first quarter after the change or full. | : (n.) One limb of a quadruped with the adjacent parts; one fourth part of the carcass of a slaughtered animal, including a leg; as, the fore quarters; the hind quarters. | : (n.) That part of a boot or shoe which forms the side, from the heel to the vamp. | : (n.) That part on either side of a horse's hoof between the toe and heel, being the side of the coffin. | : (n.) A term of study in a seminary, college, etc, etc.; properly, a fourth part of the year, but often longer or shorter. | : (n.) The encampment on one of the principal passages round a place besieged, to prevent relief and intercept convoys. | : (n.) The after-part of a vessel's side, generally corresponding in extent with the quarter-deck; also, the part of the yardarm outside of the slings. | : (n.) One of the divisions of an escutcheon when it is divided into four portions by a horizontal and a perpendicular line meeting in the fess point. | : (v. t.) A division of a town, city, or county; a particular district; a locality; as, the Latin quarter in Paris. | : (v. t.) A small upright timber post, used in partitions; -- in the United States more commonly called stud. | : (v. t.) The fourth part of the distance from one point of the compass to another, being the fourth part of 11! 15', that is, about 2! 49'; -- called also quarter point. | : (v. t.) Proper station; specific place; assigned position; special location. | : (v. t.) A station at which officers and men are posted in battle; -- usually in the plural. | : (v. t.) Place of lodging or temporary residence; shelter; entertainment; -- usually in the plural. | : (v. t.) A station or encampment occupied by troops; a place of lodging for soldiers or officers; as, winter quarters. | : (v. t.) Treatment shown by an enemy; mercy; especially, the act of sparing the life a conquered enemy; a refraining from pushing one's advantage to extremes. | : (v. t.) Friendship; amity; concord. | : (v. i.) To lodge; to have a temporary residence. | : (v. i.) To drive a carriage so as to prevent the wheels from going into the ruts, or so that a rut shall be between the wheels.
questuary : (a.) Studious of profit. | : (n.) One employed to collect profits.
quinqueliteral : (a.) Consisting of five letters.
queck : (v. i.) A word occurring in a corrupt passage of Bacon's Essays, and probably meaning, to stir, to move.
queensland nut : ( ) The nut of an Australian tree (Macadamia ternifolia). It is about an inch in diameter, and contains a single round edible seed, or sometimes two hemispherical seeds. So called from Queensland in Australia.
quack grass : ( ) See Quitch grass.
quantities : (pl. ) of Quantity
quech : (v. i.) Alt. of Queck
qualled : (imp. & p. p.) of Quail
quatch : (a.) Squat; flat.
quadruplication : (n.) The act of making fourfold; a taking four times the simple sum or amount.
quandaries : (pl. ) of Quandary
quindecemvirate : (n.) The body or office of the quindecemviri.
quarterage : (n.) A quarterly allowance.
quiescence : (n.) Alt. of Quiescency
quinazol : (n.) A complex nitrogenous base related to cinnoline.
queen truss : ( ) A truss framed with queen-posts; a queen-post truss.
quillaia bark : ( ) The bark of a rosaceous tree (Quillaja Saponaria), native of Chili. The bark is finely laminated, and very heavy with alkaline substances, and is used commonly by the Chilians instead of soap. Also called soap bark.
quietistic : (a.) Of or pertaining to the Quietists, or to Quietism.
quinquevalve : (a.) Alt. of Quinquevalvular
quickening : (p. pr. & vb. n.) of Quicken | : (n.) The act or process of making or of becoming quick. | : (n.) The first motion of the fetus in the womb felt by the mother, occurring usually about the middle of the term of pregnancy. It has been popularly supposed to be due to the fetus becoming possessed of independent life.
quitch grass : ( ) A perennial grass (Agropyrum repens) having long running rootstalks, by which it spreads rapidly and pertinaciously, and so becomes a troublesome weed. Also called couch grass, quick grass, quick grass, twitch grass. See Illustration in Appendix.
quindecemviri : (pl. ) of Quindecemvir
quincuncial : ( ) Having the form of a quincunx. | : ( ) Having the leaves of a pentamerous calyx or corolla so imbricated that two are exterior, two are interior, and the other has one edge exterior and one interior; as, quincuncial aestivation.
quorum : (n.) Such a number of the officers or members of any body as is competent by law or constitution to transact business; as, a quorum of the House of Representatives; a constitutional quorum was not present.
quadric : (a.) Of or pertaining to the second degree. | : (n.) A quantic of the second degree. See Quantic. | : (n.) A surface whose equation in three variables is of the second degree. Spheres, spheroids, ellipsoids, paraboloids, hyperboloids, also cones and cylinders with circular bases, are quadrics.
quininism : (n.) Alt. of Quinism
quinoline : (n.) A nitrogenous base, C9H7N obtained as a pungent colorless liquid by the distillation of alkaloids, bones, coal tar, etc. It the nucleus of many organic bodies, especially of certain alkaloids and related substances; hence, by extension, any one of the series of alkaloidal bases of which quinoline proper is the type.
quaily : (n.) The upland plover.
querry : (n.) A groom; an equerry.
quiescency : (n.) The state or quality of being quiescent.
quater-cousin : (n.) A cousin within the first four degrees of kindred.
quizzical : (a.) Relating to quizzing: given to quizzing; of the nature of a quiz; farcical; sportive.
quackish : (a.) Like a quack; boasting; characterized by quackery.
quotiety : (n.) The relation of an object to number.
quaver : (v. i.) To tremble; to vibrate; to shake. | : (v. i.) Especially, to shake the voice; to utter or form sound with rapid or tremulous vibrations, as in singing; also, to trill on a musical instrument | : (v. t.) To utter with quavers. | : (n.) A shake, or rapid and tremulous vibration, of the voice, or of an instrument of music. | : (n.) An eighth note. See Eighth.
quackism : (n.) Quackery.
querulential : (a.) Querulous.
quindecemvirs : (pl. ) of Quindecemvir
quadrin : (n.) A small piece of money, in value about a farthing, or a half cent.
quirpele : (n.) The Indian ferret.
quarterstaves : (pl. ) of Quarterstaff
quean : (n.) A woman; a young or unmarried woman; a girl. | : (n.) A low woman; a wench; a slut.
quercite : (n.) A white crystalline substance, C6H7(OH)5, found in acorns, the fruit of the oak (Quercus). It has a sweet taste, and is regarded as a pentacid alcohol.
quodlibetical : (a.) Not restricted to a particular subject; discussed for curiosity or entertainment.
quaggy : (a.) Of the nature of a quagmire; yielding or trembling under the foot, as soft, wet earth; spongy; boggy.
querimony : (n.) A complaint or complaining.
quoddies : (n. pl.) Herring taken and cured or smoked near Quoddy Head, Maine, or near the entrance of Passamaquoddy Ray.
quinquelobed : (a.) Same as Quinquelobate.
quagga : (n.) A South African wild ass (Equus, / Hippotigris, quagga). The upper parts are reddish brown, becoming paler behind and behind and beneath, with dark stripes on the face, neck, and fore part of the body.
quitting : (p. pr. & vb. n.) of Quit
qualificative : (n.) That which qualifies, modifies, or restricts; a qualifying term or statement.
quadri- : ( ) A combining form meaning four, four times, fourfold; as, quadricapsular, having four capsules.
quartern : (n.) A quarter. Specifically: (a) The fourth part of a pint; a gill. (b) The fourth part of a peck, or of a stone (14 ibs.). | : (n.) A loaf of bread weighing about four pounds; -- called also quartern loaf.
quemeful : (a.) Kindly; merciful.
querpo : (n.) The inner or body garments taken together. See Cuerpo.
quantitively : (adv.) So as to be measurable by quantity; quantitatively.
quayd : ( ) p. p. of Quail.
quatrefoil : (n.) Same as Quarterfoil.
-trixes : (pl. ) of Quadratrix
quarreling : (p. pr. & vb. n.) of Quarrel | : (a.) Engaged in a quarrel; apt or disposed to quarrel; as, quarreling factions; a quarreling mood.
quadratrix : (n.) A curve made use of in the quadrature of other curves; as the quadratrix, of Dinostratus, or of Tschirnhausen.
quinate : (n.) A salt of quinic acid.
quietus : (a.) Final discharge or acquittance, as from debt or obligation; that which silences claims; (Fig.) rest; death.
quaternity : (n.) The number four. | : (n.) The union of four in one, as of four persons; -- analogous to the theological term trinity.
quadrangular : (a.) Having four angles, and consequently four sides; tetragonal.
quindecone : (n.) An unsaturated hydrocarbon, C15H26, of the valylene series, produced artificially as an oily liquid.
quiddity : (n.) The essence, nature, or distinctive peculiarity, of a thing; that which answers the question, Quid est? or, What is it? | : (n.) A trifling nicety; a cavil; a quibble.
quayage : (n.) Wharfage.
quadripennate : (a.) Having four wings; -- said of insects.
quartan : (a.) Of or pertaining to the fourth; occurring every fourth day, reckoning inclusively; as, a quartan ague, or fever. | : (n.) An intermittent fever which returns every fourth day, reckoning inclusively, that is, one in which the interval between paroxysms is two days. | : (n.) A measure, the fourth part of some other measure.
qualified : (a.) Fitted by accomplishments or endowments. | : (a.) Modified; limited; as, a qualified statement. | : (imp. & p. p.) of Qualify
quiddle : (v. i.) To spend time in trifling employments, or to attend to useful subjects in an indifferent or superficial manner; to dawdle. | : (n.) Alt. of Quiddler
quaking : (p. pr. & vb. n.) of Quake | : ( ) a. & n. from Quake, v.
quadricornous : (a.) Having four horns, or hornlike organs; as, a quadricornous beetle.
quadricapsular : (a.) Having four capsules.
quaker : (n.) One who quakes. | : (n.) One of a religious sect founded by George Fox, of Leicestershire, England, about 1650, -- the members of which call themselves Friends. They were called Quakers, originally, in derision. See Friend, n., 4. | : (n.) The nankeen bird. | : (n.) The sooty albatross. | : (n.) Any grasshopper or locust of the genus (Edipoda; -- so called from the quaking noise made during flight.
queenfish : (n.) A California sciaenoid food fish (Seriphys politus). The back is bluish, and the sides and belly bright silvery. Called also kingfish.
quegh : (n.) A drinking vessel. See Quaich.
quick-scented : (a.) Acute of smell.
quran : (n.) See Koran.
quassin : (n.) The bitter principle of quassia, extracted as a white crystalline substance; -- formerly called quassite.
quinsy : (n.) An inflammation of the throat, or parts adjacent, especially of the fauces or tonsils, attended by considerable swelling, painful and impeded deglutition, and accompanied by inflammatory fever. It sometimes creates danger of suffocation; -- called also squinancy, and squinzey.
qualifiedness : (n.) The state of being qualified.
quartene : (n.) Same as Butylene.
quadrupedal : (a.) Having four feet; of or pertaining to a quadruped.
quaked : (imp. & p. p.) of Quake
quaverer : (n.) One who quavers; a warbler.
quadrantal : (a.) Of or pertaining to a quadrant; also, included in the fourth part of a circle; as, quadrantal space. | : (n.) A cubical vessel containing a Roman cubic foot, each side being a Roman square foot; -- used as a measure. | : (n.) A cube.
quadrature : (a.) The act of squaring; the finding of a square having the same area as some given curvilinear figure; as, the quadrature of a circle; the operation of finding an expression for the area of a figure bounded wholly or in part by a curved line, as by a curve, two ordinates, and the axis of abscissas. | : (a.) A quadrate; a square. | : (a.) The integral used in obtaining the area bounded by a curve; hence, the definite integral of the product of any function of one variable into the differential of that variable. | : (a.) The position of one heavenly body in respect to another when distant from it 90!, or a quarter of a circle, as the moon when at an equal distance from the points of conjunction and opposition.
quadriliteral : (a.) Consisting of four letters.
quint : (n.) A set or sequence of five, as in piquet. | : (n.) The interval of a fifth.
quenched : (imp. & p. p.) of Quench
quermonious : (a.) Complaining; querulous; apt to complain.
quilled : (imp. & p. p.) of Quill | : (a.) Furnished with quills; also, shaped like quills.
quadricipital : (n.) Of or pertaining to the quadriceps.
quinquefarious : (a.) Arranged in five vertical rows; pentastichous.
quencher : (n.) One who, or that which, quenches.
quarry : (n.) Same as 1st Quarrel. | : (a.) Quadrate; square. | : (n.) A part of the entrails of the beast taken, given to the hounds. | : (n.) A heap of game killed. | : (n.) The object of the chase; the animal hunted for; game; especially, the game hunted with hawks. | : (v. i.) To secure prey; to prey, as a vulture or harpy. | : (n.) A place, cavern, or pit where stone is taken from the rock or ledge, or dug from the earth, for building or other purposes; a stone pit. See 5th Mine (a). | : (v. t.) To dig or take from a quarry; as, to quarry marble.
quartos : (pl. ) of Quarto
quartzoid : (n.) A form of crystal common with quartz, consisting of two six-sided pyramids, base to base.
quintessence : (n.) The fifth or last and highest essence or power in a natural body. See Ferment oils, under Ferment. | : (n.) Hence: An extract from anything, containing its rarest virtue, or most subtle and essential constituent in a small quantity; pure or concentrated essence. | : (v. t.) To distil or extract as a quintessence; to reduce to a quintessence.
queenly : (a.) Like, becoming, or suitable to, a queen.
quinhydrone : (n.) A green crystalline substance formed by the union of quinone with hydroquinone, or as an intermediate product in the oxidation of hydroquinone or the reduction of quinone.
quadrivium : (n.) The four "liberal arts," arithmetic, music, geometry, and astronomy; -- so called by the schoolmen. See Trivium.
quadrifoliate : (a.) Four-leaved; having the leaves in whorls of four.
quillet : (n.) Subtilty; nicety; quibble.
qualifier : (n.) One who, or that which, qualifies; that which modifies, reduces, tempers or restrains.
quavered : (imp. & p. p.) of Quaver
queer : (a.) At variance with what is usual or normal; differing in some odd way from what is ordinary; odd; singular; strange; whimsical; as, a queer story or act. | : (a.) Mysterious; suspicious; questionable; as, a queer transaction. | : (n.) Counterfeit money.
quinquangular : (a.) Having five angles or corners.
quadriennial : (a.) Same as Quadrennial.
quirkish : (a.) Consisting of quirks; resembling a quirk.
queen : (n.) The wife of a king. | : (n.) A woman who is the sovereign of a kingdom; a female monarch; as, Elizabeth, queen of England; Mary, queen of Scots. | : (n.) A woman eminent in power or attractions; the highest of her kind; as, a queen in society; -- also used figuratively of cities, countries, etc. | : (n.) The fertile, or fully developed, female of social bees, ants, and termites. | : (n.) The most powerful, and except the king the most important, piece in a set of chessmen. | : (n.) A playing card bearing the picture of a queen; as, the queen of spades. | : (n.) A male homosexual, esp. one who is effeminate or dresses in women's clothing. | : (v. i.) To act the part of a queen. | : (v. i.) To make a queen (or other piece, at the player's discretion) of by moving it to the eighth row; as, to queen a pawn.
quietist : (n.) One of a sect of mystics originated in the seventeenth century by Molinos, a Spanish priest living in Rome. See Quietism.
quantivalence : (n.) Valence.
quilting : (p. pr. & vb. n.) of Quilt | : (n.) The act of stitching or running in patterns, as in making a quilt. | : (n.) A quilting bee. See Bee, 2. | : (n.) The material used for making quilts. | : (n.) A coating of strands of rope for a water vessel.
quizzing : (p. pr. & vb. n.) of Quiz
questor : (n.) An officer who had the management of the public treasure; a receiver of taxes, tribute, etc.; treasurer of state.
quarterly : (a.) Containing, or consisting of, a fourth part; as, quarterly seasons. | : (a.) Recurring during, or at the end of, each quarter; as, quarterly payments of rent; a quarterly meeting. | : (n.) A periodical work published once a quarter, or four times in a year. | : (adv.) By quarters; once in a quarter of a year; as, the returns are made quarterly. | : (adv.) In quarters, or quarterings; as, to bear arms quarterly; in four or more parts; -- said of a shield thus divided by lines drawn through it at right angles.
quindecylic : (n.) Pertaining to, or designating, an acid of the fatty acid series, containing fifteen atoms of carbon; called also pentadecylic acid.
queach : (n.) A thick, bushy plot; a thicket. | : (v. i.) To stir; to move. See Quick, v. i.
quinizarin : ( ) A yellow crystalline substance produced artificially. It is isomeric with alizarin.
quipus : (pl. ) of Quipu
quadrifurcated : (a.) Having four forks, or branches.
quaschi : (n.) Alt. of Quasje
quietism : (n.) Peace or tranquillity of mind; calmness; indifference; apathy; dispassion; indisturbance; inaction. | : (n.) The system of the Quietists, who maintained that religion consists in the withdrawal of the mind from worldly interests and anxieties and its constant employment in the passive contemplation of God and his attributes.
quadrilobed : (a.) Having four lobes; as, a quadrilobate leaf.
quar : (n.) A quarry.
quassia : (n.) The wood of several tropical American trees of the order Simarubeae, as Quassia amara, Picraena excelsa, and Simaruba amara. It is intensely bitter, and is used in medicine and sometimes as a substitute for hops in making beer.
quat : (n.) A pustule. | : (n.) An annoying, worthless person. | : (v. t.) To satiate; to satisfy.
quilt : (n.) Anything that is quilted; esp., a quilted bed cover, or a skirt worn by women; any cover or garment made by putting wool, cotton, etc., between two cloths and stitching them together; also, any outer bed cover. | : (v. t.) To stitch or sew together at frequent intervals, in order to confine in place the several layers of cloth and wadding of which a garment, comforter, etc., may be made; as, to quilt a coat. | : (v. t.) To wad, as a garment, with warm soft material. | : (v. t.) To stitch or sew in lines or patterns.
quas : (n.) A kind of beer. Same as Quass.
question : (n.) The act of asking; interrogation; inquiry; as, to examine by question and answer. | : (n.) Discussion; debate; hence, objection; dispute; doubt; as, the story is true beyond question; he obeyed without question. | : (n.) Examination with reference to a decisive result; investigation; specifically, a judicial or official investigation; also, examination under torture. | : (n.) That which is asked; inquiry; interrogatory; query. | : (n.) Hence, a subject of investigation, examination, or debate; theme of inquiry; matter to be inquired into; as, a delicate or doubtful question. | : (n.) Talk; conversation; speech; speech. | : (n.) To ask questions; to inquire. | : (n.) To argue; to converse; to dispute. | : (v. t.) To inquire of by asking questions; to examine by interrogatories; as, to question a witness. | : (v. t.) To doubt of; to be uncertain of; to query. | : (v. t.) To raise a question about; to call in question; to make objection to. | : (v. t.) To talk to; to converse with.
quap : (v. i.) To quaver.
quarter-deck : (n.) That part of the upper deck abaft the mainmast, including the poop deck when there is one.
quay : (n.) A mole, bank, or wharf, formed toward the sea, or at the side of a harbor, river, or other navigable water, for convenience in loading and unloading vessels. | : (v. t.) To furnish with quays.
quinquefoliated : (a.) Having five leaves or leaflets.
quitclaim : (n.) A release or relinquishment of a claim; a deed of release; an instrument by which some right, title, interest, or claim, which one person has, or is supposed to have, in or to an estate held by himself or another, is released or relinquished, the grantor generally covenanting only against persons who claim under himself. | : (v. t.) To release or relinquish a claim to; to release a claim to by deed, without covenants of warranty against adverse and paramount titles.
quill : (n.) One of the large feathers of a bird's wing, or one of the rectrices of the tail; also, the stock of such a feather. | : (n.) A pen for writing made by sharpening and splitting the point or nib of the stock of a feather; as, history is the proper subject of his quill. | : (n.) A spine of the hedgehog or porcupine. | : (n.) The pen of a squid. See Pen. | : (n.) The plectrum with which musicians strike the strings of certain instruments. | : (n.) The tube of a musical instrument. | : (n.) Something having the form of a quill | : (n.) The fold or plain of a ruff. | : (n.) A spindle, or spool, as of reed or wood, upon which the thread for the woof is wound in a shuttle. | : (n.) A hollow spindle. | : (v. t.) To plaint in small cylindrical ridges, called quillings; as, to quill a ruffle. | : (v. t.) To wind on a quill, as thread or yarn.
quinology : (n.) The science which treats of the cultivation of the cinchona, and of its use in medicine.
quab : (n.) An unfledged bird; hence, something immature or unfinished. | : (v. i.) See Quob, v. i.
quadrivalent : (a.) Having a valence of four; capable of combining with, being replaced by, or compared with, four monad atoms; tetravalent; -- said of certain atoms and radicals; thus, carbon and silicon are quadrivalent elements.
quad : (a.) Alt. of Quade | : (n.) A quadrat. | : (n.) A quadrangle; hence, a prison.
quadriphyllous : (a.) Having four leaves; quadrifoliate.
quadragenarious : (a.) Consisting of forty; forty years old.
quintile : (n.) The aspect of planets when separated the fifth part of the zodiac, or 72!.
quinnat : (n.) The California salmon (Oncorhynchus choicha); -- called also chouicha, king salmon, chinnook salmon, and Sacramento salmon. It is of great commercial importance.
quag : (n.) A quagmire.
quench : (v. t.) To extinguish; to overwhelm; to make an end of; -- said of flame and fire, of things burning, and figuratively of sensations and emotions; as, to quench flame; to quench a candle; to quench thirst, love, hate, etc. | : (v. t.) To cool suddenly, as heated steel, in tempering. | : (v. i.) To become extinguished; to go out; to become calm or cool.
quitch : (n.) Same as Quitch grass. | : (n.) Figuratively: A vice; a taint; an evil.
quarterfoil : (n.) An ornamental foliation having four lobes, or foils.
quinquennium : (n.) Space of five years.
quinoxyl : (n.) The hypothetical radical of certain quinone derivatives related to rhodizonic acid.
qualmish : (a.) Sick at the stomach; affected with nausea or sickly languor; inclined to vomit.
quack : (v. i.) To utter a sound like the cry of a duck. | : (v. i.) To make vain and loud pretensions; to boast. | : (v. i.) To act the part of a quack, or pretender. | : (n.) The cry of the duck, or a sound in imitation of it; a hoarse, quacking noise. | : (n.) A boastful pretender to medical skill; an empiric; an ignorant practitioner. | : (n.) Hence, one who boastfully pretends to skill or knowledge of any kind not possessed; a charlatan. | : (a.) Pertaining to or characterized by, boasting and pretension; used by quacks; pretending to cure diseases; as, a quack medicine; a quack doctor.
quiddler : (n.) One who wastes his energy about trifles.
quade : (a.) Evil; bad; baffling; as, a quade wind.
quietude : (n.) Rest; repose; quiet; tranquillity.
quiname : (a.) Growing in sets of five; -- said especially of leaves composed of five leaflets set at the end of a common petiole.
quatrefeuille : (n.) Alt. of Quatrefoil
quillback : (n.) An American fresh-water fish (Ictiobus, / Carpiodes, cyprinus); -- called also carp sucker, sailfish, spearfish, and skimback.
quotationist : (n.) One who makes, or is given to making, quotations.
quarrymen : (pl. ) of Quarry-man
quarterstaff : (n.) A long and stout staff formerly used as a weapon of defense and offense; -- so called because in holding it one hand was placed in the middle, and the other between the middle and the end.
quenelle : (n.) A kind of delicate forcemeat, commonly poached and used as a dish by itself or for garnishing.
quite : (v. t. & i.) See Quit. | : (a.) Completely; wholly; entirely; totally; perfectly; as, the work is not quite done; the object is quite accomplished; to be quite mistaken. | : (a.) To a great extent or degree; very; very much; considerably.
qualificator : (n.) An officer whose business it is to examine and prepare causes for trial in the ecclesiastical courts.
qualify : (v. t.) To make such as is required; to give added or requisite qualities to; to fit, as for a place, office, occupation, or character; to furnish with the knowledge, skill, or other accomplishment necessary for a purpose; to make capable, as of an employment or privilege; to supply with legal power or capacity. | : (v. t.) To give individual quality to; to modulate; to vary; to regulate. | : (v. t.) To reduce from a general, undefined, or comprehensive form, to particular or restricted form; to modify; to limit; to restrict; to restrain; as, to qualify a statement, claim, or proposition. | : (v. t.) Hence, to soften; to abate; to diminish; to assuage; to reduce the strength of, as liquors. | : (v. t.) To soothe; to cure; -- said of persons. | : (v. i.) To be or become qualified; to be fit, as for an office or employment. | : (v. i.) To obtain legal power or capacity by taking the oath, or complying with the forms required, on assuming an office.
quiddled : (imp. & p. p.) of Quiddle
quiddling : (p. pr. & vb. n.) of Quiddle
quatorze : (n.) The four aces, kings, queens, knaves, or tens, in the game of piquet; -- so called because quatorze counts as fourteen points.
quiesced : (imp. & p. p.) of Quiesce
quadrilocular : (a.) Having four cells, or cavities; as, a quadrilocular heart.
quartter : (v. t.) To divide into four equal parts. | : (v. t.) To divide; to separate into parts or regions. | : (v. t.) To furnish with shelter or entertainment; to supply with the means of living for a time; especially, to furnish shelter to; as, to quarter soldiers. | : (v. t.) To furnish as a portion; to allot. | : (v. t.) To arrange (different coats of arms) upon one escutcheon, as when a man inherits from both father and mother the right to bear arms.
quiescently : (adv.) In a quiescent manner.
quarrelsome : (a.) Apt or disposed to quarrel; given to brawls and contention; easily irritated or provoked to contest; irascible; choleric.
queasily : (adv.) In a queasy manner.
quipped : (imp. & p. p.) of Quip
quirt : (n.) A rawhide whip plaited with two thongs of buffalo hide.
quinquesyllable : (n.) A word of five syllables.
quacksalver : (n.) One who boasts of his skill in medicines and salves, or of the efficacy of his prescriptions; a charlatan; a quack; a mountebank.
quadrangle : (n.) A plane figure having four angles, and consequently four sides; any figure having four angles. | : (n.) A square or quadrangular space or inclosure, such a space or court surrounded by buildings, esp. such a court in a college or public school in England.
quackery : (n.) The acts, arts, or boastful pretensions of a quack; false pretensions to any art; empiricism.
quadrantes : (pl. ) of Quadrans
quish : (n.) See Cuish.
quittal : (n.) Return; requital; quittance.
quarry-man : (n.) A man who is engaged in quarrying stones; a quarrier.
quadripartite : (a.) Divided into four parts.
quintine : (n.) The embryonic sac of an ovule, sometimes regarded as an innermost fifth integument. Cf. Quartine, and Tercine.
questionary : (a.) Inquiring; asking questions; testing. | : (n.) One who makes it his business to seek after relics and carry them about for sale.
quebrith : (n.) Sulphur.
quiddany : (n.) A confection of quinces, in consistency between a sirup and marmalade.
quieting : (p. pr. & vb. n.) of Quiet
quadriga : (n.) A car or chariot drawn by four horses abreast.
queening : (p. pr. & vb. n.) of Queen | : (n.) Any one of several kinds of apples, as summer queening, scarlet queening, and early queening. An apple called the queening was cultivated in England two hundred years ago.
quaich : (n.) A small shallow cup or drinking vessel.
quadrisection : (n.) A subdivision into four parts.
quintilllion : (n.) According to the French notation, which is used on the Continent and in America, the cube of a million, or a unit with eighteen ciphers annexed; according to the English notation, a number produced by involving a million to the fifth power, or a unit with thirty ciphers annexed. See the Note under Numeration.
quivering : (p. pr. & vb. n.) of Quiver
quantum : (n.) Quantity; amount. | : (n.) A definite portion of a manifoldness, limited by a mark or by a boundary.
quartic : (a.) Of the fourth degree. | : (n.) A quantic of the fourth degree. See Quantic. | : (n.) A curve or surface whose equation is of the fourth degree in the variables.
quiver : (a.) Nimble; active. | : (v. i.) To shake or move with slight and tremulous motion; to tremble; to quake; to shudder; to shiver. | : (n.) The act or state of quivering; a tremor. | : (n.) A case or sheath for arrows to be carried on the person.
quiddative : (a.) Constituting, or containing, the essence of a thing; quidditative.
quirl : (n. & v.) See Querl.
quittable : (a.) Capable of being quitted.
-trices : (pl. ) of Quadratrix
quirk : (n.) A sudden turn; a starting from the point or line; hence, an artful evasion or subterfuge; a shift; a quibble; as, the quirks of a pettifogger. | : (n.) A fit or turn; a short paroxysm; a caprice. | : (n.) A smart retort; a quibble; a shallow conceit. | : (n.) An irregular air; as, light quirks of music. | : (n.) A piece of ground taken out of any regular ground plot or floor, so as to make a court, yard, etc.; -- sometimes written quink. | : (n.) A small channel, deeply recessed in proportion to its width, used to insulate and give relief to a convex rounded molding.
quaintness : (n.) The quality of being quaint.
quire : (n.) See Choir. | : (v. i.) To sing in concert. | : (n.) A collection of twenty-four sheets of paper of the same size and quality, unfolded or having a single fold; one twentieth of a ream.
qui vive : ( ) The challenge of a French sentinel, or patrol; -- used like the English challenge: "Who comes there?"
quercus : (n.) A genus of trees constituted by the oak. See Oak.
quittance : (v. t.) Discharge from a debt or an obligation; acquittance. | : (v. t.) Recompense; return; repayment. | : (v. t.) To repay; to requite.
quidam : (n.) Somebody; one unknown.
quarto : (a.) Having four leaves to the sheet; of the form or size of a quarto. | : (n.) Originally, a book of the size of the fourth of sheet of printing paper; a size leaves; in present usage, a book of a square or nearly square form, and usually of large size.
questorship : (n.) The office, or the term of office, of a questor.
quipu : (n.) A contrivance employed by the ancient Peruvians, Mexicans, etc., as a substitute for writing and figures, consisting of a main cord, from which hung at certain distances smaller cords of various colors, each having a special meaning, as silver, gold, corn, soldiers. etc. Single, double, and triple knots were tied in the smaller cords, representing definite numbers. It was chiefly used for arithmetical purposes, and to register important facts and events.
quet : (n.) The common guillemot.
questioned : (imp. & p. p.) of Question
querken : (v. t.) To stifle or choke.
quarterhung : (a.) Having trunnions the axes of which lie below the bore; -- said of a cannon.
quartz : (n.) A form of silica, or silicon dioxide (SiO2), occurring in hexagonal crystals, which are commonly colorless and transparent, but sometimes also yellow, brown, purple, green, and of other colors; also in cryptocrystalline massive forms varying in color and degree of transparency, being sometimes opaque.
quartette : (n.) A composition in four parts, each performed by a single voice or instrument. | : (n.) The set of four person who perform a piece of music in four parts. | : (n.) A stanza of four lines.
quipo : (n.) Same as Quipu.
quey : (n.) A heifer.
queachy : (a.) Yielding or trembling under the feet, as moist or boggy ground; shaking; moving. | : (a.) Like a queach; thick; bushy.
quotient : (n.) The number resulting from the division of one number by another, and showing how often a less number is contained in a greater; thus, the quotient of twelve divided by four is three. | : (n.) The result of any process inverse to multiplication. See the Note under Multiplication.
questioner : (n.) One who asks questions; an inquirer.
quadrifid : (a.) Divided, or deeply cleft, into four parts; as, a quadrifid perianth; a quadrifid leaf.
quarte : (n.) Same as 2d Carte.
quantitative : (a.) Relating to quantity.
quamash : (n.) See Camass.
quarrel : (n.) An arrow for a crossbow; -- so named because it commonly had a square head. | : (n.) Any small square or quadrangular member | : (n.) A square of glass, esp. when set diagonally. | : (n.) A small opening in window tracery, of which the cusps, etc., make the form nearly square. | : (n.) A square or lozenge-shaped paving tile. | : (n.) A glazier's diamond. | : (n.) A four-sided cutting tool or chisel having a diamond-shaped end. | : (n.) A breach of concord, amity, or obligation; a falling out; a difference; a disagreement; an antagonism in opinion, feeling, or conduct; esp., an angry dispute, contest, or strife; a brawl; an altercation; as, he had a quarrel with his father about expenses. | : (n.) Ground of objection, dislike, difference, or hostility; cause of dispute or contest; occasion of altercation. | : (n.) Earnest desire or longing. | : (v. i.) To violate concord or agreement; to have a difference; to fall out; to be or become antagonistic. | : (v. i.) To dispute angrily, or violently; to wrangle; to scold; to altercate; to contend; to fight. | : (v. i.) To find fault; to cavil; as, to quarrel with one's lot. | : (v. t.) To quarrel with. | : (v. t.) To compel by a quarrel; as, to quarrel a man out of his estate or rights. | : (n.) One who quarrels or wrangles; one who is quarrelsome.
queenship : (n.) The state, rank, or dignity of a queen.
quadrilobate : (a.) Alt. of Quadrilobed
quarteron : (n.) A quarter; esp., a quarter of a pound, or a quarter of a hundred. | : (n.) Alt. of Quarteroon
quietly : (adv.) In a quiet state or manner; without motion; in a state of rest; as, to lie or sit quietly. | : (adv.) Without tumult, alarm, dispute, or disturbance; peaceably; as, to live quietly; to sleep quietly. | : (adv.) Calmly, without agitation or violent emotion; patiently; as, to submit quietly to unavoidable evils. | : (adv.) Noiselessly; silently; without remark or violent movement; in a manner to attract little or no observation; as, he quietly left the room.
quintette : (n.) A composition for five voices or instruments; also, the set of five persons who sing or play five-part music.
quaintly : (adv.) In a quaint manner.
quenchable : (a.) Capable of being quenched.
quassation : (n.) The act of shaking, or the state of being shaken.
quester : (n.) One who seeks; a seeker.
qua-bird : (n.) The American night heron. See under Night.
quinovic : (a.) Pertaining to, or designating, a crystalline acid obtained from some varieties of cinchona bark.
quib : (n.) A quip; a gibe.
quesal : (n.) The long-tailed, or resplendent, trogon (Pharomachus mocinno, formerly Trogon resplendens), native of Southern Mexico and Central America. Called also quetzal, and golden trogon.
quaere : (v. imperative.) Inquire; question; see; -- used to signify doubt or to suggest investigation.
quid : (n.) A portion suitable to be chewed; a cud; as, a quid of tobacco. | : (v. t.) To drop from the mouth, as food when partially chewed; -- said of horses.
quindecemvir : (n.) One of a sacerdotal college of fifteen men whose chief duty was to take care of the Sibylline books.
quoter : (n.) One who quotes the words of another.
quoted : (imp. & p. p.) of Quote
quaketail : (n.) A wagtail.
querist : (n.) One who inquires, or asks questions.
quadricostate : (a.) Having four ribs.
quinovin : (n.) An amorphous bitter glucoside derived from cinchona and other barks. Called also quinova bitter, and quinova.
quagmire : (n.) Soft, wet, miry land, which shakes or yields under the feet.
quinquelobate : (a.) Alt. of Quinquelobared
quitture : (n.) A discharge; an issue.
quarteroon : (n.) A quadroon.
quodlibet : (n.) A nice point; a subtilty; a debatable point. | : (n.) A medley improvised by several performers.
quartile : (n.) Same as Quadrate.
querele : (n.) A complaint to a court. See Audita Querela.
quicksilver : (a.) The metal mercury; -- so called from its resemblance to liquid silver.
quixotry : (n.) Quixotism; visionary schemes.
quotidian : (a.) Occurring or returning daily; as, a quotidian fever. | : (n.) Anything returning daily; especially (Med.), an intermittent fever or ague which returns every day.
quality : (n.) The condition of being of such and such a sort as distinguished from others; nature or character relatively considered, as of goods; character; sort; rank. | : (n.) Special or temporary character; profession; occupation; assumed or asserted rank, part, or position. | : (n.) That which makes, or helps to make, anything such as it is; anything belonging to a subject, or predicable of it; distinguishing property, characteristic, or attribute; peculiar power, capacity, or virtue; distinctive trait; as, the tones of a flute differ from those of a violin in quality; the great quality of a statesman. | : (n.) An acquired trait; accomplishment; acquisition. | : (n.) Superior birth or station; high rank; elevated character.
querulous : (v.) Given to quarreling; quarrelsome. | : (v.) Apt to find fault; habitually complaining; disposed to murmur; as, a querulous man or people. | : (v.) Expressing complaint; fretful; whining; as, a querulous tone of voice.
quondam : (a.) Having been formerly; former; sometime. | : (n.) A person dismissed or ejected from a position.
queerly : (adv.) In a queer or odd manner.
quinquina : (n.) Peruvian bark.
quadrigeminous : (a.) Fourfold; having four similar parts, or two pairs of similar parts.
quarterlies : (pl. ) of Quarterly
quinologist : (n.) One who is versed in quinology.
queened : (imp. & p. p.) of Queen
quaff : (v. t.) To drink with relish; to drink copiously of; to swallow in large draughts. | : (v. i.) To drink largely or luxuriously.
quilling : (p. pr. & vb. n.) of Quill | : (n.) A band of linen, muslin, or the like, fluted, folded, or plaited so as somewhat to resemble a row of quills. | : (n.) One of the rounded plaits or flutings of such a band.
quadratics : (n.) That branch of algebra which treats of quadratic equations.
quadrivalve : (a.) Dehiscent into four similar parts; four-valved; as, a quadrivalve pericarp. | : (n.) A door, shutter, or the like, having four folds.
quinia : (n.) Quinine.
quadrilateral : (a.) Having four sides, and consequently four angles; quadrangular. | : (n.) A plane figure having four sides, and consequently four angles; a quadrangular figure; any figure formed by four lines. | : (n.) An area defended by four fortresses supporting each other; as, the Venetian quadrilateral, comprising Mantua, Peschiera, Verona, and Legnano.
quinic : (a.) Pertaining to, derived from, or connected with, quinine and related compounds; specifically, designating a nonnitrogenous acid obtained from cinchona bark, coffee, beans, etc., as a white crystalline substance.
quaternary : (a.) Consisting of four; by fours, or in sets of four. | : (a.) Later than, or subsequent to, the Tertiary; Post-tertiary; as, the Quaternary age, or Age of man. | : (n.) The number four. | : (n.) The Quaternary age, era, or formation. See the Chart of Geology.
quebracho : (n.) A Chilian apocynaceous tree (Aspidosperma Quebracho); also, its bark, which is used as a febrifuge, and for dyspn/a of the lung, or bronchial diseases; -- called also white quebracho, to distinguish it from the red quebracho, a Mexican anacardiaceous tree (Loxopterygium Lorentzii) whose bark is said to have similar properties.
quinque- : ( ) A combining form meaning five, five times, fivefold; as, quinquefid, five-cleft; quinquedentate, five-toothed.
quelling : (p. pr. & vb. n.) of Quell
quinoxaline : (n.) Any one of a series of complex nitrogenous bases obtained by the union of certain aniline derivatives with glyoxal or with certain ketones.
quiz : (n.) A riddle or obscure question; an enigma; a ridiculous hoax. | : (n.) One who quizzes others; as, he is a great quiz. | : (n.) An odd or absurd fellow. | : (n.) An exercise, or a course of exercises, conducted as a coaching or as an examination. | : (v. t.) To puzzle; to banter; to chaff or mock with pretended seriousness of discourse; to make sport of, as by obscure questions. | : (v. t.) To peer at; to eye suspiciously or mockingly. | : (v. t.) To instruct in or by a quiz. See Quiz, n., 4. | : (v. i.) To conduct a quiz. See Quiz, n., 4.
quartine : (n.) A supposed fourth integument of an ovule, counting from the outside.
quindem : (n.) A fifteenth part.
quasje : (n.) The brown coati. See Coati.
quercitrin : (n.) A glucoside extracted from the bark of the oak (Quercus) as a bitter citron-yellow crystalline substance, used as a pigment and called quercitron.
quadripartitely : (adv.) In four parts.
quicksand : (n.) Sand easily moved or readily yielding to pressure; especially, a deep mass of loose or moving sand mixed with water, sometimes found at the mouth of a river or along some coasts, and very dangerous, from the difficulty of extricating a person who begins sinking into it.
quibbler : (n.) One who quibbles; a caviler; also, a punster.
quits : (interj.) See the Note under Quit, a.
quadridentate : (a.) Having four teeth; as, a quadridentate leaf.
quell : (v. i.) To die. | : (v. i.) To be subdued or abated; to yield; to abate. | : (v. t.) To take the life of; to kill. | : (v. t.) To overpower; to subdue; to put down. | : (v. t.) To quiet; to allay; to pacify; to cause to yield or cease; as, to quell grief; to quell the tumult of the soul. | : (n.) Murder.
quindism : (n.) A fifteenth.
queenliness : (n.) The quality of being queenly; the; characteristic of a queen; stateliness; eminence among women in attractions or power.
quintel : (n.) See Quintain.
querent : (n.) A complainant; a plaintiff. | : (n.) An inquirer.
quadrumanous : (a.) Having four hands; of or pertaining to the Quadrumana.
queme : (v. t. & i.) To please.
quintet : (n.) Alt. of Quintette
quit : (n.) Any one of numerous species of small passerine birds native of tropical America. See Banana quit, under Banana, and Guitguit. | : (v.) Released from obligation, charge, penalty, etc.; free; clear; absolved; acquitted. | : (imp. & p. p.) of Quit | : (a.) To set at rest; to free, as from anything harmful or oppressive; to relieve; to clear; to liberate. | : (a.) To release from obligation, accusation, penalty, or the like; to absolve; to acquit. | : (a.) To discharge, as an obligation or duty; to meet and satisfy, as a claim or debt; to make payment for or of; to requite; to repay. | : (a.) To meet the claims upon, or expectations entertained of; to conduct; to acquit; -- used reflexively. | : (a.) To carry through; to go through to the end. | : (a.) To have done with; to cease from; to stop; hence, to depart from; to leave; to forsake; as, to quit work; to quit the place; to quit jesting. | : (v. i.) To away; to depart; to stop doing a thing; to cease.
quibbled : (imp. & p. p.) of Quibble
quin : (n.) A European scallop (Pecten opercularis), used as food.
quip : (n.) A smart, sarcastic turn or jest; a taunt; a severe retort; a gibe. | : (v. t.) To taunt; to treat with quips. | : (v. i.) To scoff; to use taunts.
quakerly : (a.) Resembling Quakers; Quakerlike; Quakerish.
quadrivalvular : (a.) Having four valves; quadrivalve.
quaternate : (a.) Composed of, or arranged in, sets of four; quaternary; as, quaternate leaves.
quinquereme : (n.) A galley having five benches or banks of oars; as, an Athenian quinquereme.
quavemire : (n.) See Quagmire.
questionableness : (n.) The quality or state of being questionable, doubtful, or suspicious.
quincunx : (n.) An arrangement of things by fives in a square or a rectangle, one being placed at each corner and one in the middle; especially, such an arrangement of trees repeated indefinitely, so as to form a regular group with rows running in various directions. | : (n.) The position of planets when distant from each other five signs, or 150!. | : (n.) A quincuncial arrangement, as of the parts of a flower in aestivation. See Quincuncial, 2.
quaky : (a.) Shaky, or tremulous; quaking.
quadrisyllabic : ( ) Alt. of Quadri-syllabical
quarrelet : (n.) A little quarrel. See 1st Quarrel, 2.
quantitive : (a.) Estimable according to quantity; quantitative.
qualling : (p. pr. & vb. n.) of Quail
queencraft : (n.) Craft or skill in policy on the part of a queen.
quest : (n.) The act of seeking, or looking after anything; attempt to find or obtain; search; pursuit; as, to rove in quest of game, of a lost child, of property, etc. | : (n.) Request; desire; solicitation. | : (n.) Those who make search or inquiry, taken collectively. | : (n.) Inquest; jury of inquest. | : (n.) To search for; to examine. | : (v. i.) To go on a quest; to make a search; to go in pursuit; to beg.
qualm : (n.) Sickness; disease; pestilence; death. | : (n.) A sudden attack of illness, faintness, or pain; an agony. | : (n.) Especially, a sudden sensation of nausea. | : (n.) A prick or scruple of conscience; uneasiness of conscience; compunction.
quinaldine : (n.) A colorless liquid of a slightly pungent odor, C9H6N.CH3, first obtained as a condensation product of aldehyde and aniline, and regarded as a derivative of quinoline; -- called also methyl quinoline.
quadrennial : (a.) Comprising four years; as, a quadrennial period. | : (a.) Occurring once in four years, or at the end of every four years; as, quadrennial games.
quickbeam : (n.) See Quicken tree.
quateron : (n.) See 2d Quarteron.
quarreled : (imp. & p. p.) of Quarrel
quakeress : (n.) A woman who is a member of the Society of Friends.
quadribasic : (a.) Same as Tetrabasic.
quo warranto : ( ) A writ brought before a proper tribunal, to inquire by what warrant a person or a corporation acts, or exercises certain powers.
quillwort : (n.) Any plant or species of the genus Isoetes, cryptogamous plants with a cluster of elongated four-tubed rushlike leaves, rising from a corm, and containing spores in their enlarged and excavated bases. There are about seventeen American species, usually growing in the mud under still, shallow water. So called from the shape of the shape of the leaves.
quartation : (n.) The act, process, or result (in the process of parting) of alloying a button of nearly pure gold with enough silver to reduce the fineness so as to allow acids to attack and remove all metals except the gold; -- called also inquartation. Compare Parting.
quivered : (imp. & p. p.) of Quiver | : (a.) Furnished with, or carrying, a quiver. | : (a.) Sheathed, as in a quiver.
quadrivial : (a.) Having four ways meeting in a point. | : (n.) One of the four "liberal arts" making up the quadrivium.
quarrelling : ( ) of Quarrel
query : (n.) A question; an inquiry to be answered or solved. | : (n.) A question in the mind; a doubt; as, I have a query about his sincerity. | : (n.) An interrogation point [?] as the sign of a question or a doubt. | : (v. i.) To ask questions; to make inquiry. | : (v. i.) To have a doubt; as, I query if he is right. | : (v. t.) To put questions about; to elicit by questioning; to inquire into; as, to query the items or the amount; to query the motive or the fact. | : (v. t.) To address questions to; to examine by questions. | : (v. t.) To doubt of; to regard with incredulity. | : (v. t.) To write " query" (qu., qy., or ?) against, as a doubtful spelling, or sense, in a proof. See Quaere.
quadrible : (a.) Quadrable.
quinquedentated : (a.) Five-toothed; as, a quinquedentate leaf.
quartzous : (a.) Quarzose.
quinquedentate : (a.) Alt. of Quinquedentated
quinoa : (n.) The seeds of a kind of goosewort (Chenopodium Quinoa), used in Chili and Peru for making porridge or cakes; also, food thus made.
quadrifarious : (a.) Arranged in four rows or ranks; as, quadrifarious leaves.
quitclaiming : (p. pr. & vb. n.) of Quitclaim
quarrelled : ( ) of Quarrel
quincewort : (n.) The squinancy. Called also quinsywort.
quatuor : (n.) A quartet; -- applied chiefly to instrumental compositions.
quake : (v. i.) To be agitated with quick, short motions continually repeated; to shake with fear, cold, etc.; to shudder; to tremble. | : (v. i.) To shake, vibrate, or quiver, either from not being solid, as soft, wet land, or from violent convulsion of any kind; as, the earth quakes; the mountains quake. | : (v. t.) To cause to quake. | : (n.) A tremulous agitation; a quick vibratory movement; a shudder; a quivering.
quatre : (n.) A card, die. or domino, having four spots, or pips
quotha : (interj.) Indeed; forsooth.
qua : (conj.) In so far as; in the capacity or character of; as.
quartridge : (n.) Quarterage.
que : (n.) A half farthing.
quibble : (n.) A shift or turn from the point in question; a trifling or evasive distinction; an evasion; a cavil. | : (n.) A pun; a low conceit. | : (v. i.) To evade the point in question by artifice, play upon words, caviling, or by raising any insignificant or impertinent question or point; to trifle in argument or discourse; to equivocate. | : (v. i.) To pun; to practice punning.
quob : (v. i.) To throb; to quiver.
quick-sighted : (a.) Having quick sight or acute discernment; quick to see or to discern.
quadrigenarious : (a.) Consisting of four hundred.
quadra : (n.) The plinth, or lowest member, of any pedestal, podium, water table, or the like. | : (n.) A fillet, or listel.
quair : (n.) A quire; a book.
queenhood : (n.) The state, personality, or character of a queen; queenliness.
quod : (n.) A quadrangle or court, as of a prison; hence, a prison. | : (v.) Quoth; said. See Quoth.
qualifiedly : (adv.) In the way of qualification; with modification or qualification.
quarter round : ( ) An ovolo.
quiddit : (n.) A subtilty; an equivocation.
quackled : (imp. & p. p.) of Quackle
quail : (v. i.) To die; to perish; hence, to wither; to fade. | : (v. i.) To become quelled; to become cast down; to sink under trial or apprehension of danger; to lose the spirit and power of resistance; to lose heart; to give way; to shrink; to cower. | : (v. t.) To cause to fail in spirit or power; to quell; to crush; to subdue. | : (v. i.) To curdle; to coagulate, as milk. | : (n.) Any gallinaceous bird belonging to Coturnix and several allied genera of the Old World, especially the common European quail (C. communis), the rain quail (C. Coromandelica) of India, the stubble quail (C. pectoralis), and the Australian swamp quail (Synoicus australis). | : (n.) Any one of several American partridges belonging to Colinus, Callipepla, and allied genera, especially the bobwhite (called Virginia quail, and Maryland quail), and the California quail (Calipepla Californica). | : (n.) Any one of numerous species of Turnix and allied genera, native of the Old World, as the Australian painted quail (Turnix varius). See Turnix. | : (n.) A prostitute; -- so called because the quail was thought to be a very amorous bird.
quatrain : (n.) A stanza of four lines rhyming alternately.
quicklime : (a.) Calcium oxide; unslacked lime; -- so called because when wet it develops great heat. See 4th Lime, 2.
quackle : (v. i. & t.) To suffocate; to choke.
quadriceps : (n.) The great extensor muscle of the knee, divided above into four parts which unite in a single tendon at the knee.
quern : (n.) A mill for grinding grain, the upper stone of which was turned by hand; -- used before the invention of windmills and watermills.
quandy : (n.) The old squaw.
querl : (v. t.) To twirl; to turn or wind round; to coil; as, to querl a cord, thread, or rope. | : (n.) A coil; a twirl; as, the qwerl of hair on the fore leg of a blooded horse.
quinism : (n.) See Cinchonism.
quenchless : (a.) Incapable of being quenched; inextinguishable; as, quenchless fire or fury.
quietage : (n.) Quietness.
quenouille training : ( ) A method of training trees or shrubs in the shape of a cone or distaff by tying down the branches and pruning.
quieter : (n.) One who, or that which, quiets.
quickhatch : (n.) The wolverine.
quincuncially : (adv.) In the manner or order of a quincunx.
quadrinominal : (a.) Quadrinomial.
quintic : (a.) Of the fifth degree or order. | : (n.) A quantic of the fifth degree. See Quantic.
quadrisyllable : (n.) A word consisting of four syllables.
quadrilateralness : (n.) The property of being quadrilateral.
quiesce : (a. & n.) To be silent, as a letter; to have no sound.
quieted : (imp. & p. p.) of Quiet
quadrated : (imp. & p. p.) of Quadrate
quintin : (n.) See Quintain.
quadragesima : (n.) The forty days of fast preceding Easter; Lent.
quartzose : (a.) Containing, or resembling, quartz; partaking of the nature or qualities of quartz.
queint : (a.) See Quaint. | : ( ) imp. & p. p. of Quench.
quotation : (n.) The act of quoting or citing. | : (n.) That which is quoted or cited; a part of a book or writing named, repeated, or adduced as evidence or illustration. | : (n.) The naming or publishing of the current price of stocks, bonds, or any commodity; also the price named. | : (n.) Quota; share. | : (n.) A piece of hollow type metal, lower than type, and measuring two or more pica ems in length and breadth, used in the blank spaces at the beginning and end of chapters, etc.
quintessential : (a.) Of the nature of a quintessence; purest.
quadragesimal : (a.) Belonging to Lent; used in Lent; Lenten.
quickly : (adv.) Speedily; with haste or celerity; soon; without delay; quick.
quoke : ( ) imp. of Quake.
oueen-post : (n.) One of two suspending posts in a roof truss, or other framed truss of similar form. See King-post.
quixotic : (a.) Like Don Quixote; romantic to extravagance; absurdly chivalric; apt to be deluded.
quickener : (n.) One who, or that which, quickens.
quadruplicate : (v. t.) To make fourfold; to double twice; to quadruple. | : (a.) Fourfold; doubled twice; four times repeated; as, a quadruplicate ratio, or a quadruplicate proportion. | : (a.) Raised to the fourth power.
quirky : (a.) Full of quirks; tricky; as, a quirky lawyer.
quahog : (n.) Alt. of Quahaug
quinible : (n.) An interval of a fifth; also, a part sung with such intervals.
quacking : (p. pr. & vb. n.) of Quack
quadrivalence : (n.) The quality or state of being quadrivalent; tetravalence.
quintain : (n.) An object to be tilted at; -- called also quintel.
quipping : (p. pr. & vb. n.) of Quip
quinch : (v. i.) To stir; to wince.
quarry-faced : (a.) Having a face left as it comes from the quarry and not smoothed with the chisel or point; -- said of stones.
quadripartition : (n.) A division or distribution by four, or into four parts; also, a taking the fourth part of any quantity or number.
quince : (n.) The fruit of a shrub (Cydonia vulgaris) belonging to the same tribe as the apple. It somewhat resembles an apple, but differs in having many seeds in each carpel. It has hard flesh of high flavor, but very acid, and is largely used for marmalade, jelly, and preserves. | : (n.) a quince tree or shrub.
quadrans : (n.) A fourth part of the coin called an as. See 3d As, 2. | : (n.) The fourth of a penny; a farthing. See Cur.
quashee : (n.) A negro of the West Indies.
quackeries : (pl. ) of Quackery
quashed : (imp. & p. p.) of Quash
quantification : (n.) Modification by a reference to quantity; the introduction of the element of quantity.
quickset : (n.) A living plant set to grow, esp. when set for a hedge; specifically, the hawthorn. | : (a.) Made of quickset. | : (v. t.) To plant with living shrubs or trees for a hedge; as, to quickset a ditch.
quadrant : (n.) The fourth part; the quarter. | : (n.) The quarter of a circle, or of the circumference of a circle, an arc of 90!, or one subtending a right angle at the center. | : (n.) One of the four parts into which a plane is divided by the coordinate axes. The upper right-hand part is the first quadrant; the upper left-hand part the second; the lower left-hand part the third; and the lower right-hand part the fourth quadrant. | : (n.) An instrument for measuring altitudes, variously constructed and mounted for different specific uses in astronomy, surveying, gunnery, etc., consisting commonly of a graduated arc of 90!, with an index or vernier, and either plain or telescopic sights, and usually having a plumb line or spirit level for fixing the vertical or horizontal direction.
quant : (n.) A punting pole with a broad flange near the end to prevent it from sinking into the mud; a setting pole.
queerish : (a.) Rather queer; somewhat singular.
quilted : (imp. & p. p.) of Quilt
quop : (v. i.) See Quob.
quiescent : (a.) Being in a state of repose; at rest; still; not moving; as, a quiescent body or fluid. | : (a.) Not ruffed with passion; unagitated; not in action; not excited; quiet; dormant; resting. | : (a.) Not sounded; silent; as, y is quiescent in "day" and "say." | : (n.) A silent letter.
quandary : (n.) A state of difficulty or perplexity; doubt; uncertainty. | : (v. t.) To bring into a state of uncertainty, perplexity, or difficulty.
quandong : (n.) The edible drupaceous fruit of an Australian tree (Fusanus acuminatus) of the Sandalwood family; -- called also quandang.
questmen : (pl. ) of Questman
quarrellous : (a.) Quarrelsome.
quatorzain : (n.) A poem of fourteen lines; a sonnet.
quibblingly : (adv.) Triflingly; evasively.
quackling : (p. pr. & vb. n.) of Quackle
quilter : (n.) One who, or that which, quilts.
quicksilvered : (a.) Overlaid with quicksilver, or with an amalgam of quicksilver and tinfoil.
quadrel : (n.) A square piece of turf or peat. | : (n.) A square brick, tile, or the like.
quoil : (n.) See Coil.
queerness : (n.) The quality or state of being queer.
quadrupled : (imp. & p. p.) of Quadruple
quahaug : (n.) An American market clam (Venus mercenaria). It is sold in large quantities, and is highly valued as food. Called also round clam, and hard clam.
questioning : (p. pr. & vb. n.) of Question
quinogen : (n.) A hypothetical radical of quinine and related alkaloids.
questant : (n.) One who undertakes a quest; a seeker.
quoif : (n. & v. t.) See Coif.
quebec group : ( ) The middle of the three groups into which the rocks of the Canadian period have been divided in the American Lower Silurian system. See the Chart of Geology.
quiveringly : (adv.) With quivering motion.
quantic : (n.) A homogeneous algebraic function of two or more variables, in general containing only positive integral powers of the variables, and called quadric, cubic, quartic, etc., according as it is of the second, third, fourth, fifth, or a higher degree. These are further called binary, ternary, quaternary, etc., according as they contain two, three, four, or more variables; thus, the quantic / is a binary cubic.
quaffed : (imp. & p. p.) of Quaff
quirboilly : (n.) Leather softened by boiling so as to take any required shape. Upon drying, it becomes exceedingly hard, and hence was formerly used for armor.
qualifying : (p. pr. & vb. n.) of Qualify
quamoclit : (n.) Formerly, a genus of plants including the cypress vine (Quamoclit vulgaris, now called Ipomoea Quamoclit). The genus is now merged in Ipomoea.
queasy : (a.) Sick at the stomach; affected with nausea; inclined to vomit; qualmish. | : (a.) Fastidious; squeamish; delicate; easily disturbed; unsettled; ticklish.
quadruplex : (a.) Fourfold; folded or doubled twice.
quinquagesima : (a.) Fiftieth.
quoit : (n.) A flattened ring-shaped piece of iron, to be pitched at a fixed object in play; hence, any heavy flat missile used for the same purpose, as a stone, piece of iron, etc. | : (n.) A game played with quoits. | : (n.) The discus of the ancients. See Discus. | : (n.) A cromlech. | : (v. i.) To throw quoits; to play at quoits. | : (v. t.) To throw; to pitch.
quoin : (n.) Originally, a solid exterior angle, as of a building; now, commonly, one of the selected pieces of material by which the corner is marked. | : (n.) A wedgelike piece of stone, wood metal, or other material, used for various purposes | : (n.) to support and steady a stone. | : (n.) To support the breech of a cannon. | : (n.) To wedge or lock up a form within a chase. | : (n.) To prevent casks from rolling.
quaint : (a.) Prudent; wise; hence, crafty; artful; wily. | : (a.) Characterized by ingenuity or art; finely fashioned; skillfully wrought; elegant; graceful; nice; neat. | : (a.) Curious and fanciful; affected; odd; whimsical; antique; archaic; singular; unusual; as, quaint architecture; a quaint expression.
quadrijugate : (a.) Same as Quadrijugous.
quarterpace : (n.) A platform of a staircase where the stair turns at a right angle only. See Halfpace.
qvacked : (imp. & p. p.) of Quack
quaffer : (n.) One who quaffs, or drinks largely.
queller : (n.) A killer; as, Jack the Giant Queller. | : (n.) One who quells; one who overpowers or subdues.
quelled : (imp. & p. p.) of Quell
quitly : (adv.) Quite.
quitrent : (n.) A rent reserved in grants of land, by the payment of which the tenant is quit from other service.
quadratic : (a.) Of or pertaining to a square, or to squares; resembling a quadrate, or square; square. | : (a.) Tetragonal. | : (a.) Pertaining to terms of the second degree; as, a quadratic equation, in which the highest power of the unknown quantity is a square.
quadruplicating : (p. pr. & vb. n.) of Quadruplicate
quadrinodal : (a.) Possessing four nodes; as, quadrinodal curves.
quixotically : (adv.) In a quixotic way.
quizzed : (imp. & p. p.) of Quiz
quodlibetarian : (n.) One who discusses any subject at pleasure.
questrist : (n.) A seeker; a pursuer.
quiritation : (n.) A crying for help.
quidditative : (a.) Quiddative.
quadruped : (a.) Having four feet. | : (n.) An animal having four feet, as most mammals and reptiles; -- often restricted to the mammals.
quashing : (p. pr. & vb. n.) of Quash
quiddities : (pl. ) of Quiddity
quizzer : (n.) One who quizzes; a quiz.
quadrisulcate : (a.) Having four hoofs; as, a quadrisulcate foot; a quadrisulcate animal.
queue : (n.) A tail-like appendage of hair; a pigtail. | : (n.) A line of persons waiting anywhere. | : (v. t.) To fasten, as hair, in a queue.
quick : (superl.) Alive; living; animate; -- opposed to dead or inanimate. | : (superl.) Characterized by life or liveliness; animated; sprightly; agile; brisk; ready. | : (superl.) Speedy; hasty; swift; not slow; as, be quick. | : (superl.) Impatient; passionate; hasty; eager; eager; sharp; unceremonious; as, a quick temper. | : (superl.) Fresh; bracing; sharp; keen. | : (superl.) Sensitive; perceptive in a high degree; ready; as, a quick ear. | : (superl.) Pregnant; with child. | : (adv.) In a quick manner; quickly; promptly; rapidly; with haste; speedily; without delay; as, run quick; get back quick. | : (n.) That which is quick, or alive; a living animal or plant; especially, the hawthorn, or other plants used in making a living hedge. | : (n.) The life; the mortal point; a vital part; a part susceptible of serious injury or keen feeling; the sensitive living flesh; the part of a finger or toe to which the nail is attached; the tender emotions; as, to cut a finger nail to the quick; to thrust a sword to the quick, to taunt one to the quick; -- used figuratively. | : (n.) Quitch grass. | : (v. t. & i.) To revive; to quicken; to be or become alive.
quakerlike : (a.) Like a Quaker.
questionable : (a.) Admitting of being questioned; inviting, or seeming to invite, inquiry. | : (a.) Liable to question; subject to be doubted or called in question; problematical; doubtful; suspicious.
quata : (n.) The coaita.
quich : (v. i.) To stir.
quice : (n.) See Queest.
quook : ( ) imp. of Quake.
quica : (n.) A small South American opossum (Didelphys quica), native of Guiana and Brazil. It feeds upon insects, small birds, and fruit.
quakingly : (adv.) In a quaking manner; fearfully.
quakery : (n.) Quakerism.
quadruply : (adv.) To a fourfold quantity; so as to be, or cause to be, quadruple; as, to be quadruply recompensed.
queasiness : (n.) The state of being queasy; nausea; qualmishness; squeamishness.
quasimodo : (n.) The first Sunday after Easter; Low Sunday.
quinquarticular : (a.) Relating to the five articles or points; as, the quinquarticular controversy between Arminians and Calvinists.
quakerish : (a.) Like or pertaining to a Quaker; Quakerlike.
quadrable : (a.) That may be sqyared, or reduced to an equivalent square; -- said of a surface when the area limited by a curve can be exactly found, and expressed in a finite number of algebraic terms.
quinzaine : (n.) The fifteenth day after a feast day, including both in the reckoning.
questionably : (adv.) In a questionable manner.
quirister : (n.) A chorister. See Chorister.
quirked : (a.) Having, or formed with, a quirk or quirks.
quinoyl : (n.) A radical of which quinone is the hydride, analogous to phenyl.
quakerism : (n.) The peculiar character, manners, tenets, etc., of the Quakers.
quakness : (n.) The state of being quaky; liability to quake.
questionist : (n.) A questioner; an inquirer. | : (n.) A candidate for honors or degrees who is near the time of his examination.
quoting : (p. pr. & vb. n.) of Quote
quadrae : (pl. ) of Quadra
quadruple : (a.) Fourfold; as, to make quadruple restitution; a quadruple alliance. | : (n.) four times the sum or number; a fourfold amount; as, to receive to quadruple of the amount in damages. | : (v. t.) To multiply by four; to increase fourfold; to double; to double twice. | : (v. i.) To be multiplied by four; to increase fourfold; to become four times as much.
quirites : (n. pl.) Roman citizens.
quaestor : (n.) Same as Questor.
quadrinomical : (a.) Quadrinomial.
quercitron : (n.) The yellow inner bark of the Quercus tinctoria, the American black oak, yellow oak, dyer's oak, or quercitron oak, a large forest tree growing from Maine to eastern Texas. | : (n.) Quercitrin, used as a pigment. See Quercitrin.
quadrating : (p. pr. & vb. n.) of Quadrate
quickstep : (n.) A lively, spirited march; also, a lively style of dancing.
quixotism : (n.) That form of delusion which leads to extravagant and absurd undertakings or sacrifices in obedience to a morbidly romantic ideal of duty or honor, as illustrated by the exploits of Don Quixote in knight-errantry.
quadrireme : (n.) A galley with four banks of oars or rowers.
qualification : (n.) The act of qualifying, or the condition of being qualified. | : (n.) That which qualifies; any natural endowment, or any acquirement, which fits a person for a place, office, or employment, or which enables him to sustian any character with success; an enabling quality or circumstance; requisite capacity or possession. | : (n.) The act of limiting, or the state of being limited; that which qualifies by limiting; modification; restriction; hence, abatement; diminution; as, to use words without any qualification.
quintupling : (p. pr. & vb. n.) of Quintuple
quass : (n.) A thin, sour beer, made by pouring warm water on rye or barley meal and letting it ferment, -- much used by the Russians.
quickens : (n.) Quitch grass.
quadrat : (n.) A block of type metal lower than the letters, -- used in spacing and in blank lines. | : (n.) An old instrument used for taking altitudes; -- called also geometrical square, and line of shadows.
quintupled : (imp. & p. p.) of Quintuple
quadrillion : (n.) According to the French notation, which is followed also upon the Continent and in the United States, a unit with fifteen ciphers annexed; according to the English notation, the number produced by involving a million to the fourth power, or the number represented by a unit with twenty-four ciphers annexed. See the Note under Numeration.
quinine : (n.) An alkaloid extracted from the bark of several species of cinchona (esp. Cinchona Calisaya) as a bitter white crystalline substance, C20H24N2O2. Hence, by extension (Med.), any of the salts of this alkaloid, as the acetate, chloride, sulphate, etc., employed as a febrifuge or antiperiodic. Called also quinia, quinina, etc.
quantivalent : (a.) Of or pertaining to quantivalence.
questionless : (a.) Unquestioning; incurious. | : (adv.) Beyond a question or doubt; doubtless; certainly.
questman : (n.) One legally empowered to make quest of certain matters, esp. of abuses of weights and measures. | : (n.) A churchwarden's assistant; a sidesman. | : (n.) A collector of parish rents.
quasi : ( ) As if; as though; as it were; in a manner sense or degree; having some resemblance to; qualified; -- used as an adjective, or a prefix with a noun or an adjective; as, a quasi contract, an implied contract, an obligation which has arisen from some act, as if from a contract; a quasi corporation, a body that has some, but not all, of the peculiar attributes of a corporation; a quasi argument, that which resembles, or is used as, an argument; quasi historical, apparently historical, seeming to be historical.
quash : (n.) Same as Squash. | : (v. t.) To abate, annul, overthrow, or make void; as, to quash an indictment. | : (v. t.) To beat down, or beat in pieces; to dash forcibly; to crush. | : (v. t.) To crush; to subdue; to suppress or extinguish summarily and completely; as, to quash a rebellion. | : (v. i.) To be shaken, or dashed about, with noise.
quartenylic : (a.) Pertaining to, or designating, an acid of the acrylic acid series, metameric with crotonic acid, and obtained as a colorless liquid; -- so called from having four carbon atoms in the molecule. Called also isocrotonic acid.
quinquepartite : (a.) Consisting of five parts. | : (a.) Divided into five parts almost to the base.
quininic : (a.) Pertaining to, or designating, a nitrogenous acid obtained as a yellow crystalline substance by the oxidation of quinine.
quintuple : (a.) Multiplied by five; increased to five times the amount; fivefold. | : (v. t.) To make fivefold, or five times as much or many.
quintuple-ribbed : (a.) The same as Quinquenerved.
quadragene : (n.) An indulgence of forty days, corresponding to the forty days of ancient canonical penance.
quarantined : (imp. & p. p.) of Quarantine
quacha : (n.) The quagga.
quart : (n.) The fourth part; a quarter; hence, a region of the earth. | : (n.) A measure of capacity, both in dry and in liquid measure; the fourth part of a gallon; the eighth part of a peck; two pints. | : (n.) A vessel or measure containing a quart. | : (n.) In cards, four successive cards of the same suit. Cf. Tierce, 4.
questionability : (n.) The state or condition of being questionable.
quinquivalent : (a.) Same as Pentavalent.
quinqueangled : (a.) Having five angles; quinquangular.
querquedule : (n.) A teal. | : (n.) The pintail duck.
quinquelocular : (a.) Having five cells or loculi; five-celled; as, a quinquelocular pericarp.
quitclaimed : (imp. & p. p.) of Quitclaim
quarl : (n.) A medusa, or jellyfish.
quadri-syllabical : ( ) Having four syllables; of or pertaining to quadrisyllables; as, a quadrisyllabic word.
quantity : (v. t.) To modify or qualify with respect to quantity; to fix or express the quantity of; to rate. | : (n.) The attribute of being so much, and not more or less; the property of being measurable, or capable of increase and decrease, multiplication and division; greatness; and more concretely, that which answers the question "How much?"; measure in regard to bulk or amount; determinate or comparative dimensions; measure; amount; bulk; extent; size. | : (n.) The extent or extension of a general conception, that is, the number of species or individuals to which it may be applied; also, its content or comprehension, that is, the number of its constituent qualities, attributes, or relations. | : (n.) The measure of a syllable; that which determines the time in which it is pronounced; as, the long or short quantity of a vowel or syllable. | : (n.) The relative duration of a tone. | : (n.) That which can be increased, diminished, or measured; especially (Math.), anything to which mathematical processes are applicable. | : (n.) A determinate or estimated amount; a sum or bulk; a certain portion or part; sometimes, a considerable amount; a large portion, bulk, or sum; as, a medicine taken in quantities, that is, in large quantities.
quinque foliolate : (a.) Having five leaflets.
quoll : (n.) A marsupial of Australia (Dasyurus macrurus), about the size of a cat.
quaintise : (n.) Craft; subtlety; cunning. | : (n.) Elegance; beauty.
quinicine : (n.) An uncrystallizable alkaloid obtained by the action of heat from quinine, with which it is isomeric.
quickwork : (n.) All the submerged section of a vessel's planking. | : (n.) The planking between the spirketing and the clamps. | : (n.) The short planks between the portholes.
quartzy : (a.) Quartzose.
quittor : (n.) A chronic abscess, or fistula of the coronet, in a horse's foot, resulting from inflammation of the tissues investing the coffin bone.
quellio : (n.) A ruff for the neck.
quintole : (n.) A group of five notes to be played or sung in the time of four of the same species.
quintal : (n.) A hundredweight, either 112 or 100 pounds, according to the scale used. Cf. Cental. | : (n.) A metric measure of weight, being 100,000 grams, or 100 kilograms, equal to 220.46 pounds avoirdupois.
qualifiable : (a.) Capable of being qualified; abatable; modifiable.
quartering : (p. pr. & vb. n.) of Quartter | : (a.) Coming from a point well abaft the beam, but not directly astern; -- said of waves or any moving object. | : (a.) At right angles, as the cranks of a locomotive, which are in planes forming a right angle with each other. | : (n.) A station. | : (n.) Assignment of quarters for soldiers; quarters. | : (n.) The division of a shield containing different coats of arms into four or more compartments. | : (n.) One of the different coats of arms arranged upon an escutcheon, denoting the descent of the bearer. | : (n.) A series of quarters, or small upright posts. See Quarter, n., 1 (m) (Arch.)
quick-wittedness : (n.) Readiness of wit.
quietness : (n.) The quality or state of being quiet; freedom from noise, agitation, disturbance, or excitement; stillness; tranquillity; calmness.
quinquelobared : (a.) Cut less than halfway into portions, usually somewhat rounded; five-lobed; as, a quinquelobate leaf or corolla.
quickened : (imp. & p. p.) of Quicken
quick-witted : (a.) Having ready wit
quintan : (a.) Occurring as the fifth, after four others also, occurring every fifth day, reckoning inclusively; as, a quintan fever. | : (n.) An intermittent fever which returns every fifth day, reckoning inclusively, or in which the intermission lasts three days.
quenching : (p. pr. & vb. n.) of Quench
