laura : Laura : (rzecz.) Laura
leninism : Leninism : (rzecz.) leninizm
leo : Leo : (rzecz.) Leon | : (rzecz.) lew
libra : Libra : (rzecz.) waga
lilliputian : Lilliputian : (rzecz.) liliput
lilly : Lilly : (rzecz.) Liliana
lucas : Lucas : (rzecz.) Łukasz
lucy : Lucy : (rzecz.) Łucja
luke : Luke : (rzecz.) Łukasz
lutheranism : Lutheranism : (rzecz.) luteranizm
lysol : Lysol : (rzecz.) lizol
lab : lab : (rzecz.) laboratorium | : (rzecz.) pracownia
labefaction : labefaction : (rzecz.) osłabienie | : (rzecz.) upadek
label : label : (czas.) etykietować | : (czas.) metkować | : (czas.) oznakowywać | : (rzecz.) etykieta | : (rzecz.) etykietka | : (rzecz.) kartka | : (rzecz.) kwalifikator | : (rzecz.) metka | : (rzecz.) naklejka | : (rzecz.) nalepka | : (rzecz.) oznakowanie | : (rzecz.) wytwórnia
labeller : labeller : (rzecz.) etykieciarka
labelling : labelling : (rzecz.) etykietowanie | : (rzecz.) znakowanie
labial : labial : (przym.) wargowy
labile : labile : (przym.) chwiejny | : (przym.) labilny | : (przym.) nietrwały | : (przym.) zmienny
labium : labium : (rzecz.) warga
laboratory : laboratory : (przym.) laboratoryjny | : (rzecz.) laborant | : (rzecz.) laboratorium | : (rzecz.) pracownia
laborious : laborious : (przym.) mozolny | : (przym.) pilny | : (przym.) pracochłonny | : (przym.) pracowity | : (przym.) wypracowany | : (przym.) żmudny
laboriously : laboriously : (przysł.) mozolnie | : (przysł.) pracowicie
laboriousness : laboriousness : (rzecz.) pracowitość
labour : labour : (rzecz.) ból | : (rzecz.) poród | : (rzecz.) praca | : (rzecz.) robocizna | : (rzecz.) robota
labour-consuming : labour-consuming : (przym.) pracochłonny
labourer : labourer : (rzecz.) robotnik | : (rzecz.) wyrobnik
labourite : labourite : (rzecz.) laburzysta
laburnum : laburnum : (rzecz.) złotokap
labyrinth : labyrinth : (rzecz.) błędnik | : (rzecz.) labirynt
labyrinthine : labyrinthine : (przym.) błędnikowy | : (przym.) labiryntowy
lace : lace : (czas.) obszyć | : (czas.) sznurować | : (czas.) zasznurować | : (rzecz.) koronka | : (rzecz.) sznur | : (rzecz.) sznurowadło | : (rzecz.) sznurówka
lace-making : lace-making : (rzecz.) koronkarstwo
lacerate : lacerate : (czas.) dręczyć | : (czas.) podrzeć | : (czas.) potargać | : (czas.) ranić | : (czas.) rozdzierać | : (czas.) rozrywać | : (czas.) rwać | : (czas.) szarpać
laceration : laceration : (rzecz.) poszarpanie | : (rzecz.) rana
lachrymal : lachrymal : (przym.) łzowy
lachrymator : lachrymator : (rzecz.) lakrymator
lacing : lacing : (rzecz.) koronka | : (rzecz.) marlinka | : (rzecz.) przewiązka | : (rzecz.) spinanie | : (rzecz.) sznurowadło | : (rzecz.) sznurowanie | : (rzecz.) wyszywanie | : (rzecz.) zasznurowanie | : (rzecz.) zszywanie
lack : lack : (czas.) brakować | : (rzecz.) brak | : (rzecz.) niedostatek
lack-lustre : lack-lustre : (przym.) matowy
lackadaisical : lackadaisical : (przym.) apatyczny | : (przym.) czułostkowy
lackey : lackey : (rzecz.) lokaj | : (rzecz.) sługus | : (rzecz.) służalec
lackey's : lackey's : (przym.) lokajski
lacklustre : lacklustre : (przym.) matowy
laconic : laconic : (przym.) lakoniczny | : (przym.) zwięzły
laconically : laconically : (przysł.) lakonicznie
lacquer : lacquer : (czas.) lakierować | : (rzecz.) laka | : (rzecz.) lakier | : (rzecz.) pokost
lactase : lactase : (rzecz.) laktaza
lactate : lactate : (rzecz.) mleczan
lactation : lactation : (rzecz.) laktacja | : (rzecz.) mleczność
lacteal : lacteal : (przym.) mleczny
lactic : lactic : (przym.) mleczny | : (przym.) mlekowy
lactiferous : lactiferous : (przym.) mleczny
lactometer : lactometer : (rzecz.) laktodensymetr | : (rzecz.) laktometr
lactose : lactose : (rzecz.) laktoza
lacuna : lacuna : (rzecz.) jama
lacy : lacy : (przym.) koronkowy
lad : lad : (rzecz.) chłopak | : (rzecz.) chłopiec | : (rzecz.) młodzian | : (rzecz.) młodzieniec
ladder : ladder : (rzecz.) drabina | : (rzecz.) drabinka | : (rzecz.) oczko
ladder-mending : ladder-mending : (rzecz.) repasacja
lade : lade : (czas.) ładować | : (czas.) władować
laden : laden : (przym.) naładowany | : (przym.) pogrążony
ladies' : ladies' : (przym.) damski
lading : lading : (rzecz.) ładunek | : (rzecz.) załadowanie
ladle : ladle : (rzecz.) chochla | : (rzecz.) czerpak | : (rzecz.) kadź | : (rzecz.) kopyść | : (rzecz.) warząchew | : (rzecz.) warzecha
lady : lady : (rzecz.) dama
lady-killer : lady-killer : (rzecz.) kobieciarz | : (rzecz.) podrywacz
lady-love : lady-love : (rzecz.) flama
ladybird : ladybird : (rzecz.) biedronka
ladybug : ladybug : (rzecz.) biedronka
ladylike : ladylike : (przym.) dystyngowany | : (przym.) wytworny
laevorotation : laevorotation : (rzecz.) lewoskrętność
laevorotatory : laevorotatory : (przym.) lewoskrętny
laevulose : laevulose : (rzecz.) lewuloza
lag : lag : (czas.) obandażować | : (czas.) opóźniać | : (czas.) zwlekać | : (rzecz.) opóźnienie | : (rzecz.) otulina | : (rzecz.) zesłaniec | : (rzecz.) zwłoka
laggard : laggard : (przym.) ospały | : (przym.) powolny | : (przym.) spóźnialski | : (rzecz.) guzdrała | : (rzecz.) maruder | : (rzecz.) opieszalec
lagoon : lagoon : (rzecz.) laguna | : (rzecz.) zalew
laic : laic : (przym.) świecki
laicize : laicize : (czas.) laicyzować | : (czas.) zeświecczać | : (czas.) zlaicyzować
laid : laid : (czas.) nakrywać
lair : lair : (rzecz.) koczowisko | : (rzecz.) kryjówka | : (rzecz.) legowisko | : (rzecz.) szałas
laird : laird : (rzecz.) dziedzic | : (rzecz.) ziemianin
lake : lake : (rzecz.) jeziorko | : (rzecz.) jezioro | : (rzecz.) pojezierze
lam : lam : (czas.) chłostać
lama : lama : (rzecz.) mnich
lamb : lamb : (rzecz.) baranek | : (rzecz.) baranina | : (rzecz.) jagnię | : (rzecz.) jagnięcina | : (rzecz.) roszponka
lambaste : lambaste : (czas.) besztać | : (czas.) młócić
lambent : lambent : (przym.) migotliwy
lambkin : lambkin : (rzecz.) jagniątko
lambrequin : lambrequin : (rzecz.) lambrekin
lambskin : lambskin : (rzecz.) baranek
lame : lame : (czas.) okaleczyć | : (czas.) okulawiać | : (czas.) okulawić | : (przym.) beznogi | : (przym.) chromy | : (przym.) kaleki | : (przym.) kiepski | : (przym.) kulawy | : (przym.) lichy | : (przym.) niepełny | : (przym.) słaby | : (przym.) ułomny | : (przym.) wadliwy
lamella : lamella : (rzecz.) blaszka | : (rzecz.) lamela
lamely : lamely : (przysł.) kulawo | : (przysł.) nieprzekonująco
lameness : lameness : (rzecz.) chromanie | : (rzecz.) ułomność
lament : lament : (czas.) lamentować | : (czas.) opłakiwać | : (czas.) ubolewać | : (rzecz.) lament | : (rzecz.) skarga
lamentable : lamentable : (przym.) opłakany | : (przym.) żałosny
lamentation : lamentation : (rzecz.) lament | : (rzecz.) lamentacja | : (rzecz.) narzekanie
lamentations : lamentations : (rzecz.) biadolenie | : (rzecz.) zawodzenie
lamina : lamina : (rzecz.) blaszka
laminar : laminar : (przym.) blaszkowaty | : (przym.) laminarny
laminate : laminate : (czas.) laminować
lamination : lamination : (rzecz.) laminowanie | : (rzecz.) łupanie | : (rzecz.) rozwarstwienie | : (rzecz.) uwarstwienie
laminitis : laminitis : (rzecz.) ochwat
lamp : lamp : (rzecz.) lampa | : (rzecz.) lampka | : (rzecz.) latarnia
lamp-shade : lamp-shade : (rzecz.) abażur
lampion : lampion : (rzecz.) lampion
lampoon : lampoon : (czas.) ośmieszać | : (rzecz.) pamflet | : (rzecz.) paszkwil
lampooner : lampooner : (rzecz.) pamflecista | : (rzecz.) paszkwilant
lamprey : lamprey : (rzecz.) minóg
lampshade : lampshade : (rzecz.) abażur | : (rzecz.) klosz
lanai : lanai : (rzecz.) weranda
lance : lance : (rzecz.) broń | : (rzecz.) kopia | : (rzecz.) lanca
lancelet : lancelet : (rzecz.) lancetnik
lancer : lancer : (rzecz.) lansjer | : (rzecz.) ułan
lancet : lancet : (rzecz.) łańcuszek
land : land : (czas.) lądować | : (czas.) wylądować | : (czas.) wyładować | : (czas.) wyładowywać | : (czas.) zsiadać | : (rzecz.) budownictwo | : (rzecz.) grunt | : (rzecz.) kraina | : (rzecz.) kraj | : (rzecz.) ląd | : (rzecz.) lądowe | : (rzecz.) teren | : (rzecz.) wieś | : (rzecz.) wyładowywanie | : (rzecz.) ziemia
land-based : land-based : (przym.) lądowy
land-measuring : land-measuring : (rzecz.) miernictwo
landau : landau : (rzecz.) landara | : (rzecz.) lando
landed : landed : (przym.) obszarniczy | : (przym.) twardy | : (przym.) ziemski
landfall : landfall : (rzecz.) lądowisko | : (rzecz.) wybrzeże | : (rzecz.) wylądowanie
landfill : landfill : (rzecz.) składowisko | : (rzecz.) wysypisko
landing : landing : (rzecz.) desant | : (rzecz.) lądowanie | : (rzecz.) podest | : (rzecz.) półpiętro | : (rzecz.) spocznik | : (rzecz.) wyładunek | : (rzecz.) zeskok
landing-place : landing-place : (rzecz.) przystań
landless : landless : (przym.) bezrolny
landlocked : landlocked : (przym.) śródlądowy
landlord : landlord : (rzecz.) gospodarz | : (rzecz.) obszarnik | : (rzecz.) właściciel | : (rzecz.) ziemianin
landmark : landmark : (rzecz.) słup
landmass : landmass : (rzecz.) ląd
landmine : landmine : (rzecz.) mina
landowner : landowner : (rzecz.) obszarnik | : (rzecz.) ziemianin
landrail : landrail : (rzecz.) derkacz
landscape : landscape : (czas.) projektować | : (rzecz.) krajobraz | : (rzecz.) pejzaż
landslide : landslide : (rzecz.) obsunięcie | : (rzecz.) osuwisko | : (rzecz.) zsuw
landslides : landslides : (rzecz.) osuwanie
landslip : landslip : (rzecz.) obsuwisko | : (rzecz.) osuwisko | : (rzecz.) usuwisko | : (rzecz.) zsuw
lane : lane : (rzecz.) aleja | : (rzecz.) alejka | : (rzecz.) droga | : (rzecz.) dróżka | : (rzecz.) drożyna | : (rzecz.) ścieżka | : (rzecz.) tor | : (rzecz.) uliczka | : (rzecz.) zaułek
language : language : (rzecz.) jeżyk | : (rzecz.) język | : (rzecz.) mowa | : (rzecz.) styl
languid : languid : (przym.) apatyczny | : (przym.) leniwy | : (przym.) osłabiony | : (przym.) powolny | : (przym.) znużony | : (przym.) zwiędły
languidly : languidly : (przysł.) omdlewająco
languidness : languidness : (rzecz.) ospałość
languish : languish : (czas.) marnieć | : (czas.) obumierać | : (czas.) omdleć | : (czas.) omdlewać | : (czas.) słabnąć | : (czas.) tęsknić | : (czas.) więdnąć
languishment : languishment : (rzecz.) obumieranie
languor : languor : (rzecz.) apatyczność | : (rzecz.) omdlenie | : (rzecz.) osłabienie | : (rzecz.) rozmarzenie | : (rzecz.) znużenie
languorous : languorous : (przym.) powolny | : (przym.) tęskny
laniary : laniary : (rzecz.) kieł
lank : lank : (przym.) chudy
lanky : lanky : (przym.) chudy
lanner : lanner : (rzecz.) raróg
lanolin : lanolin : (rzecz.) lanolina
lanoline : lanoline : (rzecz.) lanolina
lansquenet : lansquenet : (rzecz.) lancknecht
lantern : lantern : (rzecz.) latarnia
lanthanide : lanthanide : (rzecz.) lantanowiec
lanthanum : lanthanum : (rzecz.) lantan
lanyard : lanyard : (rzecz.) cięgiel | : (rzecz.) talrep
lap : lap : (czas.) chłeptać | : (czas.) chlipać | : (czas.) chlupać | : (czas.) mlaskać | : (czas.) objąć | : (czas.) opłukiwać | : (czas.) otoczyć | : (czas.) pluskać | : (czas.) siorbać | : (czas.) zaleźć | : (czas.) żłopać | : (rzecz.) chlupot | : (rzecz.) docierak | : (rzecz.) etap | : (rzecz.) łono | : (rzecz.) międzyczas | : (rzecz.) obieg | : (rzecz.) okrążenie | : (rzecz.) poła | : (rzecz.) pomyje | : (rzecz.) przykrycie | : (rzecz.) przysłonięcie | : (rzecz.) zakucie | : (rzecz.) zawalcowanie | : (rzecz.) zwój
laparoscopy : laparoscopy : (rzecz.) laparoskopia
lapel : lapel : (rzecz.) klapa | : (rzecz.) wyłóg
lapful : lapful : (rzecz.) zanadrze
lapidary : lapidary : (przym.) lapidarny
lapidate : lapidate : (czas.) ukamienować
lapin : lapin : (rzecz.) królik
lappet : lappet : (rzecz.) fałd | : (rzecz.) płatek
lapse : lapse : (czas.) odpaść | : (czas.) omylić | : (czas.) opaść | : (czas.) zaniedbać | : (rzecz.) gradient | : (rzecz.) lapsus | : (rzecz.) okres | : (rzecz.) omyłka | : (rzecz.) opuszczenie | : (rzecz.) przejęzyczenie | : (rzecz.) przejście | : (rzecz.) uchybienie | : (rzecz.) upływ
laptop : laptop : (rzecz.) laptop
lapwing : lapwing : (rzecz.) czajka
larboard : larboard : (rzecz.) bakburta
larceny : larceny : (rzecz.) kradzież | : (rzecz.) złodziejstwo
larch : larch : (rzecz.) modrzew
lard : lard : (czas.) naszpikować | : (czas.) szpikować | : (rzecz.) sadło | : (rzecz.) słonina | : (rzecz.) smalec
larder : larder : (rzecz.) spiżarnia | : (rzecz.) śpiżarnia
large : large : (przym.) duży | : (przym.) obfity | : (przym.) rozległy | : (przym.) szeroki | : (przym.) wielki | : (przym.) wielkoformatowy
large-hearted : large-hearted : (przym.) wielkoduszny
largely : largely : (przysł.) głównie | : (przysł.) walnie | : (przysł.) wielce | : (przysł.) wyraźnie
largeness : largeness : (rzecz.) grubość | : (rzecz.) obfitość | : (rzecz.) wielkość
largess : largess : (rzecz.) hojność | : (rzecz.) szczodrość
largesse : largesse : (rzecz.) hojność | : (rzecz.) szczodrość
lariat : lariat : (rzecz.) arkan | : (rzecz.) lina
lark : lark : (czas.) brać | : (czas.) figlować | : (czas.) nabrać | : (rzecz.) figiel | : (rzecz.) kawał | : (rzecz.) skowronek
larkspur : larkspur : (rzecz.) ostróżka
larrikin : larrikin : (rzecz.) chuligan
larrup : larrup : (czas.) młócić | : (czas.) naparzać | : (czas.) prać | : (czas.) sprać
larva : larva : (rzecz.) larwa
larval : larval : (przym.) larwalny
laryngeal : laryngeal : (przym.) krtaniowy
laryngitis : laryngitis : (rzecz.) zapalenie
laryngologist : laryngologist : (rzecz.) laryngolog
laryngologists : laryngologists : (rzecz.) laryngolog
laryngoscope : laryngoscope : (rzecz.) laryngoskop
larynx : larynx : (rzecz.) krtań
lascar : lascar : (rzecz.) ind
lascivious : lascivious : (przym.) lubieżny | : (przym.) pożądliwy | : (przym.) sprośny
lasciviousness : lasciviousness : (rzecz.) pożądliwość
laser : laser : (rzecz.) laser
lash : lash : (czas.) biczować | : (czas.) chłostać | : (czas.) osmagać | : (czas.) smagać | : (czas.) zagalopować | : (rzecz.) bicz | : (rzecz.) rzemień | : (rzecz.) rzęsa | : (rzecz.) smagnięcie
lashing : lashing : (rzecz.) chłosta | : (rzecz.) dopinanie | : (rzecz.) mocowanie | : (rzecz.) wiązanie | : (rzecz.) zatrzęsienie
lasing : lasing : (rzecz.) laserowanie
lass : lass : (rzecz.) dziewczątko | : (rzecz.) dziewczę | : (rzecz.) dziewczyna | : (rzecz.) dziewczynka | : (rzecz.) dziewuszka | : (rzecz.) makolągwa | : (rzecz.) panienka
lassie : lassie : (rzecz.) dziewczyna
lassitude : lassitude : (rzecz.) znużenie
last : last : (czas.) ciągać | : (czas.) przetrwać | : (czas.) starczyć | : (czas.) trwać | : (czas.) wystarczać | : (czas.) wystarczyć | : (przym.) ostatni | : (przym.) poprzedni | : (przysł.) ostatnio
last-ditch : last-ditch : (przym.) ostateczny | : (przym.) ostatni
last-minute : last-minute : (przym.) ostatni
lasting : lasting : (przym.) niezmienny | : (przym.) trwały
lastly : lastly : (przysł.) wreszcie
latch : latch : (czas.) zatrzaskiwać | : (rzecz.) klamka | : (rzecz.) rygiel | : (rzecz.) zapadka | : (rzecz.) zatrzask | : (rzecz.) zawora
latchet : latchet : (rzecz.) rzemyk
latchkey : latchkey : (rzecz.) klucz
late : late : (przym.) niedawny | : (przym.) ostatni | : (przym.) poprzedni | : (przym.) późny | : (przysł.) późno
latecomer : latecomer : (rzecz.) spóźnienie
lately : lately : (przysł.) niedawno | : (przysł.) ostatnio
latency : latency : (rzecz.) opóźnienie | : (rzecz.) utajenie | : (rzecz.) zwłoka
lateness : lateness : (rzecz.) niepunktualność | : (rzecz.) spóźnienie
latent : latent : (przym.) ukryty | : (przym.) utajony
later : later : (przym.) późniejszy
lateral : lateral : (przym.) boczny | : (przym.) poboczny | : (przym.) poprzeczny
laterally : laterally : (przysł.) bocznie
latest : latest : (przym.) najnowszy | : (przym.) najpóźniejszy
latex : latex : (rzecz.) lateks | : (rzecz.) mleczko
lath : lath : (rzecz.) deszczułka | : (rzecz.) łata | : (rzecz.) listwa | : (rzecz.) płyta
lathe : lathe : (rzecz.) krosno | : (rzecz.) obrabiarka | : (rzecz.) tokarka | : (rzecz.) tokarnia
lather : lather : (czas.) mydlić | : (czas.) pienić | : (czas.) zapienić | : (rzecz.) piana
lathing : lathing : (rzecz.) łatanie | : (rzecz.) okręcanie | : (rzecz.) toczenie
latitude : latitude : (rzecz.) swoboda | : (rzecz.) szerokość
latria : latria : (rzecz.) kat
latrine : latrine : (rzecz.) kloaka | : (rzecz.) latryna | : (rzecz.) ustęp
latten : latten : (przym.) mosiężny | : (rzecz.) blacha | : (rzecz.) mosiądz
latter : latter : (przym.) drugi | : (przym.) nowszy | : (przym.) ostatni | : (przym.) późniejszy
latter-day : latter-day : (przym.) współczesny
latterly : latterly : (przysł.) ostatnio
lattice : lattice : (rzecz.) krata | : (rzecz.) kratownica
lattice-work : lattice-work : (rzecz.) kratownica
latticework : latticework : (rzecz.) krata | : (rzecz.) kratownica
laud : laud : (czas.) chwalić | : (czas.) gloryfikować | : (czas.) sławić | : (czas.) wysławiać | : (rzecz.) chwała
laudable : laudable : (przym.) chwalebny
laudanum : laudanum : (rzecz.) laudanum
laugh : laugh : (czas.) naśmiać | : (czas.) pośmiać | : (czas.) roześmiać | : (czas.) śmiać | : (czas.) uśmiać | : (czas.) wyśmiać | : (rzecz.) śmiech
laughable : laughable : (przym.) absurdalny | : (przym.) śmieszny | : (przym.) zabawny
laughing-stock : laughing-stock : (rzecz.) pośmiewisko
laughingstock : laughingstock : (rzecz.) pośmiewisko
laughter : laughter : (rzecz.) śmiech
launce : launce : (rzecz.) piskorz
launch : launch : (czas.) odpalać | : (czas.) puszczać | : (czas.) rozpocząć | : (czas.) rzucać | : (czas.) spuszczać | : (czas.) wodować | : (czas.) wypuścić | : (czas.) wypuszczać | : (czas.) wystrzelić | : (czas.) zaangażować | : (czas.) zaczynać | : (czas.) zainaugurować | : (czas.) zwodować | : (rzecz.) łódź | : (rzecz.) szalupa | : (rzecz.) wystrzelenie
launcher : launcher : (rzecz.) granatnik | : (rzecz.) wyrzutnia
launder : launder : (czas.) prać | : (czas.) wyprać
launderette : launderette : (rzecz.) pralnia
laundress : laundress : (rzecz.) praczka
laundry : laundry : (rzecz.) pralnia | : (rzecz.) pranie
laureate : laureate : (rzecz.) laureat
laurel : laurel : (rzecz.) wawrzyn
laurels : laurels : (rzecz.) laury
lava : lava : (rzecz.) lawa | : (rzecz.) lawowanie
lavatory : lavatory : (rzecz.) toaleta | : (rzecz.) ubikacja | : (rzecz.) umywalnia
lave : lave : (czas.) oblewać | : (czas.) umyć
lavender : lavender : (rzecz.) lawenda
laver : laver : (rzecz.) chrzcielnica | : (rzecz.) kropielnica | : (rzecz.) sadzawka | : (rzecz.) umywalnia
lavish : lavish : (czas.) obdarzać | : (czas.) szafować | : (przym.) hojny | : (przym.) obfity | : (przym.) rozrzutny | : (przym.) sowity
lavishly : lavishly : (przysł.) hojnie | : (przysł.) sowicie
lavishness : lavishness : (rzecz.) hojność | : (rzecz.) wystawność
law : law : (rzecz.) legislacja | : (rzecz.) nakaz | : (rzecz.) ordynacja | : (rzecz.) prawo | : (rzecz.) praworządność | : (rzecz.) przepis | : (rzecz.) statut | : (rzecz.) ustawa | : (rzecz.) zasada
law-abiding : law-abiding : (przym.) prawomyślny | : (przym.) praworządny
law-breaker : law-breaker : (rzecz.) gwałciciel | : (rzecz.) przestępca
lawbreaker : lawbreaker : (rzecz.) delikwent | : (rzecz.) gwałciciel | : (rzecz.) przestępca
lawful : lawful : (przym.) legalny | : (przym.) prawny | : (przym.) prawowity
lawfully : lawfully : (przysł.) legalnie | : (przysł.) prawowicie
lawfulness : lawfulness : (rzecz.) legalność | : (rzecz.) praworządność
lawgiver : lawgiver : (rzecz.) prawodawca
lawless : lawless : (przym.) anarchiczny | : (przym.) bezprawny
lawlessly : lawlessly : (przysł.) bezprawnie | : (przysł.) samowolnie
lawlessness : lawlessness : (rzecz.) anarchia | : (rzecz.) bezprawie | : (rzecz.) rozwiązłość | : (rzecz.) samowola
lawmaker : lawmaker : (rzecz.) prawodawca | : (rzecz.) ustawodawca
lawmaking : lawmaking : (rzecz.) ustawodawstwo
lawn : lawn : (rzecz.) murawa | : (rzecz.) polana | : (rzecz.) trawnik
lawnmower : lawnmower : (rzecz.) kosiarka
lawrencium : lawrencium : (rzecz.) lorens
lawsuit : lawsuit : (rzecz.) pozew | : (rzecz.) proces
lawyer : lawyer : (rzecz.) adwokat | : (rzecz.) mecenas | : (rzecz.) prawnik
lax : lax : (przym.) luźny | : (przym.) niestaranny | : (przym.) rozwiązły | : (przym.) swobodny | : (przym.) zwiędły
laxity : laxity : (rzecz.) nieobyczajność | : (rzecz.) pobłażliwość | : (rzecz.) rozluźnienie
lay : lay : (czas.) kłaść | : (czas.) nakryć | : (czas.) nakrywać | : (czas.) nieść | : (czas.) pokładać | : (czas.) położyć | : (czas.) powalić | : (czas.) układać | : (czas.) wyznaczyć | : (przym.) laicki | : (przym.) świecki | : (rzecz.) pieśń
lay-by : lay-by : (rzecz.) bocznica | : (rzecz.) zatoka
lay-out : lay-out : (rzecz.) rozmieszczenie | : (rzecz.) rozplanowanie | : (rzecz.) układ | : (rzecz.) wytyczenie
layabout : layabout : (rzecz.) bumelant | : (rzecz.) leń | : (rzecz.) leser
layer : layer : (czas.) rozkrzewiać | : (rzecz.) cieniowanie | : (rzecz.) nakładacz | : (rzecz.) nawarstwienie | : (rzecz.) nioska | : (rzecz.) pokład | : (rzecz.) pokrywa | : (rzecz.) powłoka | : (rzecz.) układacz | : (rzecz.) warstwa
layer-cake : layer-cake : (rzecz.) tort
layered : layered : (przym.) warstwowy
layette : layette : (rzecz.) wyprawka
layman : layman : (rzecz.) amator | : (rzecz.) dyletant | : (rzecz.) laik | : (rzecz.) niefachowiec
layoff : layoff : (czas.) zwalniać | : (rzecz.) ograniczenie | : (rzecz.) przestój
layout : layout : (rzecz.) adiustacja | : (rzecz.) edycja | : (rzecz.) rozmieszczenie | : (rzecz.) rozplanowanie | : (rzecz.) układ
laze : laze : (czas.) popróżnować | : (czas.) próżnować
laziness : laziness : (rzecz.) daremność | : (rzecz.) guzdralstwo | : (rzecz.) lenistwo | : (rzecz.) nygusostwo | : (rzecz.) opieszałość | : (rzecz.) próżniactwo | : (rzecz.) rozleniwienia | : (rzecz.) wygodnictwo
lazy : lazy : (przym.) gnuśny | : (przym.) leniwy | : (przym.) powolny | : (przym.) próżniaczy | : (przym.) wygodny
lazybones : lazybones : (rzecz.) leń | : (rzecz.) leniuch | : (rzecz.) nygus | : (rzecz.) próżniak
lb : lb : (rzecz.) funt
lea : lea : (rzecz.) łąka | : (rzecz.) pasemko | : (rzecz.) polana | : (rzecz.) polanka
leach : leach : (czas.) ługować | : (czas.) płukać
lead : lead : (czas.) doprowadzać | : (czas.) doprowadzić | : (czas.) dowodzić | : (czas.) dyrygować | : (czas.) interliniować | : (czas.) kierować | : (czas.) namawiać | : (czas.) poprowadzić | : (czas.) powodzić | : (czas.) prowadzić | : (czas.) przewodzić | : (czas.) przodować | : (czas.) skłonić | : (czas.) zaprowadzić | : (rzecz.) doprowadzenie | : (rzecz.) grafit | : (rzecz.) kierownictwo | : (rzecz.) ołów | : (rzecz.) ołowiowanie | : (rzecz.) poprowadzenie | : (rzecz.) prowadzenie | : (rzecz.) przewód | : (rzecz.) smycz | : (rzecz.) trop | : (rzecz.) wieść | : (rzecz.) wyprowadzenie | : (rzecz.) zacisk | : (rzecz.) zagrywka
lead-coated : lead-coated : (przym.) ołowiowany
lead-free : lead-free : (przym.) bezołowiowy
lead-in : lead-in : (rzecz.) doprowadzenie | : (rzecz.) wprowadzenie
lead-off : lead-off : (rzecz.) zapoczątkowanie
leaded : leaded : (przym.) ołowiany | : (przym.) ołowiowy
leaden : leaden : (przym.) ołowiany
leader : leader : (rzecz.) hegemon | : (rzecz.) kierownik | : (rzecz.) lider | : (rzecz.) prowodyr | : (rzecz.) prym | : (rzecz.) przewodnik | : (rzecz.) przodownik | : (rzecz.) przywódca | : (rzecz.) szef
leader's : leader's : (przym.) przywódczy
leadership : leadership : (rzecz.) kierownictwo | : (rzecz.) naczelnictwo | : (rzecz.) przewodnictwo | : (rzecz.) przewodzenie | : (rzecz.) przodownictwo | : (rzecz.) przywództwo
leading : leading : (przym.) czołowy | : (przym.) główny | : (przym.) kierowniczy | : (przym.) pierwszoplanowy | : (przym.) prowadzący | : (przym.) przewodni | : (przym.) wybitny | : (przym.) wyprzedzający | : (rzecz.) etylizowanie | : (rzecz.) ołowiowanie | : (rzecz.) paliw
leadoff : leadoff : (rzecz.) zapoczątkowanie
leads : leads : (rzecz.) obciążnik | : (rzecz.) przewodnik
leady : leady : (przym.) ołowiany
leaf : leaf : (rzecz.) folia | : (rzecz.) karta | : (rzecz.) kartka | : (rzecz.) liść | : (rzecz.) lista | : (rzecz.) listek
leafage : leafage : (rzecz.) listowie | : (rzecz.) ulistnienie
leafiest : leafiest : (przym.) emaliowany | : (przym.) liściasty
leafless : leafless : (przym.) bezlistny
leaflet : leaflet : (rzecz.) broszurka | : (rzecz.) druczek | : (rzecz.) kartka | : (rzecz.) listek | : (rzecz.) ulotka
leafy : leafy : (przym.) bujny | : (przym.) liściasty
league : league : (rzecz.) ekstraklasa | : (rzecz.) klasa | : (rzecz.) liga | : (rzecz.) mila | : (rzecz.) poziom | : (rzecz.) związek
leaguer : leaguer : (rzecz.) ligowiec
leak : leak : (czas.) cieknąć | : (czas.) przeciekać | : (czas.) sączyć | : (czas.) ujawniać | : (czas.) ulatniać | : (czas.) wyciekać | : (rzecz.) ciec | : (rzecz.) dziura | : (rzecz.) nieszczelność | : (rzecz.) pęknięcie | : (rzecz.) przeciek | : (rzecz.) wyciek
leakage : leakage : (rzecz.) przeciek | : (rzecz.) przeciekanie | : (rzecz.) ulatnianie | : (rzecz.) upływność | : (rzecz.) wyciek | : (rzecz.) wyciekanie
leakiness : leakiness : (rzecz.) nieszczelność
leaky : leaky : (przym.) dziurawy | : (przym.) niedyskretny | : (przym.) nieszczelny | : (przym.) przeciekający
lean : lean : (czas.) chylić | : (czas.) nachylić | : (czas.) opierać | : (czas.) pochylać | : (czas.) przechylać | : (czas.) przechylić | : (czas.) wychylać | : (przym.) chudy | : (przym.) nieurodzajny | : (przym.) niskokaloryczny | : (przym.) szczupły | : (przym.) ubogi
lean-to : lean-to : (rzecz.) oficyna | : (rzecz.) przybudówka
leaning : leaning : (rzecz.) przechylanie | : (rzecz.) skłonność | : (rzecz.) wychylanie
leanness : leanness : (rzecz.) chudość | : (rzecz.) słabość
leap : leap : (czas.) przeskoczyć | : (czas.) skakać | : (rzecz.) podskok | : (rzecz.) skok | : (rzecz.) sus
leapt : leapt : (czas.) przeskoczyć
learn : learn : (czas.) dowiadywać | : (czas.) dowiedzieć | : (czas.) nauczyć | : (czas.) poznać | : (czas.) rozeznawać | : (czas.) uczyć
learnedly : learnedly : (przysł.) naukowo | : (przysł.) uczenie
learner : learner : (rzecz.) uczeń
learning : learning : (rzecz.) erudycja | : (rzecz.) nauka | : (rzecz.) poznawanie | : (rzecz.) uczoność | : (rzecz.) wiedza
lease : lease : (czas.) arendować | : (czas.) dzierżawić | : (czas.) najmować | : (czas.) wydzierżawiać | : (czas.) wydzierżawić | : (czas.) wynajmować | : (rzecz.) arenda | : (rzecz.) dzierżawa | : (rzecz.) najem | : (rzecz.) wydzierżawienie | : (rzecz.) wynajem
lease-holder : lease-holder : (rzecz.) dzierżawca | : (rzecz.) najemca
leasehold : leasehold : (przym.) dzierżawny | : (rzecz.) arenda | : (rzecz.) dzierżawa
leaseholder : leaseholder : (rzecz.) dzierżawca | : (rzecz.) najemca
leash : leash : (rzecz.) ołów | : (rzecz.) smycz
leasing : leasing : (przym.) leasingowy | : (rzecz.) arenda | : (rzecz.) dzierżawa | : (rzecz.) dzierżawienie
least : least : (przym.) najmniejszy
leather : leather : (rzecz.) skóra
leathered : leathered : (przym.) pierzasty
leatherette : leatherette : (rzecz.) derma
leathering : leathering : (rzecz.) lanie
leathern : leathern : (przym.) skórzany
leatherworker : leatherworker : (rzecz.) rymarz
leathery : leathery : (przym.) łykowaty | : (przym.) skórzasty
leave : leave : (czas.) odejść | : (czas.) odjechać | : (czas.) odjeżdżać | : (czas.) opuścić | : (czas.) opuszczać | : (czas.) pójść | : (czas.) porzucać | : (czas.) porzucić | : (czas.) pozostawiać | : (czas.) pozostawić | : (czas.) schodzić | : (czas.) wyjechać | : (czas.) wyjeżdżać | : (czas.) wyjść | : (czas.) zostawiać | : (czas.) zostawić | : (rzecz.) opuszczenie | : (rzecz.) pożegnanie | : (rzecz.) pozwolenie | : (rzecz.) urlop | : (rzecz.) wychodzenie | : (rzecz.) zwolnienie
leaved : leaved : (przym.) liściasty
leaven : leaven : (czas.) zaczynić | : (rzecz.) drożdże | : (rzecz.) rozczyn | : (rzecz.) zakwas
leaves : leaves : (rzecz.) listowie | : (rzecz.) nać
leavings : leavings : (rzecz.) odpadki | : (rzecz.) pozostałości
lecher : lecher : (rzecz.) lubieżnik | : (rzecz.) rozpustnik
lecherous : lecherous : (przym.) lubieżny | : (przym.) obleśny | : (przym.) rozpustny
lechery : lechery : (rzecz.) lubieżność
lecithin : lecithin : (rzecz.) lecytyna
lectern : lectern : (rzecz.) pulpit
lector : lector : (rzecz.) lektor
lecture : lecture : (czas.) monitować | : (czas.) pouczać | : (czas.) udzielać | : (czas.) udzielić | : (czas.) wykładać | : (czas.) wymawiać | : (rzecz.) odczyt | : (rzecz.) prelekcja | : (rzecz.) wykład
lecturer : lecturer : (rzecz.) adiunkt | : (rzecz.) prelegent | : (rzecz.) prelekcja | : (rzecz.) wykładowca
ledge : ledge : (rzecz.) gzyms | : (rzecz.) listwa | : (rzecz.) półka | : (rzecz.) rafa | : (rzecz.) występ
ledger : ledger : (rzecz.) rejestr | : (rzecz.) ryga
lee : lee : (rzecz.) osłona
leech : leech : (rzecz.) pijawka
leek : leek : (rzecz.) por
leer : leer : (rzecz.) spojrzenie
leery : leery : (przym.) nieufny | : (przym.) ostrożny | : (przym.) podejrzliwy
lees : lees : (rzecz.) fusy | : (rzecz.) osad
leeward : leeward : (przym.) zawietrzny | : (rzecz.) burta
leeway : leeway : (rzecz.) dryf | : (rzecz.) zaległości
left : left : (czas.) opuszczać | : (czas.) pozostawiać | : (czas.) pozostawić | : (czas.) zostawiać | : (przym.) lewicowy | : (przym.) lewostronny | : (przym.) lewy
left-bank : left-bank : (przym.) lewobrzeżny
left-hand : left-hand : (przym.) leworęczny | : (przym.) lewy
left-handed : left-handed : (przym.) leworęczny | : (przym.) leworęki | : (przym.) lewoskrętny
left-handedness : left-handedness : (rzecz.) leworęczność | : (rzecz.) mańkuctwo
left-hander : left-hander : (rzecz.) mańkut
left-sided : left-sided : (przym.) lewostronny
left-wing : left-wing : (przym.) lewicowy | : (rzecz.) lewica
left-winger : left-winger : (rzecz.) lewicowiec
lefthander : lefthander : (przym.) leworęczny | : (rzecz.) mańkut
leftist : leftist : (przym.) lewacki | : (przym.) lewicowy | : (rzecz.) lewak | : (rzecz.) lewicowiec
lefty : lefty : (rzecz.) lewicowiec
leg : leg : (rzecz.) cholewa | : (rzecz.) etap | : (rzecz.) gałąź | : (rzecz.) kończyna | : (rzecz.) łapa | : (rzecz.) lęg | : (rzecz.) noga | : (rzecz.) nogawica | : (rzecz.) nogawka | : (rzecz.) nóżka | : (rzecz.) odnoga | : (rzecz.) udziec
legacy : legacy : (rzecz.) legat | : (rzecz.) spadek | : (rzecz.) spuścizna
legal : legal : (przym.) legalny | : (przym.) prawniczy | : (przym.) prawny | : (przym.) sądowy | : (przym.) ustawowy
legalist : legalist : (rzecz.) legalista
legality : legality : (rzecz.) legalność | : (rzecz.) prawność | : (rzecz.) prawomocność | : (rzecz.) prawowitość
legalization : legalization : (rzecz.) legalizacja | : (rzecz.) uprawomocnienie | : (rzecz.) zalegalizowanie
legalize : legalize : (czas.) legalizować | : (czas.) zalegalizować
legally : legally : (przysł.) legalnie | : (przysł.) prawnie | : (przysł.) sądownie
legate : legate : (rzecz.) legat
legation : legation : (rzecz.) legacja | : (rzecz.) poselstwo
legend : legend : (rzecz.) legenda | : (rzecz.) napis
legendarily : legendarily : (przysł.) legendarnie
legendary : legendary : (przym.) bajeczny | : (przym.) legendarny
legerdemain : legerdemain : (rzecz.) kuglarstwo | : (rzecz.) żonglowanie
legged : legged : (przym.) nożny
legging : legging : (rzecz.) sztylpa
leggings : leggings : (rzecz.) getry
leggy : leggy : (przym.) długonogi
legibility : legibility : (rzecz.) czytelność
legible : legible : (przym.) czytelny
legibly : legibly : (przysł.) czytelnie
legion : legion : (rzecz.) legia | : (rzecz.) legion
legionary : legionary : (przym.) legionowy | : (rzecz.) legionista
legionnaire : legionnaire : (rzecz.) legionista
legislate : legislate : (czas.) ustanawiać
legislation : legislation : (rzecz.) legislacja | : (rzecz.) prawodawstwo | : (rzecz.) ustawodawstwo
legislative : legislative : (przym.) legislacyjny | : (przym.) prawny | : (przym.) prawodawczy | : (przym.) ustawodawczy
legislator : legislator : (rzecz.) prawodawca | : (rzecz.) ustawodawca
legislature : legislature : (rzecz.) legislatura | : (rzecz.) prawodawca | : (rzecz.) ustawodawca
legist : legist : (rzecz.) prawnik
legit : legit : (rzecz.) dramat
legitimacy : legitimacy : (rzecz.) legalizm | : (rzecz.) legalność | : (rzecz.) prawomocność | : (rzecz.) prawowitość | : (rzecz.) słuszność | : (rzecz.) zasadność
legitimate : legitimate : (przym.) legalny | : (przym.) prawidłowy | : (przym.) prawny | : (przym.) prawowity | : (przym.) prawy | : (przym.) ślubny | : (przym.) słuszny | : (przym.) zasadny
legitimately : legitimately : (przysł.) słusznie
legitimize : legitimize : (czas.) legalizować | : (czas.) sankcjonować | : (czas.) usankcjonować | : (czas.) usprawiedliwiać | : (czas.) uzasadniać
legless : legless : (przym.) beznogi
legs : legs : (rzecz.) golenie | : (rzecz.) kosarz
legume : legume : (rzecz.) jarzyna | : (rzecz.) strączek | : (rzecz.) strąk | : (rzecz.) warzywo
leguminous : leguminous : (przym.) strączkowy
leisure : leisure : (rzecz.) wypoczynek
leisured : leisured : (przym.) bezczynny
leisurely : leisurely : (przym.) powolny | : (przym.) spokojny | : (przysł.) spokojnie
leman : leman : (rzecz.) bogdanka
lemma : lemma : (rzecz.) lemat
lemming : lemming : (rzecz.) leming
lemon : lemon : (rzecz.) brzydula | : (rzecz.) bubel | : (rzecz.) cytryna
lemon-squeezer : lemon-squeezer : (rzecz.) wyciskacz
lemonade : lemonade : (rzecz.) lemoniada
lemur : lemur : (rzecz.) lemur
lend : lend : (czas.) dodawać | : (czas.) pożyczać | : (czas.) pożyczyć | : (czas.) udzielać | : (czas.) użyczać | : (czas.) wypożyczać
lender : lender : (rzecz.) kredytodawca | : (rzecz.) pożyczkodawca
length : length : (rzecz.) dług | : (rzecz.) długość | : (rzecz.) długotrwałość | : (rzecz.) dystans | : (rzecz.) kawałek | : (rzecz.) obszerność | : (rzecz.) odcinek | : (rzecz.) odległość | : (rzecz.) rozciągłość | : (rzecz.) staż
lengthen : lengthen : (czas.) nadsztukować | : (czas.) przedłużać | : (czas.) przedłużyć | : (czas.) wydłużyć
lengthener : lengthener : (rzecz.) przedłużacz
lengthiness : lengthiness : (rzecz.) długość | : (rzecz.) drobiazgowość | : (rzecz.) rozwlekłość
lengthways : lengthways : (przym.) wzdłużny
lengthwise : lengthwise : (przysł.) podłużnie | : (przysł.) wzdłużnie
lengthy : lengthy : (przym.) przydługi | : (przym.) sążnisty | : (przym.) tasiemcowy
lenience : lenience : (rzecz.) folgowanie | : (rzecz.) łagodność | : (rzecz.) wyrozumiałość
leniency : leniency : (rzecz.) folgowanie | : (rzecz.) łagodność | : (rzecz.) wyrozumiałość
lenient : lenient : (przym.) łagodny | : (przym.) pobłażliwy
leniently : leniently : (przysł.) łagodnie | : (przysł.) wyrozumiale
lenity : lenity : (rzecz.) wyrozumiałość
lens : lens : (rzecz.) obiektyw | : (rzecz.) soczewka
lent : lent : (czas.) pożyczać
lentil : lentil : (rzecz.) soczewica
lentils : lentils : (rzecz.) soczewica
lentoid : lentoid : (przym.) soczewkowaty
leonine : leonine : (przym.) lwi
leopard : leopard : (rzecz.) lampart
leporine : leporine : (przym.) zajęczy
leprosarium : leprosarium : (rzecz.) leprozorium
leprosy : leprosy : (rzecz.) trąd
leprous : leprous : (przym.) trędowaty
lesbian : lesbian : (przym.) lesbijski | : (rzecz.) lesbijka
lesion : lesion : (rzecz.) obrażenie | : (rzecz.) uszkodzenie
less : less : (przym.) mniej | : (rzecz.) mniej
lessee : lessee : (rzecz.) dzierżawca | : (rzecz.) najemca | : (rzecz.) najmobiorca
lessen : lessen : (czas.) drobnieć | : (czas.) karleć | : (czas.) maleć | : (czas.) pomniejszyć | : (czas.) umniejszać | : (czas.) zmaleć | : (czas.) zmniejszyć
lessening : lessening : (rzecz.) ubytek
lesser : lesser : (przym.) mniejszy
lesson : lesson : (rzecz.) epistoła | : (rzecz.) lekcja | : (rzecz.) nauczka | : (rzecz.) przestroga
let : let : (czas.) dawać | : (czas.) dopuszczać | : (czas.) pozwalać | : (czas.) pozwolić | : (czas.) puszczać | : (czas.) umożliwiać | : (czas.) wynająć | : (czas.) zezwalać | : (czas.) zgadzać
let-up : let-up : (rzecz.) luz | : (rzecz.) przerwa
letdown : letdown : (rzecz.) rozczarowanie | : (rzecz.) schodzenie | : (rzecz.) zawód
lethal : lethal : (przym.) śmiercionośny | : (przym.) śmiertelny | : (przym.) zabójczy
lethality : lethality : (rzecz.) letalność | : (rzecz.) śmiertelność
lethally : lethally : (przysł.) śmiertelnie | : (przysł.) zabójczo
lethargic : lethargic : (przym.) letargiczny
lethargy : lethargy : (rzecz.) letarg | : (rzecz.) ospałość
letter : letter : (rzecz.) dokument | : (rzecz.) list | : (rzecz.) litera | : (rzecz.) literatura | : (rzecz.) pismo | : (rzecz.) pouczenie
lettered : lettered : (przym.) oczytany | : (przym.) wykształcony
letterhead : letterhead : (rzecz.) nagłówek
lettering : lettering : (rzecz.) liternictwo | : (rzecz.) napis
letterset : letterset : (rzecz.) typooffset
lettuce : lettuce : (rzecz.) sałata
letup : letup : (rzecz.) luz | : (rzecz.) przerwa
leucoplast : leucoplast : (rzecz.) leukoplast
leukaemia : leukaemia : (rzecz.) białaczka | : (rzecz.) leukemia
leukocyte : leukocyte : (rzecz.) leukocyt
levanter : levanter : (rzecz.) zbieg
levee : levee : (rzecz.) grobla
level : level : (czas.) równać | : (czas.) wyrównać | : (czas.) zrównać | : (przym.) poziomy | : (przym.) równy | : (rzecz.) libella | : (rzecz.) poziom | : (rzecz.) poziomica | : (rzecz.) poziomnica | : (rzecz.) równia | : (rzecz.) stopień | : (rzecz.) szczebel | : (rzecz.) wysokość
level-headed : level-headed : (przym.) zrównoważony
leveller : leveller : (rzecz.) włóka
levelly : levelly : (przysł.) poziomo
lever : lever : (rzecz.) drążek | : (rzecz.) dźwignia | : (rzecz.) lewar
leverage : leverage : (rzecz.) dźwignia | : (rzecz.) dźwignięcie | : (rzecz.) wpływ
leviathan : leviathan : (rzecz.) lewiatan
levitate : levitate : (czas.) lewitować
levitation : levitation : (rzecz.) lewitacja
levity : levity : (rzecz.) frywolność | : (rzecz.) lekkomyślność | : (rzecz.) lekkość | : (rzecz.) płochość
levorotatory : levorotatory : (przym.) lewoskrętny
levy : levy : (czas.) rekrutować | : (czas.) ściągać | : (rzecz.) cło | : (rzecz.) danina | : (rzecz.) pobieranie | : (rzecz.) pobór | : (rzecz.) ściąganie | : (rzecz.) werbunek
lewd : lewd : (przym.) bezwstydny | : (przym.) jurny | : (przym.) lubieżny | : (przym.) niemoralny | : (przym.) sprośny
lewdly : lewdly : (przysł.) lubieżnie | : (przysł.) niemoralnie
lewdness : lewdness : (rzecz.) jurność | : (rzecz.) niemoralność | : (rzecz.) obsceniczność
lewisite : lewisite : (rzecz.) luizyt
lexeme : lexeme : (rzecz.) leksem
lexical : lexical : (przym.) leksykalny | : (przym.) słownikowy
lexically : lexically : (przysł.) leksykalnie
lexicographer : lexicographer : (rzecz.) leksykograf | : (rzecz.) słownikarz
lexicographical : lexicographical : (przym.) leksykograficzny
lexicographically : lexicographically : (przysł.) leksykograficznie
lexicography : lexicography : (rzecz.) leksykografia | : (rzecz.) słownikarstwo
lexicologist : lexicologist : (rzecz.) leksykolog
lexicology : lexicology : (rzecz.) leksykologia
lexicon : lexicon : (rzecz.) glosariusz | : (rzecz.) leksyka | : (rzecz.) leksykon | : (rzecz.) słownik
liabilities : liabilities : (rzecz.) pasywa
liability : liability : (rzecz.) obciążenie | : (rzecz.) obligo | : (rzecz.) odpowiedzialność | : (rzecz.) zobowiązanie
liable : liable : (przym.) odpowiedzialny | : (przym.) podatny | : (przym.) podlegający
liaise : liaise : (czas.) współpracować
liaison : liaison : (rzecz.) łączność | : (rzecz.) romans | : (rzecz.) stosunek | : (rzecz.) współpraca | : (rzecz.) związek
liana : liana : (rzecz.) liana
liar : liar : (rzecz.) kłamca | : (rzecz.) kłamczuch | : (rzecz.) łgarz
libation : libation : (rzecz.) libacja
libel : libel : (czas.) zniesławić | : (rzecz.) oszczerstwo | : (rzecz.) paszkwil | : (rzecz.) potwarz | : (rzecz.) skarga | : (rzecz.) zniesławienie
libeller : libeller : (rzecz.) oszczerca | : (rzecz.) paszkwilant
libellous : libellous : (przym.) oszczerczy | : (przym.) paszkwilowy
liberal : liberal : (przym.) hojny | : (przym.) liberalny | : (przym.) pobłażliwy | : (przym.) tolerancyjny | : (rzecz.) liberał
liberalism : liberalism : (rzecz.) liberalizm
liberality : liberality : (rzecz.) hojność | : (rzecz.) liberalność | : (rzecz.) szczodrość | : (rzecz.) wielkoduszność | : (rzecz.) wyrozumiałość
liberalization : liberalization : (rzecz.) liberalizacja | : (rzecz.) złagodzenie
liberalize : liberalize : (czas.) liberalizować | : (czas.) zliberalizować
liberalized : liberalized : (czas.) zliberalizować
liberally : liberally : (przysł.) liberalnie
liberally-minded : liberally-minded : (przym.) liberalny
liberate : liberate : (czas.) oswobodzić | : (czas.) uruchamiać | : (czas.) uwalniać | : (czas.) uwolnić | : (czas.) wyzwalać | : (czas.) wyzwolić
liberation : liberation : (rzecz.) oswobodzenie | : (rzecz.) uwolnienie | : (rzecz.) wydzielenie | : (rzecz.) wyzwolenie
liberator : liberator : (rzecz.) oswobodziciel | : (rzecz.) wyzwoliciel
libertarian : libertarian : (rzecz.) obrońca
libertine : libertine : (przym.) libertyński | : (rzecz.) libertyn | : (rzecz.) wolnomyśliciel
liberty : liberty : (rzecz.) przywilej | : (rzecz.) swoboda | : (rzecz.) wolność
libidinous : libidinous : (przym.) lubieżny | : (przym.) zmysłowy
librarian : librarian : (rzecz.) bibliotekarz | : (rzecz.) księgarz
librarianship : librarianship : (rzecz.) bibliotekarstwo | : (rzecz.) bibliotekoznawstwo
library : library : (rzecz.) biblioteka | : (rzecz.) bibliotekarstwo | : (rzecz.) czytelnia | : (rzecz.) książnica | : (rzecz.) księgozbiór
librettist : librettist : (rzecz.) librecista
lice : lice : (rzecz.) wesz | : (rzecz.) wszy
licence : licence : (rzecz.) koncesja | : (rzecz.) licencja | : (rzecz.) pozwolenie | : (rzecz.) samowola
license : license : (czas.) koncesjonować | : (czas.) licencjonować | : (czas.) upoważniać | : (rzecz.) koncesja | : (rzecz.) licencja | : (rzecz.) pozwolenie
licensee : licensee : (rzecz.) koncesjonariusz | : (rzecz.) licencjobiorca
licensor : licensor : (rzecz.) licencjodawca
licentiate : licentiate : (rzecz.) licencjat
licentious : licentious : (przym.) rozwiązły | : (przym.) swawolny
licentiousness : licentiousness : (rzecz.) rozpasanie | : (rzecz.) rozpusta | : (rzecz.) wyuzdanie
lichen : lichen : (rzecz.) liszaj | : (rzecz.) porost
lichenin : lichenin : (rzecz.) lichenina
licit : licit : (przym.) legalny
lick : lick : (czas.) lizać | : (czas.) oblizać | : (czas.) pędzić | : (czas.) pokonać | : (czas.) polizać | : (czas.) poślinić | : (rzecz.) liźnięcie
lickerish : lickerish : (przym.) łakomy | : (przym.) lubieżny | : (przym.) rozpustny
licking : licking : (rzecz.) cięgi | : (rzecz.) lizanie
lickspittle : lickspittle : (rzecz.) lizus | : (rzecz.) wazeliniarz
lid : lid : (rzecz.) dekiel | : (rzecz.) kłamstwo | : (rzecz.) pokrywa | : (rzecz.) pokrywka | : (rzecz.) powieka | : (rzecz.) przykrywa | : (rzecz.) przykrywka | : (rzecz.) wieczko | : (rzecz.) wieko
lido : lido : (rzecz.) kąpielisko
lie : lie : (czas.) bujać | : (czas.) chorować | : (czas.) kłamać | : (czas.) leżeć | : (czas.) łgać | : (czas.) poleżeć | : (czas.) położyć | : (czas.) skłamać | : (czas.) usłać | : (czas.) walać | : (czas.) wylegiwać | : (czas.) zełgać | : (czas.) znajdować | : (rzecz.) blaga | : (rzecz.) kłam | : (rzecz.) kłamstwo | : (rzecz.) legowisko | : (rzecz.) lęgowisko
lie-down : lie-down : (rzecz.) odpoczynek
lie-in : lie-in : (rzecz.) wylegiwanie | : (rzecz.) wyspanie
liege : liege : (przym.) lenniczy | : (przym.) lenny | : (przym.) lojalny | : (przym.) wierny | : (rzecz.) lennik | : (rzecz.) wasal | : (rzecz.) wąsal
liegeman : liegeman : (rzecz.) wasal
lien : lien : (rzecz.) zastaw
lieu : lieu : (rzecz.) miejsce
lieutenancy : lieutenancy : (rzecz.) namiestnictwo | : (rzecz.) porucznikostwo
lieutenant : lieutenant : (rzecz.) kapitan | : (rzecz.) lejtnant | : (rzecz.) podporucznik | : (rzecz.) podpułkownik | : (rzecz.) porucznik | : (rzecz.) zastępca
lieutenant-colonel : lieutenant-colonel : (rzecz.) podpułkownik
life : life : (rzecz.) dożywocie | : (rzecz.) egzystencja | : (rzecz.) energia | : (rzecz.) pożycie | : (rzecz.) trwałość | : (rzecz.) życie | : (rzecz.) żywot | : (rzecz.) żywotność
life-giving : life-giving : (przym.) życiodajny
life-period : life-period : (rzecz.) trwałość
life-saver : life-saver : (rzecz.) ratownik
lifeblood : lifeblood : (rzecz.) krew
lifeboat : lifeboat : (rzecz.) szalupa
lifeguard : lifeguard : (rzecz.) ochroniarz | : (rzecz.) ratownik
lifeless : lifeless : (przym.) beznamiętny | : (przym.) martwy
lifelessly : lifelessly : (przysł.) drętwo | : (przysł.) martwo
lifelessness : lifelessness : (rzecz.) bezruch
lifelike : lifelike : (przym.) realistyczny
lifelong : lifelong : (przym.) dozgonny | : (przym.) dożywotni
lifer : lifer : (rzecz.) dożywotnik
lifesaver : lifesaver : (rzecz.) ratownik
lifesaving : lifesaving : (rzecz.) ratownictwo
lifespan : lifespan : (rzecz.) trwałość | : (rzecz.) trwanie
lifetime : lifetime : (rzecz.) całokształt | : (rzecz.) witalność | : (rzecz.) życie | : (rzecz.) żywotność
lift : lift : (czas.) dźwigać | : (czas.) podnieść | : (czas.) podnosić | : (czas.) podwozić | : (czas.) uchylać | : (czas.) usuwać | : (czas.) znosić | : (rzecz.) dźwig | : (rzecz.) flek | : (rzecz.) podniesienie | : (rzecz.) podnośnik | : (rzecz.) uniesienie | : (rzecz.) wezbranie | : (rzecz.) winda | : (rzecz.) wznoszenie
lift-boy : lift-boy : (rzecz.) windziarz
lift-off : lift-off : (rzecz.) oderwanie | : (rzecz.) poduszkowca
liftboy : liftboy : (rzecz.) windziarz
lifter : lifter : (rzecz.) mechanizm | : (rzecz.) złodziej
lifting : lifting : (rzecz.) podnoszenie | : (rzecz.) rozwiewanie | : (rzecz.) unoszenie | : (rzecz.) wykopki | : (rzecz.) zniesienie
ligament : ligament : (rzecz.) ścięgno | : (rzecz.) wiązadło
ligature : ligature : (rzecz.) bandaż | : (rzecz.) ligatura | : (rzecz.) opatrunek | : (rzecz.) podwiązanie
light : light : (czas.) dnieć | : (czas.) oświetlać | : (czas.) oświetlić | : (czas.) rozpalać | : (czas.) rozświetlać | : (czas.) świecić | : (czas.) zapalać | : (czas.) zapałać | : (czas.) zapalić | : (czas.) zapłonąć | : (przym.) jasny | : (przym.) łagodny | : (przym.) lekki | : (przym.) lekkomyślny | : (przym.) lekkostrawny | : (przym.) świetlny | : (przym.) wesoły | : (przym.) widny | : (rzecz.) ogień | : (rzecz.) światełko | : (rzecz.) światło | : (rzecz.) światłość
light-blue : light-blue : (przym.) jasnoniebieski
light-fingered : light-fingered : (przym.) zręczny
light-footed : light-footed : (przym.) chyży | : (przym.) zwinny
light-green : light-green : (przym.) jasnozielony
light-hearted : light-hearted : (przym.) niefrasobliwy | : (przym.) radosny | : (przym.) żartobliwy
light-heartedness : light-heartedness : (rzecz.) beztroska | : (rzecz.) niefrasobliwość
light-minded : light-minded : (przym.) beztroski | : (przym.) lekkomyślny
light-proof : light-proof : (przym.) światłoszczelny
light-red : light-red : (przym.) jasnoczerwony
light-resistant : light-resistant : (przym.) światłoodporny
light-sensitive : light-sensitive : (przym.) światłoczuły
lighten : lighten : (czas.) błyskać | : (czas.) błyszczeć | : (czas.) odciążyć | : (czas.) oświecać | : (czas.) oświecić | : (czas.) oświetlać | : (czas.) przejaśniać | : (czas.) rozjaśniać | : (czas.) rozjaśnić | : (czas.) ulżyć | : (czas.) zelżyć
lighting : lighting : (rzecz.) oświetlenie | : (rzecz.) rozpalenie | : (rzecz.) światło | : (rzecz.) zapalanie | : (rzecz.) zapalenie
lightly : lightly : (przysł.) jasno | : (przysł.) lekceważąco | : (przysł.) lekko
lightness : lightness : (rzecz.) jasność | : (rzecz.) lekkość
lightning : lightning : (przym.) błyskawicowy | : (rzecz.) błyskawica | : (rzecz.) piorun | : (rzecz.) wyładowanie
lightning-conductor : lightning-conductor : (rzecz.) piorunochron
lightning-rod : lightning-rod : (rzecz.) piorunochron
lightproof : lightproof : (przym.) światłoszczelny
lightship : lightship : (rzecz.) latarniowiec
lightsome : lightsome : (przym.) lekki | : (przym.) niefrasobliwy
lightweight : lightweight : (przym.) lekki
ligneous : ligneous : (przym.) drewniany | : (przym.) drzewiasty
lignifying : lignifying : (rzecz.) drewnienie
lignin : lignin : (rzecz.) drzewnik | : (rzecz.) lignina
lignite : lignite : (rzecz.) lignit
ligroin : ligroin : (rzecz.) ligroina
likable : likable : (przym.) miły | : (przym.) sympatyczny
like : like : (czas.) lubić | : (czas.) podobać | : (czas.) spodobać | : (czas.) upodobać | : (przym.) podobny
likeable : likeable : (przym.) miły | : (przym.) sympatyczny
likelihood : likelihood : (rzecz.) możliwość | : (rzecz.) prawdopodobieństwo | : (rzecz.) szansa
likely : likely : (przym.) prawdopodobny | : (przysł.) pewnie | : (przysł.) prawdopodobnie
liken : liken : (czas.) porównywać | : (czas.) upodabniać
likeness : likeness : (rzecz.) podobieństwo | : (rzecz.) podobizna | : (rzecz.) wizerunek
likewise : likewise : (przysł.) podobnie | : (przysł.) również
liking : liking : (czas.) upodobać | : (rzecz.) gust | : (rzecz.) pociąg | : (rzecz.) sympatia | : (rzecz.) upodobanie
lilac : lilac : (przym.) bzowy | : (przym.) fioletowy | : (przym.) lila | : (przym.) liliowy | : (rzecz.) bez
liliaceous : liliaceous : (przym.) liliowaty
lilt : lilt : (rzecz.) pieśń | : (rzecz.) rytm
lilting : lilting : (przym.) melodyjny | : (przym.) śpiewny
lily : lily : (rzecz.) grzybień | : (rzecz.) lilia
lima : lima : (rzecz.) linka
limb : limb : (rzecz.) członek | : (rzecz.) gałąź | : (rzecz.) konar | : (rzecz.) kończyna
limber : limber : (czas.) wygimnastykować
limber^ : limber^ : (przym.) zwinny
limbo : limbo : (rzecz.) otchłań | : (rzecz.) próżnia | : (rzecz.) zawieszenie
lime : lime : (czas.) nawapniać | : (czas.) wapnować | : (rzecz.) lipa | : (rzecz.) wapno
lime-kiln : lime-kiln : (rzecz.) wapiennik
lime-tree : lime-tree : (rzecz.) lipa
limekiln : limekiln : (rzecz.) wapiennik
limerick : limerick : (rzecz.) fraszka | : (rzecz.) limeryk
limestone : limestone : (rzecz.) wapień | : (rzecz.) wapniowiec
limit : limit : (czas.) ograniczać | : (czas.) ograniczyć | : (rzecz.) granica | : (rzecz.) kres | : (rzecz.) obręb | : (rzecz.) ograniczenie | : (rzecz.) zarys
limitation : limitation : (rzecz.) limitacja | : (rzecz.) ograniczenie | : (rzecz.) ograniczoność | : (rzecz.) prekluzja | : (rzecz.) przedawnienie | : (rzecz.) tępota
limited : limited : (przym.) ograniczony
limiter : limiter : (rzecz.) ogranicznik | : (rzecz.) reduktor
limitless : limitless : (przym.) bezgraniczny
limn : limn : (czas.) malować | : (czas.) namalować
limnology : limnology : (rzecz.) limnologia
limo : limo : (rzecz.) limuzyna
limonene : limonene : (rzecz.) limonen
limonite : limonite : (rzecz.) limonit
limousine : limousine : (rzecz.) limuzyna
limp : limp : (czas.) chromać | : (czas.) kulać | : (czas.) kuleć | : (czas.) kuśtykać | : (czas.) utykać | : (przym.) bezwładny | : (przym.) miękki | : (przym.) słaby | : (przym.) wiotki
limpet : limpet : (rzecz.) pijawka
limpid : limpid : (przym.) czysty | : (przym.) klarowny | : (przym.) przejrzysty | : (przym.) przezroczysty | : (przym.) przeźroczysty
limpidity : limpidity : (rzecz.) kryształowość | : (rzecz.) przezroczystość
limply : limply : (przysł.) łatwo | : (przysł.) prosto
limpness : limpness : (rzecz.) słabość
limy : limy : (przym.) kleisty | : (przym.) lepki | : (przym.) wapnisty
linage : linage : (rzecz.) wierszówka
linchpin : linchpin : (rzecz.) przetyczka
linden : linden : (rzecz.) lipa
line : line : (czas.) kreślić | : (czas.) liniować | : (czas.) przekreślać | : (rzecz.) granica | : (rzecz.) kierunek | : (rzecz.) kolejka | : (rzecz.) kreska | : (rzecz.) lina | : (rzecz.) lineał | : (rzecz.) linia | : (rzecz.) linijka | : (rzecz.) rodzaj | : (rzecz.) rząd | : (rzecz.) specjalność | : (rzecz.) szereg | : (rzecz.) sznur | : (rzecz.) szpaler | : (rzecz.) wers | : (rzecz.) wiersz | : (rzecz.) wierszowanie
line-up : line-up : (rzecz.) drużyna | : (rzecz.) skład | : (rzecz.) ustawienie
line-vector : line-vector : (rzecz.) wektor
lineage : lineage : (rzecz.) genealogia | : (rzecz.) pochodzenie | : (rzecz.) ród | : (rzecz.) rodowód
lineal : lineal : (przym.) linearny | : (przym.) linijny | : (przym.) liniowy
linear : linear : (przym.) linearny | : (przym.) linijny | : (przym.) liniowy
linearity : linearity : (rzecz.) linearność | : (rzecz.) liniowość
linearization : linearization : (rzecz.) linearyzacja
linearly : linearly : (przysł.) linearnie
lineation : lineation : (rzecz.) liniowanie
linen : linen : (przym.) lniany | : (przym.) płowy | : (rzecz.) bielizna | : (rzecz.) len | : (rzecz.) płótno | : (rzecz.) pościel | : (rzecz.) tkanina
liner : liner : (rzecz.) konduktor | : (rzecz.) liniowiec | : (rzecz.) podszewka | : (rzecz.) statek | : (rzecz.) wkładka | : (rzecz.) wyłożenie
linesman : linesman : (rzecz.) dróżnik | : (rzecz.) monter
ling : ling : (rzecz.) dorsz
linger : linger : (czas.) marudzić | : (czas.) ociągać | : (czas.) pokutować | : (czas.) zasiedzieć | : (czas.) zwlekać
lingering : lingering : (przym.) ociągający | : (przym.) przeciągły
lingo : lingo : (rzecz.) język
lingua : lingua : (rzecz.) język
lingual : lingual : (przym.) językowy
linguist : linguist : (rzecz.) filolog | : (rzecz.) językoznawca | : (rzecz.) lingwista
linguistic : linguistic : (przym.) językowy | : (przym.) językoznawczy | : (przym.) lingwistyczny
linguistically : linguistically : (przysł.) językoznawczo
linguistics : linguistics : (rzecz.) językoznawstwo | : (rzecz.) lingwistyka
liniment : liniment : (rzecz.) mazidło
lining : lining : (rzecz.) kadzi | : (rzecz.) kreskowanie | : (rzecz.) liniowanie | : (rzecz.) obicie | : (rzecz.) obmurowanie | : (rzecz.) obudowa | : (rzecz.) ocieplacz | : (rzecz.) okładzina | : (rzecz.) podbicie | : (rzecz.) podpinka | : (rzecz.) podszewka | : (rzecz.) podszycie | : (rzecz.) podszywanie | : (rzecz.) wykładanie | : (rzecz.) wykładzina | : (rzecz.) wyklejenie | : (rzecz.) wyściółka
link : link : (czas.) łączyć | : (czas.) połączyć | : (czas.) wiązać | : (rzecz.) człon | : (rzecz.) łącze | : (rzecz.) łącznik | : (rzecz.) łączność | : (rzecz.) ogniwo | : (rzecz.) połączenie | : (rzecz.) powiązanie | : (rzecz.) więź
link-trainer : link-trainer : (rzecz.) trenażer
link-up : link-up : (rzecz.) połączenie
linkage : linkage : (rzecz.) połączenie | : (rzecz.) powiązanie | : (rzecz.) wiązanie
linker : linker : (rzecz.) konsolidator | : (rzecz.) linker
linking : linking : (rzecz.) konsolidacja | : (rzecz.) łączenie | : (rzecz.) wiązanie
linkup : linkup : (rzecz.) połączenie
linnet : linnet : (rzecz.) dzwoniec | : (rzecz.) makolągwa
linoleum : linoleum : (rzecz.) linoleum
linotype : linotype : (rzecz.) linotyp
linsey-woolsey : linsey-woolsey : (rzecz.) materiał
lint : lint : (rzecz.) szarpie
lintel : lintel : (rzecz.) nadproże
lion : lion : (rzecz.) lew
lion's : lion's : (przym.) lwi
lioness : lioness : (rzecz.) lwica
lip : lip : (rzecz.) brzeg | : (rzecz.) krawędź | : (rzecz.) warga
lip-sore : lip-sore : (rzecz.) zajad
lipase : lipase : (rzecz.) lipaza
lipoid : lipoid : (rzecz.) lipid | : (rzecz.) lipoid | : (rzecz.) tłuszczowiec
lipoproteins : lipoproteins : (przym.) lipoproteidy
liposuction : liposuction : (rzecz.) liposukcja
lips : lips : (rzecz.) buzia
lipstick : lipstick : (rzecz.) kredka | : (rzecz.) pomadka | : (rzecz.) szminka
liquate : liquate : (czas.) wytapiać
liquefaction : liquefaction : (rzecz.) skraplanie | : (rzecz.) stopienie
liquefier : liquefier : (rzecz.) skraplacz
liquefy : liquefy : (czas.) skraplać | : (czas.) skroplić | : (czas.) topić | : (czas.) topnieć
liqueur : liqueur : (rzecz.) alkohol | : (rzecz.) likier | : (rzecz.) nalewka
liquid : liquid : (przym.) cieczowy | : (przym.) ciekłokrystaliczny | : (przym.) ciekły | : (przym.) płynny | : (rzecz.) ciecz | : (rzecz.) płyn
liquidambar : liquidambar : (rzecz.) ambra
liquidate : liquidate : (czas.) likwidować | : (czas.) spłacać | : (czas.) upłynnić | : (czas.) zaprzestawać | : (czas.) zlikwidować
liquidation : liquidation : (rzecz.) likwidacja
liquidator : liquidator : (rzecz.) likwidator
liquidity : liquidity : (rzecz.) płynność
liquidize : liquidize : (czas.) przetrzeć
liquidizer : liquidizer : (rzecz.) mikser
liquids : liquids : (rzecz.) cieczenie
liquor : liquor : (rzecz.) likier | : (rzecz.) ług | : (rzecz.) napitek | : (rzecz.) napój | : (rzecz.) płyn | : (rzecz.) trunek
liquorice : liquorice : (rzecz.) lukrecja
lira : lira : (rzecz.) lir
lire : lire : (rzecz.) kłamca
lisp : lisp : (czas.) seplenić | : (rzecz.) seplenienie
lisping : lisping : (rzecz.) seplenienie
lissom : lissom : (przym.) giętki | : (przym.) składny | : (przym.) smukły | : (przym.) zwinny
list : list : (czas.) wyliczać | : (rzecz.) indeks | : (rzecz.) katalog | : (rzecz.) lista | : (rzecz.) przechył | : (rzecz.) spis | : (rzecz.) wykaz
listen : listen : (czas.) czekać | : (czas.) nasłuchiwać | : (czas.) oczekiwać | : (czas.) odsłuchać | : (czas.) odsłuchiwać | : (czas.) posłuchać | : (czas.) przysłuchiwać | : (czas.) słuchać | : (czas.) usłuchać | : (czas.) wsłuchać | : (czas.) wsłuchiwać
listener : listener : (rzecz.) odbiornik | : (rzecz.) radiosłuchacz | : (rzecz.) słuchacz
listing : listing : (rzecz.) listing | : (rzecz.) pozycja | : (rzecz.) wydruk
listless : listless : (przym.) apatyczny | : (przym.) obojętny
listlessly : listlessly : (przysł.) apatycznie
litany : litany : (rzecz.) litania
literacy : literacy : (rzecz.) piśmienność | : (rzecz.) umiejętność
literal : literal : (przym.) autentyczny | : (przym.) dosłowny | : (przym.) literalny | : (przym.) literowy | : (przym.) nieprzenośny | : (przym.) przyziemny | : (rzecz.) literał | : (rzecz.) literat
literality : literality : (rzecz.) dosłowność
literally : literally : (przysł.) dosłownie | : (przysł.) literalnie
literalness : literalness : (rzecz.) dosłowność
literals : literals : (rzecz.) literał
literary : literary : (przym.) literacki | : (przym.) pisarski
literate : literate : (przym.) piśmienny
literature : literature : (rzecz.) literatura | : (rzecz.) literaturoznawstwo | : (rzecz.) piśmiennictwo
litharge : litharge : (rzecz.) glejta
lithe : lithe : (przym.) gibki | : (przym.) giętki | : (przym.) zwinny
lithesome : lithesome : (przym.) smukły | : (przym.) zwinny
lithium : lithium : (rzecz.) lit | : (rzecz.) litowanie
lithograph : lithograph : (czas.) litografować | : (rzecz.) litografia
lithographer : lithographer : (rzecz.) litograf
lithographic : lithographic : (przym.) litograficzny
lithographical : lithographical : (przym.) litograficzny
lithography : lithography : (rzecz.) litografia
lithopone : lithopone : (rzecz.) litopon
lithosphere : lithosphere : (rzecz.) litosfera
litigant : litigant : (przym.) sporny
litigate : litigate : (czas.) procesować | : (czas.) zakwestionować
litigation : litigation : (rzecz.) proces | : (rzecz.) spór
litmus : litmus : (rzecz.) lakmus
litre : litre : (rzecz.) litr
litre-atmosphere : litre-atmosphere : (rzecz.) litroatmosfera
litter : litter : (czas.) podesłać | : (czas.) śmiecić | : (czas.) zaśmiecać | : (rzecz.) barłóg | : (rzecz.) lektyka | : (rzecz.) miot | : (rzecz.) nosze | : (rzecz.) podściółka | : (rzecz.) ściółka | : (rzecz.) śmieci | : (rzecz.) śmiecie | : (rzecz.) wyściółka | : (rzecz.) zaśmiecanie | : (rzecz.) zaśmiecenie | : (rzecz.) żwirek
little : little : (przym.) mały | : (przym.) niewielki | : (rzecz.) drobiazg | : (rzecz.) garnek | : (rzecz.) garnuszek | : (rzecz.) kalendarzyk | : (rzecz.) trochę
littleness : littleness : (rzecz.) drobnostka | : (rzecz.) małość
littoral : littoral : (przym.) litoralny | : (przym.) nadbrzeżny | : (przym.) przybrzeżny | : (rzecz.) pobrzeże
liturgical : liturgical : (przym.) liturgiczny
liturgically : liturgically : (przysł.) liturgicznie
liturgy : liturgy : (rzecz.) liturgia
live : live : (czas.) mieszkać | : (czas.) przeżyć | : (czas.) zamieszkać | : (czas.) żyć | : (przym.) aktualny | : (przym.) ruchomy | : (przym.) żywy | : (przysł.) żywo
livelihood : livelihood : (rzecz.) utrzymanie
liveliness : liveliness : (rzecz.) ożywienie | : (rzecz.) żwawość | : (rzecz.) żywość
livelong : livelong : (przym.) długotrwały
lively : lively : (przym.) rześki | : (przym.) skoczny | : (przym.) szampański | : (przym.) wesoły | : (przym.) witalny | : (przym.) żwawy | : (przym.) żywy
liven : liven : (czas.) ożywiać | : (czas.) ożywić
liver : liver : (rzecz.) wątroba | : (rzecz.) wątróbka
liverish : liverish : (przym.) chory
liverwort : liverwort : (rzecz.) porostnica | : (rzecz.) przylaszczka
livery : livery : (rzecz.) liberia | : (rzecz.) służba | : (rzecz.) strój
liveryman : liveryman : (rzecz.) właściciel
livestock : livestock : (rzecz.) bydło | : (rzecz.) remanent | : (rzecz.) żywiec
livid : livid : (przym.) silny | : (przym.) siny
living : living : (przym.) żywy | : (rzecz.) utrzymanie | : (rzecz.) zamieszkiwanie | : (rzecz.) życie
lixiviate : lixiviate : (czas.) wyługować
lixiviation : lixiviation : (rzecz.) ługowanie
lizard : lizard : (rzecz.) jaszczur | : (rzecz.) jaszczurka
lizard's : lizard's : (przym.) jaszczurczy
llama : llama : (rzecz.) lama | : (rzecz.) wełna
lo-do : lo-do : (rzecz.) zamieszanie
load : load : (czas.) alkoholizować | : (czas.) dźwigać | : (czas.) instalować | : (czas.) lądować | : (czas.) ładować | : (czas.) nabić | : (czas.) obarczyć | : (czas.) obciążać | : (czas.) objuczyć | : (czas.) obładować | : (czas.) obsypać | : (czas.) repetować | : (czas.) władować | : (czas.) załadować | : (rzecz.) brzemię | : (rzecz.) ciężar | : (rzecz.) ładowanie | : (rzecz.) ładunek | : (rzecz.) nośność | : (rzecz.) obciążalność | : (rzecz.) obciążanie | : (rzecz.) obciążenie | : (rzecz.) załadowanie | : (rzecz.) załadunek
loadable : loadable : (przym.) ładowalny
loaded : loaded : (przym.) ładowny | : (przym.) naładowany | : (przym.) obciążony | : (przym.) przydrożny
loader : loader : (rzecz.) ładowacz | : (rzecz.) ładowarka | : (rzecz.) ładownik
loading : loading : (rzecz.) ładowanie | : (rzecz.) obarczenie | : (rzecz.) obciążanie | : (rzecz.) obciążenie | : (rzecz.) załadunek
loadstone : loadstone : (rzecz.) magnetyt
loaf : loaf : (czas.) bumelować | : (czas.) napocząć | : (czas.) nygusować | : (czas.) próżnować | : (czas.) wałęsać | : (rzecz.) bochen | : (rzecz.) bochenek
loafer : loafer : (rzecz.) bumelant | : (rzecz.) latawica | : (rzecz.) łazik | : (rzecz.) nierób | : (rzecz.) nygus | : (rzecz.) obibok | : (rzecz.) próżniak | : (rzecz.) wałkoń | : (rzecz.) włóczęga
loam : loam : (rzecz.) ił
loamy : loamy : (przym.) ilasty
loan : loan : (czas.) pożyczać | : (rzecz.) kredyt | : (rzecz.) pożyczka
loan-word : loan-word : (rzecz.) zapożyczenie
loaner : loaner : (rzecz.) pożyczkobiorca
loanword : loanword : (rzecz.) naleciałość | : (rzecz.) zapożyczenie
loath : loath : (przym.) niechętny | : (przym.) wstrętny
loathe : loathe : (czas.) brzydzić | : (czas.) nienawidzić
loathing : loathing : (rzecz.) obrzydzenie | : (rzecz.) odraza | : (rzecz.) wstręt
loathsome : loathsome : (przym.) wstrętny
lob : lob : (czas.) gramolić | : (czas.) wgramolić
lobby : lobby : (rzecz.) hol | : (rzecz.) kuluary | : (rzecz.) lobby | : (rzecz.) poczekalnia | : (rzecz.) przedpokój | : (rzecz.) przedsionek
lobe : lobe : (rzecz.) garb | : (rzecz.) listek | : (rzecz.) płat | : (rzecz.) płatek | : (rzecz.) występ
lobotomy : lobotomy : (rzecz.) lobotomia
lobster : lobster : (rzecz.) homar
lobworm : lobworm : (rzecz.) dżdżownica | : (rzecz.) glista
local : local : (przym.) lokalny | : (przym.) miejscowy | : (przym.) okoliczny
locale : locale : (rzecz.) widownia
localism : localism : (rzecz.) regionalizm | : (rzecz.) zaściankowość
locality : locality : (rzecz.) miejscowość | : (rzecz.) okolica | : (rzecz.) położenie
localization : localization : (rzecz.) lokalizacja | : (rzecz.) umiejscowienie
localize : localize : (czas.) lokalizować | : (czas.) umiejscawiać | : (czas.) umiejscowić | : (czas.) zlokalizować
localizer : localizer : (rzecz.) lokalizator
locally : locally : (przysł.) lokalnie
locate : locate : (czas.) lokalizować | : (czas.) odszukiwać | : (czas.) osiedlać | : (czas.) osiedlić | : (czas.) sytuować | : (czas.) umiejscawiać | : (czas.) umiejscowić | : (czas.) umieścić | : (czas.) umieszczać | : (czas.) zlokalizować
location : location : (rzecz.) lokacja | : (rzecz.) lokalizacja | : (rzecz.) lokalność | : (rzecz.) miejsce | : (rzecz.) okolica | : (rzecz.) plener | : (rzecz.) położenie | : (rzecz.) umiejscowienie | : (rzecz.) umieszczenie | : (rzecz.) usytuowanie
locative : locative : (rzecz.) miejscownik
locator : locator : (rzecz.) adres | : (rzecz.) lokalizator | : (rzecz.) wskaźnik
loch : loch : (rzecz.) jezioro
lock : lock : (czas.) blokować | : (czas.) obejmować | : (czas.) zaciskać | : (czas.) zamknąć | : (czas.) zamykać | : (czas.) zatrzymywać | : (rzecz.) blokada | : (rzecz.) kłódka | : (rzecz.) kosmyk | : (rzecz.) lok | : (rzecz.) lokaut | : (rzecz.) pukiel | : (rzecz.) rygiel | : (rzecz.) śluza | : (rzecz.) zamek | : (rzecz.) zamknięcie | : (rzecz.) zastawka
lock-jaw : lock-jaw : (rzecz.) katalepsja | : (rzecz.) szczękościsk
lock-out : lock-out : (rzecz.) lokaut | : (rzecz.) odcięcie | : (rzecz.) zablokowanie
lock-up : lock-up : (rzecz.) mamer | : (rzecz.) więzienie | : (rzecz.) zamknięcie | : (rzecz.) zamykanie
lockable : lockable : (przym.) blokowany | : (przym.) zamykany
lockage : lockage : (rzecz.) śluzowanie
locked : locked : (czas.) ryglować
locked-jaw : locked-jaw : (rzecz.) katalepsja | : (rzecz.) szczękościsk
locker : locker : (rzecz.) kabina | : (rzecz.) schowek | : (rzecz.) szafka
locket : locket : (rzecz.) medalion | : (rzecz.) medalionik
lockjaw : lockjaw : (rzecz.) katalepsja | : (rzecz.) szczękościsk | : (rzecz.) tężec
locknut : locknut : (rzecz.) lokaut | : (rzecz.) przeciwnakrętka
lockout : lockout : (rzecz.) lokaut | : (rzecz.) odcięcie | : (rzecz.) zablokowanie
locksmith : locksmith : (rzecz.) ślusarz
lockup : lockup : (rzecz.) garaż | : (rzecz.) więzienie | : (rzecz.) zamknięcie | : (rzecz.) zamykanie
loco : loco : (rzecz.) elektrowóz
locomotion : locomotion : (rzecz.) lokomocja | : (rzecz.) lokomotywa | : (rzecz.) poruszanie | : (rzecz.) ruch
locomotive : locomotive : (rzecz.) lokomotywa | : (rzecz.) parowóz
locus : locus : (rzecz.) położenie | : (rzecz.) umiejscowienie
locust : locust : (rzecz.) szarańcza
locution : locution : (rzecz.) powiedzenie | : (rzecz.) wyrażenie | : (rzecz.) zwrot
lode : lode : (rzecz.) pokład | : (rzecz.) złoże
lodestone : lodestone : (rzecz.) magnetyt
lodge : lodge : (czas.) deponować | : (czas.) kwaterować | : (czas.) protestować | : (czas.) umieścić | : (czas.) umieszczać | : (czas.) wnosić | : (czas.) zakwaterować | : (rzecz.) domek | : (rzecz.) loża | : (rzecz.) oświadczenie | : (rzecz.) portiernia | : (rzecz.) przechowanie | : (rzecz.) stróżówka
lodger : lodger : (rzecz.) lokator | : (rzecz.) sublokator
lodging : lodging : (rzecz.) kwatera | : (rzecz.) kwaterunek | : (rzecz.) mieszkanie | : (rzecz.) nocleg | : (rzecz.) zakwaterowanie | : (rzecz.) złożenie
lodging-house : lodging-house : (rzecz.) pensjonat
lodgings : lodgings : (rzecz.) kwatera | : (rzecz.) lokum | : (rzecz.) mieszkanie
loess : loess : (rzecz.) less
loft : loft : (rzecz.) chór | : (rzecz.) galeria | : (rzecz.) poddasze | : (rzecz.) strych
loftily : loftily : (przysł.) wysoko | : (przysł.) wzniośle
loftiness : loftiness : (rzecz.) wyniosłość | : (rzecz.) wzniosłość
lofty : lofty : (przym.) szczytny | : (przym.) wyniosły | : (przym.) wysoki | : (przym.) wzniosły
log : log : (czas.) notować | : (czas.) ścinać | : (czas.) zanotować | : (rzecz.) bal | : (rzecz.) bela | : (rzecz.) bierwiono | : (rzecz.) dłużyca | : (rzecz.) dziennik | : (rzecz.) kloc | : (rzecz.) kłoda | : (rzecz.) rejestr
log-line : log-line : (rzecz.) loglina
log-rolling : log-rolling : (rzecz.) kumoterstwo
loganberry : loganberry : (rzecz.) jeżyna
logarithm : logarithm : (rzecz.) logarytm
logarithmic : logarithmic : (przym.) logarytmiczny
logarithmically : logarithmically : (przysł.) logarytmicznie
logbook : logbook : (rzecz.) dziennik
logger : logger : (rzecz.) drwal | : (rzecz.) rejestrator
loggerhead : loggerhead : (rzecz.) dureń | : (rzecz.) głupek | : (rzecz.) tępak
loggia : loggia : (rzecz.) lodżia | : (rzecz.) loggia
logging : logging : (rzecz.) logowanie | : (rzecz.) pień | : (rzecz.) rejestracja | : (rzecz.) wyrąb
logic : logic : (przym.) dorzeczny | : (przym.) logiczny | : (rzecz.) logika
logical : logical : (przym.) logiczny | : (przym.) sensowny
logicality : logicality : (rzecz.) logiczność
logically : logically : (przysł.) logicznie
logician : logician : (rzecz.) logik | : (rzecz.) logika
login : login : (czas.) meldować | : (czas.) wejść | : (czas.) zalogować | : (czas.) zarejestrować | : (rzecz.) login | : (rzecz.) logowanie | : (rzecz.) zarejestrowanie
logistic : logistic : (przym.) logistyczny | : (rzecz.) logistyka
logistical : logistical : (przym.) logistyczny
logistically : logistically : (przysł.) logistycznie
logistics : logistics : (rzecz.) kwatermistrzostwo | : (rzecz.) logistyka
logjam : logjam : (rzecz.) korek
logo : logo : (rzecz.) godło
logoff : logoff : (rzecz.) wyrejestrowanie
logon : logon : (czas.) zarejestrować | : (rzecz.) login
logotype : logotype : (rzecz.) logotyp
logout : logout : (czas.) wyjść | : (czas.) wymeldować | : (czas.) wyrejestrować
logrolling : logrolling : (rzecz.) kartel | : (rzecz.) kumoterstwo | : (rzecz.) zrywka
logy : logy : (przym.) ciężki | : (przym.) tępy
loin : loin : (rzecz.) lędźwie | : (rzecz.) polędwica | : (rzecz.) schab
loins : loins : (rzecz.) lędźwie
loiter : loiter : (czas.) bałaganić | : (czas.) łazikować | : (czas.) marudzić | : (czas.) mitrężyć | : (czas.) szwendać | : (czas.) wałęsać | : (czas.) zamarudzić
loiterer : loiterer : (rzecz.) łazik | : (rzecz.) maruda | : (rzecz.) włóczęga
loll : loll : (czas.) próżnować | : (czas.) rozwalać | : (czas.) wywiesić
lollipop : lollipop : (rzecz.) lizak
lollop : lollop : (czas.) kiwać
lollypop : lollypop : (rzecz.) lizak
lone : lone : (przym.) odludny | : (przym.) samotny
loneliness : loneliness : (rzecz.) osamotnienie | : (rzecz.) samotność
lonely : lonely : (przym.) odludny | : (przym.) samotny
loner : loner : (rzecz.) samotnica | : (rzecz.) samotnik
lonesome : lonesome : (przym.) odludny | : (przym.) samotny
long : long : (czas.) pragnąć | : (czas.) stęsknić | : (czas.) tęsknić | : (przym.) długi | : (przym.) długoletni | : (przym.) długowieczny | : (przym.) długowłosy | : (przysł.) dawno | : (przysł.) długo | : (rzecz.) kalesony | : (rzecz.) podróż | : (rzecz.) zasięg
long-distance : long-distance : (przym.) dalekobieżny | : (przym.) długodystansowy | : (przym.) międzymiastowy | : (przym.) zamiejscowy
long-haired : long-haired : (przym.) artystyczny | : (przym.) długowłosy | : (przym.) niekonwencjonalny
long-haul : long-haul : (przym.) daleki
long-lasting : long-lasting : (przym.) długotrwały
long-lived : long-lived : (przym.) długowieczny
long-range : long-range : (przym.) dalekonośny | : (przym.) długofalowy
long-sighted : long-sighted : (przym.) dalekowzroczny
long-term : long-term : (przym.) długofalowy | : (przym.) długookresowy | : (przym.) długoterminowy
long-time : long-time : (przym.) odwieczny | : (przym.) stary
long-winded : long-winded : (przym.) gadatliwy
longboat : longboat : (rzecz.) barkas
longevity : longevity : (rzecz.) długowieczność
longhaired : longhaired : (przym.) artystyczny | : (przym.) długowłosy | : (przym.) niekonwencjonalny
longing : longing : (rzecz.) pragnienie | : (rzecz.) tęsknota
longingly : longingly : (przysł.) pożądliwie
longitude : longitude : (rzecz.) długość
longitudinal : longitudinal : (przym.) denny | : (przym.) podłużny | : (przym.) południkowy | : (przym.) wzdłużny
longitudinally : longitudinally : (przysł.) południkowo
longshoreman : longshoreman : (rzecz.) doker | : (rzecz.) tragarz
longsighted : longsighted : (przym.) dalekowzroczny
longwinded : longwinded : (przym.) gadatliwy
loo : loo : (rzecz.) bardacha | : (rzecz.) kibel | : (rzecz.) ubikacja
look : look : (czas.) patrzeć | : (czas.) popatrzeć | : (czas.) rozejrzeć | : (czas.) rozglądać | : (czas.) spoglądać | : (czas.) spojrzeć | : (czas.) szukać | : (czas.) upilnować | : (czas.) wejrzeć | : (czas.) wyglądać | : (rzecz.) aparycja | : (rzecz.) spoglądanie | : (rzecz.) spojrzenie | : (rzecz.) wygląd
look-alike : look-alike : (rzecz.) imitacja | : (rzecz.) sobowtór
look-out : look-out : (rzecz.) ambona | : (rzecz.) obserwator | : (rzecz.) perspektywa | : (rzecz.) straż | : (rzecz.) widok
looker-on : looker-on : (rzecz.) kibic | : (rzecz.) widz
looking-glass : looking-glass : (rzecz.) lusterko | : (rzecz.) lustro
lookout : lookout : (rzecz.) ambona | : (rzecz.) czujność | : (rzecz.) obserwator | : (rzecz.) perspektywa | : (rzecz.) straż | : (rzecz.) widok
looks : looks : (rzecz.) rozglądanie
lookup : lookup : (rzecz.) odszukiwanie | : (rzecz.) połączenie | : (rzecz.) wyszukiwanie
loom : loom : (czas.) majaczeć | : (czas.) majaczyć | : (czas.) nadchodzić | : (czas.) widnieć | : (czas.) wyłaniać | : (rzecz.) krosno
loon : loon : (rzecz.) gbur | : (rzecz.) głupiec | : (rzecz.) nicpoń | : (rzecz.) nur | : (rzecz.) szaleniec
loony : loony : (przym.) lunatyczny | : (rzecz.) bzik
loop : loop : (czas.) podwiązać | : (rzecz.) kokarda | : (rzecz.) obwód | : (rzecz.) pętelka | : (rzecz.) pętla | : (rzecz.) węzeł | : (rzecz.) zapętlenie | : (rzecz.) zwitka
loophole : loophole : (rzecz.) strzelnica
loose : loose : (czas.) przegrywać | : (czas.) rozluźniać | : (czas.) stracić | : (czas.) strącić | : (czas.) utracić | : (czas.) zatracić | : (przym.) luźny | : (przym.) niedbały | : (przym.) obszerny | : (przym.) swobodny | : (przym.) sypki
loosely : loosely : (przysł.) luźno | : (przysł.) wolno
loosely-coupled : loosely-coupled : (przysł.) luźno
loosen : loosen : (czas.) luzować | : (czas.) obluzować | : (czas.) oderwać | : (czas.) poluzować | : (czas.) rozluźniać | : (czas.) rozluźnić | : (czas.) uwalniać | : (czas.) uwolnić
looseness : looseness : (rzecz.) luz | : (rzecz.) luźność | : (rzecz.) rozchwianie
loosest : loosest : (przym.) luźny
loosestrife : loosestrife : (rzecz.) krwawnica
loot : loot : (czas.) grabić | : (czas.) łupić | : (czas.) szabrować | : (rzecz.) grabież | : (rzecz.) łup | : (rzecz.) łupy | : (rzecz.) zdobycz
looter : looter : (rzecz.) łupieżca | : (rzecz.) szabrownik | : (rzecz.) złodziej
lop : lop : (czas.) obrzynać | : (czas.) odcinać | : (czas.) okrzesywać | : (czas.) wisieć | : (czas.) zwiesić | : (czas.) zwisać
lop-ear : lop-ear : (rzecz.) kłapouch
lope : lope : (rzecz.) sus
lopsided : lopsided : (przym.) krzywy
loquacious : loquacious : (przym.) gadatliwy
lord : lord : (rzecz.) lord | : (rzecz.) pan | : (rzecz.) władca
lordliness : lordliness : (rzecz.) dostojność | : (rzecz.) pańskość
lordly : lordly : (przym.) dostojny | : (przym.) dumny | : (przym.) magnacki | : (przym.) pański | : (przym.) władczy | : (przym.) zarozumiały
lore : lore : (rzecz.) tradycja | : (rzecz.) wiedza
lorgnette : lorgnette : (rzecz.) lorgnon | : (rzecz.) lornetka
lorry : lorry : (rzecz.) ciężarówka | : (rzecz.) lora | : (rzecz.) tir
lose : lose : (czas.) blamować | : (czas.) gubić | : (czas.) niedosłyszeć | : (czas.) postradać | : (czas.) przegrać | : (czas.) przegrywać | : (czas.) speszyć | : (czas.) stracić | : (czas.) tracić | : (czas.) zabłądzić | : (czas.) zgubić
loser : loser : (rzecz.) cienias | : (rzecz.) nieudacznik | : (rzecz.) ofiara | : (rzecz.) palant | : (rzecz.) przegranie
losers : losers : (rzecz.) przegranie
losing : losing : (rzecz.) przegranie | : (rzecz.) przegrywanie | : (rzecz.) stracenie | : (rzecz.) tracenie | : (rzecz.) utracenie
loss : loss : (rzecz.) perta | : (rzecz.) porażka | : (rzecz.) strata | : (rzecz.) szwank | : (rzecz.) ubycie | : (rzecz.) ubytek | : (rzecz.) utrata | : (rzecz.) zaginięcie | : (rzecz.) zatrata | : (rzecz.) zguba
loss-free : loss-free : (przym.) bezstratny
lossless : lossless : (przym.) bezstratny
lost : lost : (czas.) przegrać | : (czas.) stracić | : (czas.) zagubić | : (czas.) zgubić | : (przym.) stracony | : (przym.) utracony | : (przym.) zagubiony
lot : lot : (rzecz.) część | : (rzecz.) dola | : (rzecz.) działka | : (rzecz.) grupa | : (rzecz.) los | : (rzecz.) mnóstwo | : (rzecz.) parcela | : (rzecz.) partia | : (rzecz.) plac | : (rzecz.) seria | : (rzecz.) udział | : (rzecz.) zestaw
lotion : lotion : (rzecz.) emulsja | : (rzecz.) płyn
lots : lots : (rzecz.) krocie | : (rzecz.) mnóstwo
lottery : lottery : (rzecz.) loteria
lotto : lotto : (rzecz.) loteryjka | : (rzecz.) totolotek
lotus : lotus : (rzecz.) lotos | : (rzecz.) lotus
loud : loud : (przym.) donośny | : (przym.) głośny | : (przym.) gromki | : (przym.) gwarny | : (przym.) huczny | : (przym.) krzykliwy
loud-mouthed : loud-mouthed : (przym.) głośny | : (przym.) wrzaskliwy
loud-speaker : loud-speaker : (rzecz.) głośnik | : (rzecz.) megafon
loudhailer : loudhailer : (rzecz.) megafon
loudly : loudly : (przym.) głośny | : (przysł.) głośno | : (przysł.) krzykliwie
loudmouth : loudmouth : (rzecz.) pyskacz
loudmouthed : loudmouthed : (przym.) głośny | : (przym.) wrzaskliwy
loudness : loudness : (rzecz.) donośność | : (rzecz.) głośność
loudspeaker : loudspeaker : (rzecz.) głośnik | : (rzecz.) megafon
lounge : lounge : (czas.) leżeć | : (czas.) próżnować | : (czas.) wylegiwać | : (czas.) wypoczywać | : (rzecz.) hol | : (rzecz.) poczekalnia | : (rzecz.) sala | : (rzecz.) salon | : (rzecz.) wypoczynek
lour : lour : (czas.) krzywić
louse : louse : (rzecz.) gnida | : (rzecz.) wesz | : (rzecz.) węszenie
lousy : lousy : (przym.) kiepski | : (przym.) nędzny | : (przym.) parszywy | : (przym.) wstrętny | : (przym.) wszawy | : (przym.) zawszony
lout : lout : (rzecz.) cham | : (rzecz.) ciura | : (rzecz.) drągal | : (rzecz.) dziad | : (rzecz.) gbur | : (rzecz.) niedołęga | : (rzecz.) niemrawiec
loutish : loutish : (przym.) ciamajdowaty | : (przym.) klocowaty
louver : louver : (rzecz.) żaluzja
lovable : lovable : (przym.) miły | : (przym.) rozkoszny | : (przym.) sympatyczny
love : love : (czas.) kochać | : (czas.) lubić | : (czas.) miłować | : (czas.) pokochać | : (czas.) ubóstwiać | : (czas.) uwielbiać | : (czas.) zakochać | : (rzecz.) luba | : (rzecz.) miłość | : (rzecz.) umiłowanie | : (rzecz.) zaloty | : (rzecz.) zamiłowanie
love-affair : love-affair : (rzecz.) miłostka | : (rzecz.) romans
love-making : love-making : (rzecz.) kochanie
lovebird : lovebird : (rzecz.) papużka
loveliness : loveliness : (rzecz.) powab | : (rzecz.) śliczność
lovely : lovely : (przym.) miły | : (przym.) piękny | : (przym.) prześliczny | : (przym.) śliczny | : (przym.) uroczy
lovemaking : lovemaking : (rzecz.) kochanie
lover : lover : (rzecz.) amant | : (rzecz.) amator | : (rzecz.) kochanek | : (rzecz.) miłośnik | : (rzecz.) wielbiciel
loving : loving : (przym.) tkliwy
lovingly : lovingly : (przysł.) czule | : (przysł.) pieszczotliwie
low : low : (czas.) cichnąć | : (czas.) ryczeć | : (czas.) wyczerpywać | : (przym.) cichy | : (przym.) dolny | : (przym.) niski | : (przym.) niskotemperaturowy | : (przym.) niskowartościowy | : (przym.) podły | : (przym.) słaby | : (przym.) wątły | : (przysł.) cicho | : (przysł.) mało | : (przysł.) nisko | : (rzecz.) łów | : (rzecz.) niż | : (rzecz.) podłość | : (rzecz.) ryczenie | : (rzecz.) świństwo | : (rzecz.) szept
low-ball : low-ball : (rzecz.) dmuchawiec
low-boiling : low-boiling : (przym.) niskowrzący
low-down : low-down : (przym.) niski
low-grade : low-grade : (przym.) niskogatunkowy | : (przym.) niskoprocentowy | : (przym.) niskowartościowy
low-interest : low-interest : (przym.) niskoprocentowy
low-level : low-level : (przym.) niskopoziomowy
low-pass : low-pass : (przym.) dolnoprzepustowy | : (rzecz.) wzmacniacz
low-pressure : low-pressure : (przym.) niskociśnieniowy | : (przym.) niskoprężny
low-speed : low-speed : (przym.) niskoobrotowy | : (przym.) wolnobieżny
lowbrow : lowbrow : (przym.) prymitywny | : (rzecz.) prostak
lower : lower : (czas.) degradować | : (czas.) obniżać | : (czas.) obniżyć | : (czas.) opuszczać | : (czas.) zniżać | : (czas.) zniżyć
lowering : lowering : (rzecz.) obniżka | : (rzecz.) spuszczanie | : (rzecz.) spuszczenie | : (rzecz.) zniżka
lowland : lowland : (rzecz.) nizina
lowly : lowly : (przym.) korny | : (przym.) niski | : (przym.) skromny
lowness : lowness : (rzecz.) niskość
loyal : loyal : (przym.) lojalny | : (przym.) prawomyślny | : (przym.) wierny
loyalist : loyalist : (rzecz.) lojalista
loyally : loyally : (przysł.) lojalnie
loyalty : loyalty : (rzecz.) lojalność | : (rzecz.) prawomyślność | : (rzecz.) wierność
lozenge : lozenge : (rzecz.) romb | : (rzecz.) tabletka
lubber : lubber : (rzecz.) majtek | : (rzecz.) niedołęga
lubricant : lubricant : (rzecz.) smar
lubricate : lubricate : (czas.) natłuścić | : (czas.) oliwić | : (czas.) posmarować | : (czas.) smarować | : (czas.) tłuścić
lubrication : lubrication : (rzecz.) natłuszczenie | : (rzecz.) oliwienie | : (rzecz.) smarowanie
lubricator : lubricator : (rzecz.) lubrykator | : (rzecz.) oliwiarka | : (rzecz.) smar | : (rzecz.) smarowacz | : (rzecz.) smarownica
lucent : lucent : (przym.) lśniący | : (przym.) przezroczysty | : (przym.) przeźroczysty
lucid : lucid : (przym.) jasny | : (przym.) lśniący | : (przym.) przezroczysty | : (przym.) przeźroczysty
lucidity : lucidity : (rzecz.) blask | : (rzecz.) jasność | : (rzecz.) przezroczystość | : (rzecz.) przeźroczystość
lucidly : lucidly : (przysł.) błyszcząco | : (przysł.) przejrzyście
luck : luck : (rzecz.) fuks | : (rzecz.) powodzenie | : (rzecz.) szczęście | : (rzecz.) traf
luckily : luckily : (przysł.) szczęśliwie
luckless : luckless : (przym.) nieszczęsny
lucky : lucky : (przym.) pomyślny | : (przym.) szczęśliwy | : (przym.) taki
lucrative : lucrative : (przym.) dochodowy | : (przym.) intratny | : (przym.) lukratywny | : (przym.) popłatny
lucratively : lucratively : (przysł.) lukratywnie
lucre : lucre : (rzecz.) zysk
lucubration : lucubration : (rzecz.) elukubracja
luculent : luculent : (przym.) jasny
ludicrous : ludicrous : (przym.) absurdalny | : (przym.) śmieszny
ludicrously : ludicrously : (przysł.) absurdalnie | : (przysł.) śmiesznie
lug : lug : (czas.) ciągnąć | : (czas.) szarpać | : (czas.) taszczyć | : (czas.) zataszczyć
luggage : luggage : (rzecz.) bagaż
lugubrious : lugubrious : (przym.) ponury | : (przym.) przygnębiony | : (przym.) smutny | : (przym.) żałobny | : (przym.) żałosny
lukewarm : lukewarm : (przym.) obojętny
lull : lull : (czas.) ukołysać | : (czas.) uśmierzać | : (czas.) uspokajać | : (czas.) usypiać | : (rzecz.) cisza
lullaby : lullaby : (rzecz.) kołysanka
lulu : lulu : (rzecz.) wariat
lumbago : lumbago : (rzecz.) postrzał
lumbar : lumbar : (przym.) lędźwiowy
lumber : lumber : (rzecz.) drewno | : (rzecz.) graciarnia | : (rzecz.) graty | : (rzecz.) rupiecie | : (rzecz.) tarcica
lumber-mill : lumber-mill : (rzecz.) tartak
lumber-room : lumber-room : (rzecz.) lamus | : (rzecz.) rupieciarnia
lumberjack : lumberjack : (rzecz.) drwal | : (rzecz.) rębacz
lumberman : lumberman : (rzecz.) drwal
lumen : lumen : (rzecz.) lumen
lumen-hour : lumen-hour : (rzecz.) lumenogodzina
lumen-second : lumen-second : (rzecz.) lumenosekunda
luminance : luminance : (rzecz.) jaskrawość | : (rzecz.) luminancja
luminary : luminary : (rzecz.) luminarz
luminescence : luminescence : (rzecz.) jarzenie | : (rzecz.) luminescencja
luminescent : luminescent : (przym.) luminescencyjny
luminosity : luminosity : (rzecz.) świecenie
luminous : luminous : (przym.) bystry | : (przym.) lśniący | : (przym.) świetlny
lummox : lummox : (rzecz.) głupek | : (rzecz.) kołek | : (rzecz.) tuman
lump : lump : (czas.) skawalać | : (czas.) zbrylać | : (rzecz.) bryła | : (rzecz.) gruda | : (rzecz.) grudka | : (rzecz.) guz | : (rzecz.) kawałek | : (rzecz.) niedołęga
lumpfish : lumpfish : (rzecz.) tasza
lumping : lumping : (przym.) zryczałtowany
lumpy : lumpy : (przym.) bryłowaty | : (przym.) grudkowaty | : (przym.) grudkowy
lunacy : lunacy : (rzecz.) obłęd | : (rzecz.) szaleństwo
lunar : lunar : (przym.) blady | : (przym.) księżycowy | : (przym.) synodyczny
lunatic : lunatic : (przym.) niepoczytalny | : (przym.) zwariowany | : (rzecz.) lunatyk | : (rzecz.) obłąkaniec | : (rzecz.) szaleniec | : (rzecz.) wariat
lunation : lunation : (rzecz.) lunacja
lunch : lunch : (rzecz.) lunch | : (rzecz.) obiad | : (rzecz.) posiłek
luncheon : luncheon : (rzecz.) lunch
lunette : lunette : (rzecz.) luneta
lung : lung : (rzecz.) płuco
lunge : lunge : (rzecz.) lonża | : (rzecz.) pchnięcie
lungwort : lungwort : (rzecz.) miodunka | : (rzecz.) płucnik
lupine : lupine : (przym.) wilczy | : (rzecz.) łubin
lupus : lupus : (rzecz.) toczeń | : (rzecz.) wilk
lurch : lurch : (czas.) uchylać | : (rzecz.) przechył | : (rzecz.) przechylenie
lure : lure : (czas.) kusić | : (czas.) mamić | : (czas.) nęcić | : (czas.) przywabiać | : (czas.) skusić | : (czas.) wabić | : (czas.) zwabić | : (rzecz.) mamidło | : (rzecz.) nęcenie | : (rzecz.) omamienie | : (rzecz.) powab | : (rzecz.) przynęta | : (rzecz.) wab | : (rzecz.) wabik | : (rzecz.) zwab
lurid : lurid : (przym.) ponury | : (przym.) straszny | : (przym.) upiorny
luridness : luridness : (rzecz.) tragiczność
lurk : lurk : (czas.) czaić | : (czas.) czyhać | : (czas.) drzemać | : (czas.) obserwować | : (czas.) podpatrywać
lurking-place : lurking-place : (rzecz.) kryjówka
luscious : luscious : (przym.) ckliwy | : (przym.) słodki | : (przym.) soczysty
lusciously : lusciously : (przysł.) czarująco | : (przysł.) łagodnie | : (przysł.) słodko
lush : lush : (przym.) bujny | : (rzecz.) pijak
lust : lust : (czas.) pożądać | : (rzecz.) chuć | : (rzecz.) jurność | : (rzecz.) lubieżność | : (rzecz.) pożądanie | : (rzecz.) pożądliwość | : (rzecz.) żądza
lustful : lustful : (przym.) jurny | : (przym.) lubieżny | : (przym.) obleśny | : (przym.) pożądliwy
lustfully : lustfully : (przysł.) pożądliwie
lustily : lustily : (przysł.) pożądliwie | : (przysł.) silnie
lustiness : lustiness : (rzecz.) krzepkość | : (rzecz.) siła
lustre : lustre : (rzecz.) blask | : (rzecz.) połysk
lustreless : lustreless : (przym.) matowy
lustrous : lustrous : (przym.) błyszczący | : (przym.) połyskujący
lustrum : lustrum : (rzecz.) pięciolecie
lusty : lusty : (przym.) krzepki | : (przym.) silny | : (przym.) tęgi | : (przym.) wesoły | : (przym.) żwawy
lute : lute : (rzecz.) kit | : (rzecz.) lutnia
lutetium : lutetium : (rzecz.) lutet
luxuriance : luxuriance : (rzecz.) bujność
luxuriant : luxuriant : (przym.) bujny | : (przym.) obfity | : (przym.) płodny | : (przym.) przepyszny
luxuriantly : luxuriantly : (przysł.) bujnie | : (przysł.) obficie
luxuriate : luxuriate : (czas.) rosnąć | : (czas.) rozkoszować | : (czas.) wybujać
luxurious : luxurious : (przym.) luksusowy | : (przym.) obfity | : (przym.) zbytkowny
luxuriously : luxuriously : (przysł.) luksusowo
luxury : luxury : (rzecz.) luksus | : (rzecz.) obfitość | : (rzecz.) przepych | : (rzecz.) wykwint | : (rzecz.) zbytek
lyceum : lyceum : (rzecz.) liceum
lye : lye : (rzecz.) fug | : (rzecz.) ług | : (rzecz.) mijanka
lymph : lymph : (rzecz.) limfa | : (rzecz.) wysięk
lymphatic : lymphatic : (przym.) chłonny | : (przym.) limfatyczny
lymphocyte : lymphocyte : (rzecz.) limfocyt
lynch : lynch : (czas.) linczować | : (czas.) zlinczować
lynx : lynx : (rzecz.) ryś
lyre : lyre : (rzecz.) lira
lyric : lyric : (przym.) liryczny | : (rzecz.) liryk | : (rzecz.) poemat
lyrical : lyrical : (przym.) liryczny | : (przym.) nastrojowy
lyrically : lyrically : (przysł.) lirycznie
lyricism : lyricism : (rzecz.) liryka | : (rzecz.) liryzm
lyricist : lyricist : (rzecz.) liryk
lyrics : lyrics : (rzecz.) tekst
lyrist : lyrist : (rzecz.) lirnik | : (rzecz.) liryk
lysine : lysine : (rzecz.) lizyna
