daniel : Daniel : (rzecz.) Daniel
darwinian : Darwinian : (rzecz.) darwinista
darwinism : Darwinism : (rzecz.) darwinizm
dave : Dave : (rzecz.) Dawid
david : David : (rzecz.) Dawid
december : December : (rzecz.) grudzień
diana : Diana : (rzecz.) Diana
dominic : Dominic : (rzecz.) Dominik
dorothy : Dorothy : (rzecz.) Dorota
d : d : (rzecz.) głębokość | : (rzecz.) rozwój
dab : dab : (czas.) dotykać | : (czas.) klepać | : (czas.) łożyć | : (czas.) nałożyć | : (czas.) nanieść | : (czas.) nieść | : (czas.) pobijać | : (czas.) przetrzeć | : (czas.) przykładać | : (czas.) przyłożyć | : (czas.) ścierać | : (czas.) zdejmować | : (rzecz.) dotknięcie | : (rzecz.) dziobnięcie | : (rzecz.) muśnięcie | : (rzecz.) odrobina | : (rzecz.) płastuga | : (rzecz.) szczypta | : (rzecz.) zimnica
dabber : dabber : (rzecz.) tampon
dabble : dabble : (czas.) fuszerować | : (czas.) moczyć | : (czas.) parać | : (czas.) pluskać | : (czas.) spryskiwać | : (czas.) zabawiać | : (czas.) zamoczyć | : (czas.) zwilżać
dabbler : dabbler : (rzecz.) amator
dacha : dacha : (rzecz.) dacza
dachshund : dachshund : (rzecz.) jamnik
dactyl : dactyl : (rzecz.) daktyl
dactylic : dactylic : (przym.) daktyliczny
dad : dad : (rzecz.) tata | : (rzecz.) tato | : (rzecz.) tatuś
dada : dada : (rzecz.) tata
daddy : daddy : (rzecz.) papa | : (rzecz.) tata | : (rzecz.) tato | : (rzecz.) tatulek | : (rzecz.) tatuś
daddy-long-legs : daddy-long-legs : (rzecz.) komarnica | : (rzecz.) kosarz
daddy-longlegs : daddy-longlegs : (rzecz.) komarnica
dado : dado : (rzecz.) gzymsem | : (rzecz.) lamperia
daedal : daedal : (przym.) przemyślny
daemon : daemon : (rzecz.) demon
daemonic : daemonic : (przym.) opętańczy
daff : daff : (czas.) dokazywać
daffodil : daffodil : (rzecz.) narcyz | : (rzecz.) żonkil
daft : daft : (przym.) durny | : (przym.) głupi | : (przym.) przygłupiasty
dagger : dagger : (rzecz.) kindżał | : (rzecz.) puginał | : (rzecz.) sztylet
daggle : daggle : (czas.) szargać
daguerreotype : daguerreotype : (rzecz.) dagerotyp
dahlia : dahlia : (rzecz.) dalia | : (rzecz.) georginia
daily : daily : (przym.) codzienny | : (przym.) dniówkowy | : (przym.) dobowy | : (przym.) dzienny | : (przym.) powszedni | : (przysł.) codziennie | : (przysł.) dziennie | : (rzecz.) dziennik | : (rzecz.) przydział
dainties : dainties : (rzecz.) przysmaki
daintily : daintily : (przysł.) delikatnie
daintiness : daintiness : (rzecz.) delikatność
dainty : dainty : (przym.) delikatny | : (przym.) drobny | : (przym.) elegancki | : (przym.) filigranowy | : (przym.) misterny | : (przym.) wykwintny | : (przym.) zdobny | : (przym.) zgrabny | : (rzecz.) frykas | : (rzecz.) przysmak | : (rzecz.) smakowitość | : (rzecz.) specjał
dairy : dairy : (rzecz.) mleczarnia | : (rzecz.) nabiał | : (rzecz.) udój
dairy-produce : dairy-produce : (rzecz.) nabiał
dairying : dairying : (rzecz.) mleczarnia | : (rzecz.) mleczarstwo
dairymaid : dairymaid : (rzecz.) dojarka | : (rzecz.) krowiarka | : (rzecz.) mleczarka
dairyman : dairyman : (rzecz.) dojarz | : (rzecz.) mleczarz
dais : dais : (rzecz.) platforma | : (rzecz.) podium
daisy : daisy : (rzecz.) margerytka | : (rzecz.) stokrotka
dale : dale : (rzecz.) dolina
dalliance : dalliance : (rzecz.) figlowanie
dally : dally : (czas.) lenić | : (czas.) marudzić | : (czas.) pętać | : (czas.) próżnować | : (czas.) zabawiać
dalmatic : dalmatic : (rzecz.) dalmatyka
dam : dam : (czas.) ogroblić | : (czas.) przegradzać | : (czas.) tamować | : (czas.) zatamować | : (rzecz.) grobla | : (rzecz.) przegroda | : (rzecz.) tama | : (rzecz.) zapora
damage : damage : (czas.) kancerować | : (czas.) nadwerężyć | : (czas.) niszczyć | : (czas.) uszkadzać | : (czas.) uszkodzić | : (czas.) zaszkodzić | : (czas.) zniszczyć | : (rzecz.) awaria | : (rzecz.) niepowodzenie | : (rzecz.) odszkodowanie | : (rzecz.) szkoda | : (rzecz.) uszczerbek | : (rzecz.) uszko | : (rzecz.) uszkodzenie | : (rzecz.) zepsucie | : (rzecz.) zniszczenie
damages : damages : (rzecz.) odszkodowanie | : (rzecz.) szkody
damaging : damaging : (przym.) szkodliwy
damask : damask : (rzecz.) adamaszek | : (rzecz.) inkarnat
dame : dame : (rzecz.) dama | : (rzecz.) kobieta
damn : damn : (czas.) ganić | : (czas.) potępiać | : (czas.) przeklinać | : (rzecz.) przekleństwo
damnable : damnable : (przym.) niegodziwy | : (przym.) nikczemny
damnably : damnably : (przysł.) fatalnie
damnation : damnation : (rzecz.) potępienie
damned : damned : (przym.) cholerny | : (przym.) przeklęty
damp : damp : (czas.) amortyzować | : (czas.) hamować | : (czas.) skrapiać | : (czas.) stłumiać | : (czas.) stłumić | : (czas.) tłumić | : (czas.) zwilżać | : (czas.) zwilżyć | : (przym.) mokry | : (przym.) parny | : (przym.) wilgotny | : (rzecz.) para | : (rzecz.) wilgoć | : (rzecz.) zawilgocenie
dampen : dampen : (czas.) tłumić | : (czas.) zamakać | : (czas.) zwilżać
damper : damper : (rzecz.) amortyzator | : (rzecz.) nawilżacz | : (rzecz.) przepustnica | : (rzecz.) tłumik | : (rzecz.) zwilżacz
damping : damping : (rzecz.) dławienie | : (rzecz.) nawilżanie | : (rzecz.) wilgoć | : (rzecz.) zwilżanie
dampness : dampness : (rzecz.) wilgoć | : (rzecz.) wilgotność
damsel : damsel : (rzecz.) dziewczyna | : (rzecz.) dziewica
damson : damson : (rzecz.) damaszka | : (rzecz.) mirabelka | : (rzecz.) powidło | : (rzecz.) śliwka
dance : dance : (czas.) balować | : (czas.) hasać | : (czas.) pląsać | : (czas.) potańczyć | : (czas.) tańczyć | : (czas.) zatańczyć | : (rzecz.) bal | : (rzecz.) kompozycja | : (rzecz.) potańcówka | : (rzecz.) tan | : (rzecz.) taniec
dancer : dancer : (rzecz.) tancerz
dancing : dancing : (rzecz.) bal | : (rzecz.) tańczenie | : (rzecz.) taniec | : (rzecz.) zabawa
dancing-master : dancing-master : (rzecz.) tancmistrz
dandelion : dandelion : (rzecz.) dmuchawiec | : (rzecz.) mlecz
dander : dander : (rzecz.) złość
dandle : dandle : (czas.) huśtać | : (czas.) kołysać | : (czas.) niańczyć
dandruff : dandruff : (rzecz.) łupież
dandy : dandy : (przym.) elegancki | : (przym.) świetny | : (przym.) wykwintny | : (rzecz.) dandys | : (rzecz.) elegant | : (rzecz.) fircyk | : (rzecz.) strojniś
dandyish : dandyish : (przym.) fircykowaty
dandyism : dandyism : (rzecz.) dandyzm
danger : danger : (rzecz.) groźba | : (rzecz.) niebezpieczeństwo | : (rzecz.) zagrożenie
dangerous : dangerous : (przym.) groźny | : (przym.) niebezpieczny
dangerously : dangerously : (przysł.) niebezpiecznie
dangle : dangle : (czas.) bujać | : (czas.) dyndać | : (czas.) huśtać | : (czas.) majtać | : (czas.) powiewać | : (czas.) wisieć | : (czas.) wymachiwać | : (czas.) zwisać
dank : dank : (przym.) wilgotny
dap : dap : (czas.) wrębiać | : (czas.) zacinać | : (rzecz.) wrąb | : (rzecz.) zacios
daphnia : daphnia : (rzecz.) dafnia | : (rzecz.) rozwielitka
dapper : dapper : (przym.) elegancki | : (przym.) wytworny | : (przym.) żywy | : (rzecz.) dziarskość | : (rzecz.) elegancja | : (rzecz.) smukłość | : (rzecz.) wytworność | : (rzecz.) zadbanie | : (rzecz.) żywość
dapple : dapple : (czas.) cętkować | : (przym.) pstrokaty
dappled : dappled : (przym.) pstrokaty
dare : dare : (czas.) odważać | : (czas.) ośmielać | : (czas.) ośmielić | : (czas.) podpuścić | : (czas.) poważyć | : (czas.) śmieć | : (rzecz.) wyzwanie
dare-devil : dare-devil : (rzecz.) chojrak | : (rzecz.) śmiałek | : (rzecz.) zuch
daredevil : daredevil : (rzecz.) chojrak | : (rzecz.) ryzykant | : (rzecz.) śmiałek
daring : daring : (przym.) brawurowy | : (przym.) śmiały | : (rzecz.) brawura | : (rzecz.) odwaga | : (rzecz.) śmiałość
daringly : daringly : (przysł.) ślicznie
dark : dark : (przym.) ciemnowłosy | : (przym.) ciemny | : (przym.) mroczny | : (przym.) ponury | : (rzecz.) ciemne | : (rzecz.) ciemnica | : (rzecz.) ciemno | : (rzecz.) ciemność | : (rzecz.) mrok | : (rzecz.) zmrok
dark-skinned : dark-skinned : (przym.) ciemnoskóry
darken : darken : (czas.) ciemnieć | : (czas.) mroczyć | : (czas.) nachmurzyć | : (czas.) pochmurnieć | : (czas.) posępnieć | : (czas.) przyciemniać | : (czas.) ściemniać | : (czas.) ściemnieć | : (czas.) zachmurzyć | : (czas.) zaciemniać
darkness : darkness : (rzecz.) ciemnica | : (rzecz.) ciemność | : (rzecz.) mroczność | : (rzecz.) mrok
darkroom : darkroom : (rzecz.) ciemnia
darksome : darksome : (przym.) ciemny
darling : darling : (rzecz.) beniaminek | : (rzecz.) kochanie | : (rzecz.) ulubieniec
darn : darn : (czas.) cerować | : (czas.) zacerować
darnel : darnel : (rzecz.) rajgras
darner : darner : (rzecz.) cerowaczka
darning : darning : (rzecz.) cerowanie
darning-egg : darning-egg : (rzecz.) grzybek
dart : dart : (czas.) ciskać | : (czas.) gnać | : (czas.) lecieć | : (czas.) rzucać | : (czas.) wpadać | : (rzecz.) oszczep | : (rzecz.) rzut | : (rzecz.) rzutek | : (rzecz.) rzutka | : (rzecz.) strzałka
dash : dash : (czas.) ciskać | : (czas.) lecieć | : (czas.) mknąć | : (czas.) niweczyć | : (czas.) obgryzać | : (czas.) obryzgać | : (czas.) pędzić | : (czas.) rozbijać | : (czas.) roztrzaskać | : (czas.) rzucać | : (czas.) trzaskać | : (czas.) walnąć | : (czas.) wpadać | : (czas.) zderzyć | : (rzecz.) brawura | : (rzecz.) dziarskość | : (rzecz.) kreska | : (rzecz.) łącznik | : (rzecz.) myślnik | : (rzecz.) pauza | : (rzecz.) przerywnik | : (rzecz.) zamaszystość | : (rzecz.) zuchowatość
dashing : dashing : (przym.) dziarski | : (przym.) ozdobny | : (przym.) zamaszysty
dashingly : dashingly : (przysł.) fantazyjnie
dastard : dastard : (rzecz.) łachudra | : (rzecz.) tchórz
dastardly : dastardly : (przym.) nikczemny | : (przym.) podły
data : data : (rzecz.) dane | : (rzecz.) informacja
dataset : dataset : (rzecz.) modem
datasheet : datasheet : (rzecz.) dane
date : date : (czas.) chodzić | : (czas.) datować | : (rzecz.) chłopak | : (rzecz.) daktyl | : (rzecz.) daktylowiec | : (rzecz.) data | : (rzecz.) dzień | : (rzecz.) randka | : (rzecz.) schadzka | : (rzecz.) termin
date-palm : date-palm : (rzecz.) daktylowiec
date-stamp : date-stamp : (rzecz.) datownik
dated : dated : (przym.) datowany
dateless : dateless : (przym.) niepamiętny
dateline : dateline : (rzecz.) zniewolenie
dater : dater : (rzecz.) datowanie | : (rzecz.) datownik
dative : dative : (przym.) celownikowy | : (rzecz.) celownik
datum : datum : (rzecz.) fakt | : (rzecz.) punkt | : (rzecz.) znaczenie
daub : daub : (czas.) babrać | : (czas.) mazać | : (czas.) nasmarować | : (czas.) pacykować | : (czas.) smarować | : (czas.) zamazywać | : (rzecz.) bohomaz | : (rzecz.) gips | : (rzecz.) kicz | : (rzecz.) mazanina | : (rzecz.) tynk
dauber : dauber : (rzecz.) bazgracz | : (rzecz.) pacykarz
daughter : daughter : (rzecz.) chrześniak | : (rzecz.) córa | : (rzecz.) córka | : (rzecz.) pochodna | : (rzecz.) synowa
daughter-in-law : daughter-in-law : (rzecz.) synowa
daughterboard : daughterboard : (rzecz.) płyta | : (rzecz.) tablica
daughters’ : daughters’ : (rzecz.) córa
daunt : daunt : (czas.) nastraszyć | : (czas.) odstraszać | : (czas.) onieśmielić | : (czas.) straszyć | : (czas.) zastraszać | : (czas.) zniechęcać
dauphin : dauphin : (rzecz.) delfin
davenport : davenport : (rzecz.) biurko | : (rzecz.) sekretera
davit : davit : (rzecz.) wyciąg | : (rzecz.) żurawik
dawdle : dawdle : (czas.) grzebać | : (czas.) guzdrać | : (czas.) mitrężyć | : (czas.) próżnować
dawdler : dawdler : (rzecz.) guzdrała | : (rzecz.) leń | : (rzecz.) maruda | : (rzecz.) mazgaj
dawn : dawn : (czas.) nastać | : (czas.) świtać | : (czas.) zaświtać | : (rzecz.) brzask | : (rzecz.) jutrzenka | : (rzecz.) początek | : (rzecz.) świt | : (rzecz.) zaranie
day : day : (rzecz.) doba | : (rzecz.) dzień | : (rzecz.) dzionek | : (rzecz.) nakład
day-book : day-book : (rzecz.) dziennik
day-boy : day-boy : (rzecz.) ekstern
day-dream : day-dream : (czas.) marzyć | : (rzecz.) mrzonka
day-dreaming : day-dreaming : (rzecz.) marzycielstwo
day-labourer : day-labourer : (rzecz.) wyrobnik
day-nursery : day-nursery : (rzecz.) żłobek
day-to-day : day-to-day : (przym.) codzienny
daybook : daybook : (rzecz.) dziennik
dayboy : dayboy : (rzecz.) ekstern
daybreak : daybreak : (rzecz.) brzask | : (rzecz.) jutrzenka | : (rzecz.) przedświt | : (rzecz.) świt | : (rzecz.) zaranie | : (rzecz.) zmierzch
daydream : daydream : (czas.) fantazjować | : (czas.) marzyć
daydreamer : daydreamer : (rzecz.) fantasta | : (rzecz.) marzyciel
daylight : daylight : (rzecz.) świt
daylong : daylong : (przym.) całodzienny
days : days : (rzecz.) dzień
daytime : daytime : (rzecz.) dzień
daze : daze : (czas.) oszałamiać | : (czas.) oszołomić
dazzle : dazzle : (czas.) ćmić | : (czas.) olśnić | : (czas.) olśniewać | : (czas.) oślepiać | : (czas.) oszałamiać | : (czas.) razić | : (rzecz.) blask
de-aerate : de-aerate : (czas.) odpowietrzać
de-emulsification : de-emulsification : (rzecz.) demulgowanie
de-emulsifier : de-emulsifier : (rzecz.) demulgator
deacon : deacon : (rzecz.) diakon | : (rzecz.) dziekan
deaconess : deaconess : (rzecz.) diakonisa
deactivate : deactivate : (czas.) dezaktywować | : (czas.) odłączyć | : (czas.) przerywać | : (czas.) uchylać | : (czas.) wstrzymać | : (czas.) znosić
deactivation : deactivation : (rzecz.) dezaktywacja
dead : dead : (przym.) głuchy | : (przym.) martwy | : (przym.) nieczynny | : (przym.) nieruchomy | : (przym.) nieżywy | : (przym.) pewny | : (przym.) zmarły | : (przysł.) całkowicie | : (rzecz.) martwe | : (rzecz.) martwienie | : (rzecz.) martwota | : (rzecz.) nieboszczyk | : (rzecz.) panichida
dead-beat : dead-beat : (przym.) bezodrzutowy | : (przym.) tłumiony
dead-eye : dead-eye : (rzecz.) jufers
dead-on-arrival : dead-on-arrival : (przym.) wybrakowany
deaden : deaden : (czas.) łagodzić | : (czas.) przytępiać | : (czas.) tłumić | : (czas.) zagłuszać
deadener : deadener : (przym.) dźwiękochłonny
deadline : deadline : (rzecz.) termin
deadliness : deadliness : (rzecz.) śmiertelność
deadlock : deadlock : (rzecz.) blokada | : (rzecz.) impas | : (rzecz.) zakleszczenie | : (rzecz.) zastój
deadly : deadly : (przym.) morderczy | : (przym.) śmiercionośny | : (przym.) śmiertelny | : (przym.) zabójczy
deadness : deadness : (rzecz.) martwota
deadweight : deadweight : (rzecz.) nośność | : (rzecz.) obciążnik
deadwood : deadwood : (rzecz.) dejwud
deaf : deaf : (przym.) głuchy
deaf-and-dumb : deaf-and-dumb : (przym.) głuchoniemy
deafen : deafen : (czas.) ogłuszać | : (czas.) ogłuszyć
deafening : deafening : (przym.) huczny | : (przym.) ogłuszający
deafeningly : deafeningly : (przysł.) ogłuszająco
deafness : deafness : (rzecz.) głuchota
deal : deal : (czas.) dotyczyć | : (czas.) handlować | : (czas.) kontaktować | : (czas.) obdzielać | : (czas.) rozdać | : (czas.) rozdawać | : (czas.) rozdzielać | : (czas.) rozprawiać | : (czas.) traktować | : (czas.) uporać | : (czas.) zadawać | : (czas.) załatwiać | : (rzecz.) bal | : (rzecz.) ilość | : (rzecz.) interes | : (rzecz.) mnóstwo | : (rzecz.) porozumienie | : (rzecz.) sprawa | : (rzecz.) tarcica | : (rzecz.) transakcja | : (rzecz.) zgoda
dealer : dealer : (rzecz.) diler | : (rzecz.) handlarz | : (rzecz.) handlowiec | : (rzecz.) krupier | : (rzecz.) kupiec | : (rzecz.) makler | : (rzecz.) rzemieślnik
dealership : dealership : (rzecz.) kupiectwo
dealing : dealing : (rzecz.) handlowanie | : (rzecz.) postępowanie | : (rzecz.) traktowanie | : (rzecz.) uporanie
dealings : dealings : (rzecz.) proceder
dean : dean : (rzecz.) dziekan
deanery : deanery : (rzecz.) dekanat | : (rzecz.) dziekanat
deanship : deanship : (rzecz.) dziekanat
dear : dear : (przym.) drogi | : (przym.) kosztowny | : (przym.) miły | : (przym.) szanowny | : (rzecz.) kochanie
dearly : dearly : (przysł.) drogo | : (przysł.) serdecznie
dearness : dearness : (rzecz.) drożyzna | : (rzecz.) serdeczność
dearth : dearth : (rzecz.) brak | : (rzecz.) drożyzna | : (rzecz.) nędza | : (rzecz.) niedostatek | : (rzecz.) śmierć | : (rzecz.) zgon
death : death : (rzecz.) kostucha | : (rzecz.) pogrzeb | : (rzecz.) śmierć | : (rzecz.) zgon
death-trap : death-trap : (rzecz.) mordownia
deathless : deathless : (przym.) nieśmiertelny
deathly : deathly : (przym.) śmiertelny | : (przym.) trupi
debacle : debacle : (rzecz.) klęska | : (rzecz.) rozgromienie
debar : debar : (czas.) pozbawiać | : (czas.) pozbawić | : (czas.) wykluczyć | : (czas.) zakazywać
debark : debark : (czas.) okorowywać | : (czas.) wylądować | : (czas.) wyładować | : (czas.) wysadzać
debarkation : debarkation : (rzecz.) lądowanie | : (rzecz.) wylądowanie | : (rzecz.) wyładowanie | : (rzecz.) wyładunek
debase : debase : (czas.) deprecjonować | : (czas.) obniżać | : (czas.) poniżać | : (czas.) upodlić
debasement : debasement : (rzecz.) deprecjacja | : (rzecz.) upodlenie
debatable : debatable : (przym.) dyskusyjny | : (przym.) sporny | : (przym.) wątpliwy
debate : debate : (czas.) debatować | : (czas.) dyskutować | : (czas.) obmyślać | : (czas.) omawiać | : (rzecz.) debata | : (rzecz.) dyskusja
debater : debater : (rzecz.) argumentator | : (rzecz.) dyskutant
debauch : debauch : (czas.) psuć | : (czas.) wypaczyć | : (czas.) zdeprawować | : (rzecz.) rozpusta
debauched : debauched : (przym.) rozpustny
debauchee : debauchee : (rzecz.) rozpustnik
debauchery : debauchery : (rzecz.) rozpasanie | : (rzecz.) rozpusta | : (rzecz.) wyuzdanie
debenture : debenture : (rzecz.) obligacja
debilitate : debilitate : (czas.) osłabiać | : (czas.) osłabić | : (czas.) osłaniać | : (czas.) paraliżować
debility : debility : (rzecz.) debilizm | : (rzecz.) niemoc | : (rzecz.) słabość
debit : debit : (czas.) obciążać | : (rzecz.) debet
debonair : debonair : (przym.) elegancki | : (przym.) jowialny | : (przym.) wytworny
debouch : debouch : (czas.) wymaszerować
debrief : debrief : (czas.) egzaminować | : (czas.) wypytywać
debris : debris : (rzecz.) gruz | : (rzecz.) osad | : (rzecz.) rumowisko | : (rzecz.) szczątki | : (rzecz.) złom
debt : debt : (rzecz.) dług | : (rzecz.) wierzytelność | : (rzecz.) zadłużanie | : (rzecz.) zadłużenie
debtor : debtor : (rzecz.) dłużnik
debug : debug : (czas.) czyścić | : (czas.) odpluskwiać | : (czas.) uruchamiać | : (czas.) usuwać | : (czas.) uzdatniać
debunk : debunk : (czas.) demaskować | : (czas.) obalać | : (czas.) odbrązawiać
debus : debus : (czas.) wyładowywać
debut : debut : (rzecz.) debiut
debutant : debutant : (rzecz.) debiutant
debutante : debutante : (rzecz.) debiutant
decade : decade : (rzecz.) dekada | : (rzecz.) dziesięciolecie
decadence : decadence : (rzecz.) dekadencja | : (rzecz.) schyłek | : (rzecz.) upadek
decadency : decadency : (rzecz.) dekadencja | : (rzecz.) dekadentyzm | : (rzecz.) schyłek | : (rzecz.) upadek
decadent : decadent : (przym.) dekadencki | : (przym.) schyłkowy | : (rzecz.) dekadent | : (rzecz.) schyłkowiec
decaffeinated : decaffeinated : (przym.) bezkofeinowy
decagon : decagon : (rzecz.) dziesięciobok | : (rzecz.) dziesięciokąt
decagram : decagram : (rzecz.) dekagram | : (rzecz.) deko
decahedron : decahedron : (rzecz.) dziesięciościan
decal : decal : (przym.) dziesiątkowy | : (rzecz.) kalkomania
decalcification : decalcification : (rzecz.) odwapnianie | : (rzecz.) odwapnienie
decalcify : decalcify : (czas.) odwapniać | : (czas.) odwapnić
decalcomania : decalcomania : (rzecz.) dekalkomania | : (rzecz.) kalkomania
decamp : decamp : (czas.) uciekać
decanal : decanal : (przym.) dziekański
decant : decant : (czas.) dekantować | : (czas.) scedzić
decanter : decanter : (rzecz.) dekanter | : (rzecz.) karafka | : (rzecz.) odstojnik
decapitate : decapitate : (czas.) ścinać | : (czas.) ucinać
decapitation : decapitation : (rzecz.) dekapitacja
decarbonisation : decarbonisation : (rzecz.) dekarbonizacja
decarbonising : decarbonising : (rzecz.) dekarbonizacja
decarburization : decarburization : (rzecz.) odwęglanie
decarburize : decarburize : (czas.) odwęglać | : (czas.) świeżyć
decay : decay : (czas.) butwieć | : (czas.) gnić | : (czas.) marnieć | : (czas.) niszczeć | : (czas.) podupadać | : (czas.) psuć | : (czas.) rozkładać | : (czas.) rozpadać | : (czas.) spróchnieć | : (czas.) walić | : (czas.) zetleć | : (rzecz.) gnicie | : (rzecz.) niszczenie | : (rzecz.) obumarcie | : (rzecz.) podupadanie | : (rzecz.) próchnica | : (rzecz.) próchnienie | : (rzecz.) rozkład | : (rzecz.) rozpad | : (rzecz.) upadek | : (rzecz.) uszkodzenie | : (rzecz.) uwiąd | : (rzecz.) zamieranie | : (rzecz.) zgnicie | : (rzecz.) zgnilizna
decease : decease : (czas.) umierać | : (czas.) umrzeć | : (rzecz.) śmierć | : (rzecz.) zgon
deceased : deceased : (przym.) zmarły
decedent : decedent : (rzecz.) nieboszczyk
deceit : deceit : (rzecz.) fałsz | : (rzecz.) łgarstwo | : (rzecz.) oszukiwanie | : (rzecz.) oszustwo
deceitful : deceitful : (przym.) judaszowy | : (przym.) kłamliwy | : (przym.) oszukańczy | : (przym.) podstępny
deceitfully : deceitfully : (przysł.) kłamliwie | : (przysł.) nieuczciwie
deceitfulness : deceitfulness : (rzecz.) kłamliwość | : (rzecz.) oszukaństwo
deceive : deceive : (czas.) mamić | : (czas.) okłamać | : (czas.) okłamywać | : (czas.) omamiać | : (czas.) omamić | : (czas.) oszukiwać | : (czas.) zwieść | : (czas.) zwodzić
deceiver : deceiver : (rzecz.) kłamca | : (rzecz.) mistyfikator | : (rzecz.) oszust
decelerate : decelerate : (czas.) zmniejszyć | : (czas.) zwalniać
deceleration : deceleration : (rzecz.) opóźnienie
decency : decency : (rzecz.) obyczajność | : (rzecz.) przyzwoitość
decent : decent : (przym.) godziwy | : (przym.) obyczajny | : (przym.) porządny | : (przym.) przyzwoity
decently : decently : (przysł.) przyzwoicie
decentralization : decentralization : (rzecz.) decentralizacja
decentralize : decentralize : (czas.) decentralizować | : (czas.) zdecentralizować
deception : deception : (rzecz.) bałamuctwo | : (rzecz.) fałszowanie | : (rzecz.) oszustwo | : (rzecz.) podstęp | : (rzecz.) zwodzenie
deceptive : deceptive : (przym.) oszukańczy | : (przym.) podstępny | : (przym.) złudny | : (przym.) zwodniczy
deceptively : deceptively : (przysł.) zwodniczo
deceptiveness : deceptiveness : (rzecz.) zawodność | : (rzecz.) zwodniczość
decibel : decibel : (rzecz.) decybel
decidability : decidability : (rzecz.) rozstrzygalność
decidable : decidable : (przym.) rozstrzygalny
decide : decide : (czas.) decydować | : (czas.) postanawiać | : (czas.) przesądzać | : (czas.) rozstrzygać | : (czas.) stwierdzać | : (czas.) umyślić | : (czas.) uradzać | : (czas.) uradzić | : (czas.) wybrać | : (czas.) zadecydować | : (czas.) zdecydować
decided : decided : (przym.) bezsporny | : (przym.) stanowczy | : (przym.) zdecydowany
decidedly : decidedly : (przysł.) kategorycznie | : (przysł.) stanowczo
deciduous : deciduous : (przym.) liściasty
decilitre : decilitre : (rzecz.) decylitr
decimal : decimal : (przym.) dziesiątkowy | : (przym.) dziesiętny | : (przym.) dzietny
decimal-to-binary : decimal-to-binary : (przym.) dziesiętno-dwójkowy
decimal-to-octal : decimal-to-octal : (przym.) dziesiętno-ósemkowy
decimate : decimate : (czas.) dziesiątkować | : (czas.) przerzedzić | : (czas.) zdziesiątkować
decimation : decimation : (rzecz.) dziesiątkowanie | : (rzecz.) zdziesiątkowanie
decimetre : decimetre : (rzecz.) decymetr
decipher : decipher : (czas.) odcyfrować | : (czas.) odcyfrowywać | : (czas.) odszyfrować | : (czas.) rozszyfrować | : (czas.) rozszyfrowywać
decipherment : decipherment : (rzecz.) deszyfrowanie | : (rzecz.) odcyfrowanie | : (rzecz.) odszyfrowanie
decision : decision : (rzecz.) decyzja | : (rzecz.) postanowienie | : (rzecz.) rozstrzygnięcie | : (rzecz.) uchwała | : (rzecz.) ustalenie | : (rzecz.) zdecydowanie
decision-maker : decision-maker : (rzecz.) decydent
decision-making : decision-making : (rzecz.) decydowanie
decisive : decisive : (przym.) decydujący | : (przym.) przełomowy | : (przym.) stanowczy
decisively : decisively : (przysł.) decydująco
decisiveness : decisiveness : (rzecz.) rezolutność | : (rzecz.) stanowczość | : (rzecz.) zdecydowanie
deck : deck : (czas.) pokrywać | : (czas.) stroić | : (czas.) upiększać | : (czas.) zdobić | : (rzecz.) piętro | : (rzecz.) pokład | : (rzecz.) poziom | : (rzecz.) talia | : (rzecz.) ustrojenie
deckchair : deckchair : (rzecz.) leżak
deckhand : deckhand : (rzecz.) majtek
declaim : declaim : (czas.) deklamować | : (czas.) gardłować | : (czas.) przemawiać
declaimer : declaimer : (rzecz.) deklamator
declamation : declamation : (rzecz.) deklamacja | : (rzecz.) deklamowanie
declamatory : declamatory : (przym.) deklamatorski | : (przym.) recytatorski
declaration : declaration : (rzecz.) deklaracja | : (rzecz.) oświadczenie | : (rzecz.) oświadczyny | : (rzecz.) oznajmienie | : (rzecz.) wypowiedzenie | : (rzecz.) wyznanie
declarative : declarative : (przym.) deklaracyjny | : (przym.) deklaratywny
declaratory : declaratory : (przym.) deklaratywny
declare : declare : (czas.) deklarować | : (czas.) licytować | : (czas.) ogłaszać | : (czas.) oświadczać | : (czas.) oświadczyć | : (czas.) oznajmiać | : (czas.) twierdzić | : (czas.) wypowiadać | : (czas.) zadeklarować | : (czas.) zgłaszać
declared : declared : (przym.) stanowczy
declass : declass : (czas.) degradować | : (czas.) deklasować | : (czas.) zdeklasować
declassification : declassification : (rzecz.) odtajnienie
declassify : declassify : (czas.) odtajnić | : (czas.) ujawniać | : (czas.) ujawnić
declension : declension : (rzecz.) deklinacja | : (rzecz.) odchylenie
declinable : declinable : (przym.) odmienny
declination : declination : (rzecz.) deklinacja | : (rzecz.) zboczenie
decline : decline : (czas.) biednieć | : (czas.) blaknąć | : (czas.) chylić | : (czas.) deklinować | : (czas.) obniżać | : (czas.) odrzucać | : (czas.) odrzucić | : (czas.) opadać | : (czas.) płowieć | : (czas.) pochylać | : (czas.) podupadać | : (czas.) zanikać | : (czas.) zginać | : (czas.) zmaleć | : (czas.) zmniejszać | : (rzecz.) odmiana | : (rzecz.) pogorszenie | : (rzecz.) spadek | : (rzecz.) suchoty | : (rzecz.) zanik
declining : declining : (przym.) schyłkowy | : (przym.) spadkowy
declinometer : declinometer : (rzecz.) deklinator
declivitous : declivitous : (przym.) spadzisty
declivity : declivity : (rzecz.) pochyłość | : (rzecz.) stok
declutch : declutch : (czas.) wyprzęgać
decoct : decoct : (czas.) warzyć
decoction : decoction : (rzecz.) odwar | : (rzecz.) wywar
decode : decode : (czas.) dekodować | : (czas.) odcyfrować | : (czas.) odczytać | : (czas.) pobrać | : (czas.) rozkodować | : (czas.) rozszyfrować | : (czas.) rozszyfrowywać | : (czas.) zdekodować
decoder : decoder : (rzecz.) dekoder
decolonization : decolonization : (rzecz.) dekolonizacja
decolorize : decolorize : (czas.) odbarwiać
decolour : decolour : (czas.) odbarwiać
decolourisation : decolourisation : (rzecz.) odbarwianie
decolourize : decolourize : (czas.) odbarwiać
decolourizer : decolourizer : (rzecz.) podbarwiacz
decommission : decommission : (czas.) demobilizować | : (czas.) rozbrajać
decommissioning : decommissioning : (przym.) likwidacyjny | : (rzecz.) likwidacja
decompiling : decompiling : (rzecz.) dekompilacja
decompose : decompose : (czas.) dekomponować | : (czas.) dysocjować | : (czas.) gnić | : (czas.) rozkładać | : (czas.) rozpadać | : (czas.) rozpuszczać
decomposition : decomposition : (rzecz.) dekompozycja | : (rzecz.) rozkład | : (rzecz.) rozpad
decompress : decompress : (czas.) rozprężać
decompression : decompression : (rzecz.) dekompresja | : (rzecz.) odprężenie
decontaminate : decontaminate : (czas.) dekontaminować | : (czas.) dezaktywować | : (czas.) odkażać
decontamination : decontamination : (rzecz.) dekontaminacja | : (rzecz.) odkażanie | : (rzecz.) odkażenie
decontrol : decontrol : (rzecz.) zwolnienie
decor : decor : (rzecz.) dekoracja | : (rzecz.) wykończenie | : (rzecz.) wystrój
decorate : decorate : (czas.) dekorować | : (czas.) krasić | : (czas.) malować | : (czas.) odnawiać | : (czas.) odnowić | : (czas.) ozdabiać | : (czas.) ozdobić | : (czas.) przyozdobić | : (czas.) udekorować
decoration : decoration : (rzecz.) dekoracja | : (rzecz.) dekorowanie | : (rzecz.) odznaczenie | : (rzecz.) order | : (rzecz.) ozdoba | : (rzecz.) wykończenie | : (rzecz.) wystrój | : (rzecz.) zdobienie
decorative : decorative : (przym.) dekoracyjny | : (przym.) ornamentalny | : (przym.) ozdobny | : (przym.) zdobniczy | : (rzecz.) dekoracyjność
decoratively : decoratively : (przysł.) ozdobnie
decorator : decorator : (rzecz.) dekorator | : (rzecz.) malarz | : (rzecz.) tapeciarz | : (rzecz.) tapicer
decorous : decorous : (przym.) obyczajny | : (przym.) odpowiedni | : (przym.) przyzwoity | : (przym.) stosowny
decorticate : decorticate : (czas.) łuszczyć
decorticator : decorticator : (rzecz.) dekortykator | : (rzecz.) łuszczarka
decorum : decorum : (rzecz.) obyczajność | : (rzecz.) przyzwoitość
decoupling : decoupling : (rzecz.) odprzęganie
decoy : decoy : (czas.) mamić | : (czas.) odciągać | : (czas.) wabić | : (czas.) zwabiać | : (czas.) zwabić | : (czas.) zwodzić | : (rzecz.) przynęta | : (rzecz.) pułapka | : (rzecz.) wabik
decrease : decrease : (czas.) maleć | : (czas.) obniżać | : (czas.) obniżyć | : (czas.) opadać | : (czas.) pomniejszać | : (czas.) spadać | : (czas.) ubywać | : (czas.) zmniejszać | : (czas.) zmniejszyć | : (rzecz.) obniżenie | : (rzecz.) spadek | : (rzecz.) ubytek | : (rzecz.) zmniejszenie
decree : decree : (czas.) dekretować | : (czas.) postanawiać | : (czas.) rozporządzać | : (czas.) uchwalać | : (czas.) zarządzać | : (rzecz.) dekret | : (rzecz.) dekretowanie | : (rzecz.) postanowienie | : (rzecz.) rozporządzenie | : (rzecz.) wyrok
decrement : decrement : (rzecz.) dekrement | : (rzecz.) dekrementacja | : (rzecz.) ubytek
decremented : decremented : (rzecz.) dekrement | : (rzecz.) zanikanie
decrementing : decrementing : (rzecz.) dekrementacja | : (rzecz.) zmniejszanie
decrements : decrements : (rzecz.) dekrement
decrepitude : decrepitude : (rzecz.) cherlactwo | : (rzecz.) uwiąd | : (rzecz.) zniedołężnienie | : (rzecz.) zniszczenie
decretory : decretory : (przym.) dekretowy
decry : decry : (czas.) oczerniać | : (czas.) oczernić | : (czas.) okrzyczeć | : (czas.) potępiać | : (czas.) zniesławiać | : (czas.) zniesławić
decrypt : decrypt : (czas.) dekodować | : (czas.) deszyfrować | : (czas.) odszyfrować | : (czas.) odszyfrowywać | : (czas.) rozszyfrować
decrypted : decrypted : (rzecz.) odszyfrowanie
decrypting : decrypting : (rzecz.) deszyfrowanie
decryption : decryption : (rzecz.) deszyfracja | : (rzecz.) deszyfrowanie | : (rzecz.) odszyfrowanie | : (rzecz.) rozszyfrowanie
decuple : decuple : (rzecz.) dziesięciokrotność
dedicate : dedicate : (czas.) dedykować | : (czas.) oddać | : (czas.) ofiarować | : (czas.) poświęcać | : (czas.) poświęcić | : (czas.) przeznaczać | : (czas.) zadedykować
dedicated : dedicated : (przym.) dedykowany | : (przym.) oddany | : (przym.) ofiarny | : (przym.) specjalny
dedication : dedication : (rzecz.) dedykacja | : (rzecz.) gorliwość | : (rzecz.) oddanie | : (rzecz.) ofiarność | : (rzecz.) poświęcenie
dedicatory : dedicatory : (przym.) dedykacyjny
deduce : deduce : (czas.) dedukować | : (czas.) wnioskować | : (czas.) wyprowadzać | : (czas.) wyprowadzić | : (czas.) wywnioskować
deduct : deduct : (czas.) odciągać | : (czas.) odejmować | : (czas.) odliczać | : (czas.) odliczyć | : (czas.) pomniejszać | : (czas.) potrącać | : (czas.) potrącić
deduction : deduction : (rzecz.) dedukcja | : (rzecz.) obniżka | : (rzecz.) odejmowanie | : (rzecz.) odliczenie | : (rzecz.) pomniejszenie | : (rzecz.) potrącenie | : (rzecz.) rabat | : (rzecz.) wniosek | : (rzecz.) wnioskowanie | : (rzecz.) wywód
deductive : deductive : (przym.) dedukcyjny
deductively : deductively : (przysł.) dedukcyjnie
deed : deed : (rzecz.) czyn | : (rzecz.) dzieło | : (rzecz.) uczynek
deem : deem : (czas.) mniemać | : (czas.) poczytywać | : (czas.) sądzić | : (czas.) uważać
deep : deep : (przym.) głęboki | : (przym.) intensywny | : (przym.) nałogowy | : (przym.) niski | : (przym.) poważny | : (przym.) sromotny | : (przym.) wielki | : (przym.) wnikliwy | : (przysł.) głęboko | : (rzecz.) głębia | : (rzecz.) głębokość | : (rzecz.) wiedza
deep-blue : deep-blue : (przym.) modry
deep-sea : deep-sea : (przym.) dalekomorski | : (przym.) głębinowy
deep-seated : deep-seated : (przym.) głęboki | : (przym.) wgłębny
deepen : deepen : (czas.) pogłębiać | : (czas.) pogłębić
deeply : deeply : (przysł.) głęboko
deepness : deepness : (rzecz.) głębia | : (rzecz.) głębokość
deer : deer : (rzecz.) jeleń | : (rzecz.) łania | : (rzecz.) rogacz | : (rzecz.) sarna
deer-hound : deer-hound : (rzecz.) ogar
deer-lick : deer-lick : (rzecz.) lizawka
deerhound : deerhound : (rzecz.) ogar
deerskin : deerskin : (rzecz.) ircha
deface : deface : (czas.) niszczyć | : (czas.) szpecić | : (czas.) zamazywać
defacement : defacement : (rzecz.) zeszpecenie
defalcate : defalcate : (czas.) defraudować | : (czas.) sprzeniewierzać
defalcation : defalcation : (rzecz.) defraudacja | : (rzecz.) sprzeniewierzenie
defamation : defamation : (rzecz.) oczernianie | : (rzecz.) zniesławienie
defamatory : defamatory : (przym.) oszczerczy | : (przym.) potwarczy
defame : defame : (czas.) oczerniać | : (czas.) szkalować | : (czas.) uwłaczać | : (czas.) zniesławiać | : (czas.) zniesławić
defamer : defamer : (rzecz.) oszczerca
default : default : (czas.) odmawiać | : (przym.) domyślny | : (przym.) standardowy | : (przym.) zaoczny | : (rzecz.) brak | : (rzecz.) nieobecność | : (rzecz.) uchybienie | : (rzecz.) walkower | : (rzecz.) zaniedbanie
defaulter : defaulter : (rzecz.) defraudant
defeasance : defeasance : (rzecz.) anulowanie | : (rzecz.) unieważnienie
defeat : defeat : (czas.) odrzucać | : (czas.) pobić | : (czas.) pokonać | : (czas.) rozbijać | : (czas.) skasować | : (czas.) uchylić | : (czas.) zawodzić | : (rzecz.) kasacja | : (rzecz.) klęska | : (rzecz.) porażka | : (rzecz.) wada | : (rzecz.) zniszczenie
defeatism : defeatism : (rzecz.) defetyzm
defeatist : defeatist : (przym.) defetystyczny | : (rzecz.) defetysta
defecate : defecate : (czas.) defekować | : (czas.) srać | : (czas.) wypróżniać
defecation : defecation : (rzecz.) defekacja | : (rzecz.) oczyszczenie | : (rzecz.) wypróżnienie
defect : defect : (czas.) odłączać | : (czas.) uciekać | : (rzecz.) błąd | : (rzecz.) brak | : (rzecz.) defekt | : (rzecz.) feler | : (rzecz.) niedomaganie | : (rzecz.) przywara | : (rzecz.) skaza | : (rzecz.) usterka | : (rzecz.) wada
defection : defection : (rzecz.) dezercja | : (rzecz.) odłączenie | : (rzecz.) odstępstwo | : (rzecz.) wystąpienie | : (rzecz.) zdrada
defective : defective : (przym.) defektowy | : (przym.) niepełnowartościowy | : (przym.) ułomny | : (przym.) wadliwie | : (przym.) wadliwy
defectively : defectively : (przysł.) ułomnie
defectiveness : defectiveness : (rzecz.) defekt | : (rzecz.) wadliwość
defector : defector : (rzecz.) dezerter | : (rzecz.) odstępca | : (rzecz.) uciekinier
defence : defence : (rzecz.) defensywa | : (rzecz.) obrona | : (rzecz.) obrońca | : (rzecz.) osłona
defenceless : defenceless : (przym.) bezbronny
defences : defences : (rzecz.) umocnienia
defend : defend : (czas.) bronić | : (czas.) obronić | : (czas.) podtrzymywać | : (czas.) wspierać
defender : defender : (rzecz.) maszyna | : (rzecz.) obrońca
defenestration : defenestration : (rzecz.) defenestracja
defensible : defensible : (przym.) obronny
defensive : defensive : (przym.) defensywny | : (przym.) obronny | : (rzecz.) defensywa
defensively : defensively : (przysł.) defensywnie
defer : defer : (czas.) odraczać | : (czas.) odroczyć | : (czas.) ulegać
deference : deference : (rzecz.) atencja | : (rzecz.) poważanie | : (rzecz.) szacunek | : (rzecz.) uleganie | : (rzecz.) uległość | : (rzecz.) wzgląd
deferential : deferential : (przym.) szacowny
deferment : deferment : (rzecz.) odroczenie | : (rzecz.) odwleczenie | : (rzecz.) zwlekanie
deferral : deferral : (rzecz.) odroczenie
defiance : defiance : (rzecz.) krnąbrność | : (rzecz.) opór | : (rzecz.) wezwanie | : (rzecz.) wyzwanie
defiant : defiant : (przym.) buntowniczy | : (przym.) czupurny | : (przym.) krnąbrny | : (przym.) nieposłuszny | : (przym.) nieustępliwy | : (przym.) oporny | : (przym.) prowokujący | : (przym.) zadziorny
defiantly : defiantly : (przysł.) wyzywająco
defibrillator : defibrillator : (rzecz.) defibrylator
deficiency : deficiency : (rzecz.) brak | : (rzecz.) deficyt | : (rzecz.) niedobór | : (rzecz.) niedomiar | : (rzecz.) niedostatek | : (rzecz.) niepowodzenie | : (rzecz.) niewystarczalność | : (rzecz.) słabość
deficient : deficient : (przym.) brakujący | : (przym.) niekompletny | : (przym.) niepełny | : (przym.) oporny | : (przym.) wadliwy
deficit : deficit : (rzecz.) deficyt | : (rzecz.) niedobór
defile : defile : (czas.) defilować | : (czas.) kalać | : (czas.) przedefilować | : (czas.) zanieczyścić | : (czas.) zanieczyszczać | : (rzecz.) wąwóz
defilement : defilement : (rzecz.) skalanie | : (rzecz.) zbezczeszczenie
defiler : defiler : (rzecz.) profanator
definable : definable : (przym.) definiowalny
define : define : (czas.) charakteryzować | : (czas.) definiować | : (czas.) określać | : (czas.) określić | : (czas.) zdefiniować | : (czas.) zdeterminować
definite : definite : (przym.) dokładny | : (przym.) określony | : (przym.) ostateczny | : (przym.) wyraźny
definitely : definitely : (przysł.) definitywnie | : (przysł.) oczywiście | : (przysł.) wyraźnie
definiteness : definiteness : (rzecz.) precyzja
definition : definition : (rzecz.) definicja | : (rzecz.) definiowanie | : (rzecz.) określenie | : (rzecz.) rozdzielczość
definitional : definitional : (przym.) definicyjny
definitive : definitive : (przym.) definitywny | : (przym.) ostateczny | : (przym.) stanowczy
deflagration : deflagration : (rzecz.) deflagracja
deflate : deflate : (czas.) sflaczeć
deflation : deflation : (rzecz.) deflacja
deflationary : deflationary : (przym.) deflacyjny
deflect : deflect : (czas.) odchylać | : (czas.) odginać | : (czas.) odpierać | : (czas.) załamywać | : (czas.) zbaczać
deflection : deflection : (rzecz.) odchylanie | : (rzecz.) odchylenie | : (rzecz.) skręcenie | : (rzecz.) ugięcie | : (rzecz.) uginanie | : (rzecz.) wychylenie | : (rzecz.) zagięcie | : (rzecz.) załamywanie | : (rzecz.) zboczenie
deflector : deflector : (rzecz.) deflektor | : (rzecz.) odrzutnik | : (rzecz.) owiewka
defloration : defloration : (rzecz.) defloracja
deflower : deflower : (czas.) zdeflorować
defog : defog : (czas.) odparować
defogger : defogger : (rzecz.) nadmuch
defoliation : defoliation : (rzecz.) defoliacja
deforest : deforest : (czas.) wylesiać
deforestation : deforestation : (rzecz.) deforestacja | : (rzecz.) wylesianie
deform : deform : (czas.) deformować | : (czas.) odkształcać | : (czas.) okaleczyć | : (czas.) oszpecić | : (czas.) pokurczyć | : (czas.) zdeformować | : (czas.) zniekształcać | : (czas.) zniekształcić
deformability : deformability : (rzecz.) odkształcalność
deformable : deformable : (przym.) odkształcalny
deformation : deformation : (rzecz.) deformacja | : (rzecz.) zdeformowanie | : (rzecz.) zniekształcenie
deformed : deformed : (przym.) nieforemny
deformity : deformity : (rzecz.) brzydota | : (rzecz.) deformacja | : (rzecz.) kalectwo | : (rzecz.) nieforemność | : (rzecz.) niekształtność | : (rzecz.) zniekształcenie
defraud : defraud : (czas.) okradać | : (czas.) oszukać | : (czas.) oszukiwać | : (czas.) pozbawiać | : (czas.) wyłudzać
defrauder : defrauder : (rzecz.) defraudant
defray : defray : (czas.) opędzać | : (czas.) opłacać | : (czas.) pokrywać
defrayal : defrayal : (rzecz.) opłata
defrost : defrost : (czas.) odmarzać | : (czas.) odmrażać | : (czas.) odmrozić | : (czas.) rozmrażać
defroster : defroster : (rzecz.) odmrażacz
defrosting : defrosting : (rzecz.) odmrożenie | : (rzecz.) rozmrażanie
deft : deft : (przym.) udatny | : (przym.) zgrabny | : (przym.) zręczny | : (przym.) zwinny
deftly : deftly : (przysł.) sprawnie | : (przysł.) zręcznie | : (przysł.) zwinnie
deftness : deftness : (rzecz.) udatność | : (rzecz.) wprawność | : (rzecz.) zgrabność | : (rzecz.) zwinność
defunct : defunct : (przym.) martwy
defuse : defuse : (czas.) rozbrajać | : (czas.) rozładowywać
defy : defy : (czas.) opierać | : (czas.) przeciwstawiać | : (czas.) przeciwstawić | : (czas.) sprzeciwiać | : (czas.) sprzeciwić | : (czas.) wyzywać
degas : degas : (czas.) odgazować | : (czas.) odgazowywać
degasification : degasification : (rzecz.) odgazowywanie
degasify : degasify : (czas.) odgazowywać
degasifying : degasifying : (rzecz.) odgazowywanie
degassed : degassed : (rzecz.) odgazowywanie
degassing : degassing : (rzecz.) odgazowanie | : (rzecz.) odgazowywanie
degeneracy : degeneracy : (rzecz.) degeneracja | : (rzecz.) upadek | : (rzecz.) zdegradowanie | : (rzecz.) zwyrodnienie
degenerate : degenerate : (czas.) degenerować | : (czas.) przerodzić | : (czas.) wyradzać | : (czas.) wyrodnieć | : (czas.) zdegenerować | : (czas.) zwyrodnieć | : (przym.) wyrodny | : (przym.) zdegenerowany | : (rzecz.) degenerat | : (rzecz.) wyrodek | : (rzecz.) zwyrodnialec
degeneration : degeneration : (rzecz.) degeneracja | : (rzecz.) wynaturzenie | : (rzecz.) zwyrodnienie
degenerative : degenerative : (przym.) zwyrodnieniowy
deglutination : deglutination : (rzecz.) odklejanie | : (rzecz.) odlepianie
degradation : degradation : (rzecz.) degradacja | : (rzecz.) obniżenie | : (rzecz.) pogorszenie | : (rzecz.) poniżanie | : (rzecz.) poniżenie | : (rzecz.) upadek | : (rzecz.) upodlenie | : (rzecz.) znikczemnienie
degrade : degrade : (czas.) degradować | : (czas.) poniżać | : (czas.) spodlić | : (czas.) upadlać
degrease : degrease : (czas.) odtłuścić | : (czas.) odtłuszczać
degreaser : degreaser : (rzecz.) odtłuszczacz
degreasing : degreasing : (rzecz.) odtłuszczenie
degree : degree : (rzecz.) cecha | : (rzecz.) gatunek | : (rzecz.) jednostka | : (rzecz.) poziom | : (rzecz.) stopień | : (rzecz.) walor
dehumanization : dehumanization : (rzecz.) dehumanizacja
dehumidification : dehumidification : (rzecz.) osuszanie
dehumidifier : dehumidifier : (rzecz.) odwilżacz | : (rzecz.) osuszacz
dehumidify : dehumidify : (czas.) osuszać
dehydrate : dehydrate : (czas.) odwadniać | : (czas.) odwodniać | : (czas.) odwodnić
dehydration : dehydration : (rzecz.) dehydratacja | : (rzecz.) odwadnianie | : (rzecz.) odwodnienie
dehydrator : dehydrator : (rzecz.) odwadniacz
dehydrogenation : dehydrogenation : (rzecz.) odwodornienie
deification : deification : (rzecz.) deifikacja | : (rzecz.) ubóstwianie | : (rzecz.) ubóstwienie
deify : deify : (czas.) deifikować | : (czas.) ubóstwiać
deign : deign : (czas.) raczyć | : (czas.) zechcieć
deionization : deionization : (rzecz.) dejonizacja
deism : deism : (rzecz.) deizm
deistic : deistic : (przym.) deistyczny
deistical : deistical : (przym.) deistyczny
deity : deity : (rzecz.) bóstwo | : (rzecz.) teologia
deject : deject : (czas.) deprymować | : (czas.) przygnębiać | : (czas.) zgnębić | : (czas.) zniechęcać
dejected : dejected : (przym.) ponury
dejection : dejection : (rzecz.) przygnębienie | : (rzecz.) zniechęcenie
delay : delay : (czas.) guzdrać | : (czas.) odkładać | : (czas.) odwlekać | : (czas.) opóźniać | : (czas.) opóźnić | : (czas.) przenosić | : (czas.) wstrzymywać | : (czas.) zwlekać | : (rzecz.) izolacja | : (rzecz.) mitręga | : (rzecz.) odraczanie | : (rzecz.) odwleczenie | : (rzecz.) opóźnianie | : (rzecz.) opóźnienie | : (rzecz.) spóźnienie | : (rzecz.) zaległość | : (rzecz.) zwlekanie | : (rzecz.) zwłoka | : (rzecz.) zwłoki | : (czas.) odwlekać | : (czas.) opóźniać
delayed : delayed : (przym.) opóźniony
delayer : delayer : (rzecz.) opóźniacz
delectable : delectable : (przym.) przemiły | : (przym.) rozkoszny
delectation : delectation : (rzecz.) rozkoszowanie
delegacy : delegacy : (rzecz.) delegacja | : (rzecz.) delegatura | : (rzecz.) wydelegowanie
delegate : delegate : (czas.) delegować | : (czas.) powierzać | : (czas.) upełnomocniać | : (czas.) upełnomocnić | : (czas.) uprawnić | : (czas.) wydelegować | : (czas.) zlecać | : (czas.) zlecić | : (rzecz.) delegat
delegation : delegation : (rzecz.) delegacja | : (rzecz.) delegowanie | : (rzecz.) przekazanie
delete : delete : (czas.) anulować | : (czas.) kasować | : (czas.) skasować | : (czas.) skreślać | : (czas.) skreślić | : (czas.) usunąć | : (czas.) usuwać | : (czas.) wymazać | : (czas.) znosić
deleted : deleted : (czas.) wykreślić
deleterious : deleterious : (przym.) szkodliwy | : (przym.) ujemny | : (przym.) zgubny
deletion : deletion : (rzecz.) skasowanie | : (rzecz.) skreślanie | : (rzecz.) skreślenie | : (rzecz.) usunięcie | : (rzecz.) usuwanie | : (rzecz.) wykreślenie | : (rzecz.) wymazanie
delftware : delftware : (rzecz.) fajans
deli : deli : (rzecz.) garmażeria
deliberate : deliberate : (czas.) deliberować | : (czas.) naradzać | : (czas.) obradować | : (czas.) radzić | : (czas.) rozmyślać | : (czas.) rozważać | : (czas.) zastanawiać | : (czas.) zastanowić | : (przym.) celowy | : (przym.) naumyślny | : (przym.) rozmyślny | : (przym.) rozważny | : (przym.) umyślny
deliberately : deliberately : (przysł.) celowo | : (przysł.) naumyślnie | : (przysł.) rozmyślnie | : (przysł.) umyślnie
deliberateness : deliberateness : (przym.) umyślny | : (rzecz.) rozmyślność
deliberation : deliberation : (rzecz.) deliberacja | : (rzecz.) narada | : (rzecz.) naradzanie | : (rzecz.) obrady | : (rzecz.) pertraktacja | : (rzecz.) przezorność | : (rzecz.) rozmowa | : (rzecz.) rozwaga | : (rzecz.) rozważanie
deliberations : deliberations : (rzecz.) obrady
deliberative : deliberative : (przym.) opiniodawczy
delicacies : delicacies : (rzecz.) delicja
delicacy : delicacy : (rzecz.) delicja | : (rzecz.) delikates | : (rzecz.) delikatność | : (rzecz.) frykas | : (rzecz.) przysmak | : (rzecz.) smakołyk | : (rzecz.) specjał | : (rzecz.) subtelność
delicate : delicate : (przym.) czuły | : (przym.) delikatny | : (przym.) drobny | : (przym.) misterny | : (przym.) wątły
delicately : delicately : (przysł.) delikatnie | : (przysł.) finezyjnie
delicatessen : delicatessen : (rzecz.) delikates | : (rzecz.) garmażeria
delicious : delicious : (przym.) przemiły | : (przym.) przepyszny | : (przym.) pyszny | : (przym.) rozkoszny | : (przym.) smaczny | : (przym.) wyborny | : (przym.) zachwycający
deliciously : deliciously : (przysł.) przepysznie
delight : delight : (czas.) cieszyć | : (czas.) lubować | : (czas.) radować | : (czas.) rozkoszować | : (czas.) zachwycać | : (rzecz.) admiracja | : (rzecz.) lubość | : (rzecz.) radość | : (rzecz.) rozkosz | : (rzecz.) uciecha | : (rzecz.) zachwyt
delighted : delighted : (przym.) zachwycony
delightful : delightful : (przym.) błogi | : (przym.) rozkoszny | : (przym.) zachwycający
delightfully : delightfully : (przysł.) pięknie | : (przysł.) rozkosznie
delimit : delimit : (czas.) ograniczać | : (czas.) wytyczać
delimitate : delimitate : (czas.) rozgraniczać
delimitation : delimitation : (rzecz.) delimitacja | : (rzecz.) ograniczenie | : (rzecz.) wyznaczenie
delimiter : delimiter : (rzecz.) ogranicznik | : (rzecz.) separator
delineate : delineate : (czas.) nakreślać | : (czas.) nakreślić | : (czas.) opisywać | : (czas.) przedstawiać | : (czas.) szkicować | : (czas.) zarysowywać
delineation : delineation : (rzecz.) nakreślenie | : (rzecz.) naszkicowanie | : (rzecz.) opis | : (rzecz.) szkic
delinquency : delinquency : (rzecz.) przestępczość | : (rzecz.) przestępstwo | : (rzecz.) przewinienie | : (rzecz.) wykroczenie
delinquent : delinquent : (przym.) przestępczy | : (przym.) winny | : (rzecz.) delikwent | : (rzecz.) przestępca | : (rzecz.) winowajca
delirious : delirious : (przym.) deliryczny
delirium : delirium : (rzecz.) bredzenie | : (rzecz.) majaczenie | : (rzecz.) szał
deliver : deliver : (czas.) doręczać | : (czas.) dostarczać | : (czas.) dostarczyć | : (czas.) przekazać | : (czas.) wręczyć | : (czas.) wygłosić
deliverance : deliverance : (rzecz.) oswobodzenie | : (rzecz.) wybawienie | : (rzecz.) zwolnienie
delivered : delivered : (czas.) ocaleć
deliverer : deliverer : (rzecz.) doręczyciel | : (rzecz.) dostawca | : (rzecz.) oddawca | : (rzecz.) zbawca
delivery : delivery : (rzecz.) doprowadzenie | : (rzecz.) doręczenie | : (rzecz.) dostawa | : (rzecz.) dowóz | : (rzecz.) odstawa | : (rzecz.) połóg | : (rzecz.) poród | : (rzecz.) przekazanie | : (rzecz.) przywóz | : (rzecz.) ratunek | : (rzecz.) roznoszenie | : (rzecz.) rozsyłka | : (rzecz.) rozwóz | : (rzecz.) wręczenie | : (rzecz.) wydanie | : (rzecz.) zaopatrzenie | : (rzecz.) zwolnienie
dell : dell : (rzecz.) dolina | : (rzecz.) kotlina
delocalize : delocalize : (czas.) przenosić
delouse : delouse : (czas.) odwszawić | : (czas.) rozminować
delphinium : delphinium : (rzecz.) ostróżka
delta : delta : (rzecz.) delta
deltaic : deltaic : (przym.) deltowy
deltoid : deltoid : (rzecz.) deltoid
delude : delude : (czas.) łudzić | : (czas.) mamić | : (czas.) omamiać | : (czas.) omamić | : (czas.) zmylać | : (czas.) zmylić | : (czas.) zwodzić
deluge : deluge : (czas.) zalewać | : (rzecz.) potop | : (rzecz.) zalew
delusion : delusion : (rzecz.) iluzja | : (rzecz.) łudzenie | : (rzecz.) omamienie | : (rzecz.) oszustwo | : (rzecz.) przywidzenie | : (rzecz.) ułuda | : (rzecz.) złuda | : (rzecz.) złudzenie | : (rzecz.) zwodzenie
delusional : delusional : (przym.) urojeniowy
delusive : delusive : (przym.) iluzoryczny | : (przym.) oszukańczy | : (przym.) zwodniczy
delusory : delusory : (przym.) bałamutny | : (przym.) iluzoryczny | : (przym.) ułudny
deluxe : deluxe : (przym.) luksusowy
delve : delve : (czas.) kopać | : (czas.) ryć | : (czas.) zagłębiać
demagnetising : demagnetising : (rzecz.) rozmagnesowanie
demagnetization : demagnetization : (rzecz.) demagnetyzacja | : (rzecz.) rozmagnesowanie
demagnetize : demagnetize : (czas.) odmagnesować | : (czas.) odmagnesowywać | : (czas.) rozmagnesować
demagogic : demagogic : (przym.) demagogiczny
demagogue : demagogue : (rzecz.) demagog
demagoguery : demagoguery : (rzecz.) demagogia
demagogy : demagogy : (rzecz.) demagogia
demand : demand : (czas.) domagać | : (czas.) dopominać | : (czas.) pytać | : (czas.) rewindykować | : (czas.) wymagać | : (czas.) zadać | : (czas.) żądać | : (rzecz.) popyt | : (rzecz.) potrzebowanie | : (rzecz.) pretensja | : (rzecz.) zadanie | : (rzecz.) żądanie | : (rzecz.) zapotrzebowanie
demanding : demanding : (przym.) wymagający
demarcate : demarcate : (czas.) ograniczać | : (czas.) rozgraniczać | : (czas.) rozgraniczyć
demarcation : demarcation : (rzecz.) demarkacja | : (rzecz.) rozgraniczenie | : (rzecz.) wytyczenie
dematerialization : dematerialization : (rzecz.) anihilacja | : (rzecz.) dematerializacja
demean : demean : (czas.) poniżać
demeanour : demeanour : (rzecz.) postawa | : (rzecz.) postępowanie | : (rzecz.) zachowanie
dementia : dementia : (rzecz.) demencja
demerit : demerit : (rzecz.) przewinienie | : (rzecz.) wada | : (rzecz.) zarzut
demesne : demesne : (rzecz.) majątek | : (rzecz.) nieruchomość | : (rzecz.) własność
demigod : demigod : (rzecz.) półbóg
demijohn : demijohn : (rzecz.) balon | : (rzecz.) gąsior
demilitarization : demilitarization : (rzecz.) demilitaryzacja
demilitarize : demilitarize : (czas.) zdemilitaryzować
demimonde : demimonde : (rzecz.) półświatek
demineralization : demineralization : (rzecz.) demineralizacja | : (rzecz.) odmineralizowanie
demise : demise : (rzecz.) koniec | : (rzecz.) zanik
demission : demission : (rzecz.) abdykacja | : (rzecz.) dymisja | : (rzecz.) podanie
demister : demister : (rzecz.) nadmuch
demiurge : demiurge : (rzecz.) demiurg
demo : demo : (rzecz.) demo | : (rzecz.) demonstracja | : (rzecz.) pokaz
demob : demob : (czas.) demobilizować | : (czas.) zdemobilizować
demobilising : demobilising : (przym.) demobilizacyjny
demobilization : demobilization : (rzecz.) demobilizacja
demobilize : demobilize : (czas.) demobilizować | : (czas.) zdemobilizować
democracy : democracy : (rzecz.) demokracja | : (rzecz.) ludowładztwo
democrat : democrat : (rzecz.) demokrata
democratic : democratic : (przym.) demokratyczny
democratically : democratically : (przysł.) demokratycznie
democratization : democratization : (rzecz.) demokratyzacja
democratize : democratize : (czas.) demokratyzować | : (czas.) zdemokratyzować
demoded : demoded : (przym.) niemodny
demodulate : demodulate : (czas.) demodulować
demodulation : demodulation : (rzecz.) demodulacja
demodulator : demodulator : (rzecz.) demodulator
demographic : demographic : (przym.) demograficzny
demographically : demographically : (przysł.) demograficznie
demographics : demographics : (rzecz.) demografia
demography : demography : (rzecz.) demografia
demolish : demolish : (czas.) burzyć | : (czas.) demolować | : (czas.) obalać | : (czas.) rozwalać | : (czas.) spałaszować | : (czas.) walić | : (czas.) wyburzać | : (czas.) zburzyć
demolisher : demolisher : (rzecz.) burzyciel
demolition : demolition : (rzecz.) burzenie | : (rzecz.) rozbiórka | : (rzecz.) wyburzanie | : (rzecz.) wyburzenie | : (rzecz.) zburzenie | : (rzecz.) zniszczenie
demon : demon : (rzecz.) demon
demonetization : demonetization : (rzecz.) demonetyzacja
demoniac : demoniac : (przym.) demoniczny | : (przym.) opętańczy
demoniacal : demoniacal : (przym.) demoniczny | : (przym.) opętańczy
demonic : demonic : (przym.) demoniczny | : (przym.) szatański
demonically : demonically : (przysł.) demonicznie
demonize : demonize : (czas.) demonizować
demonized : demonized : (czas.) demonizować
demonology : demonology : (rzecz.) demonologia
demonstrable : demonstrable : (przym.) widoczny
demonstrate : demonstrate : (czas.) demonstrować | : (czas.) dowodzić | : (czas.) manifestować | : (czas.) pokazywać | : (czas.) udowadniać | : (czas.) unaoczniać | : (czas.) unaocznić | : (czas.) uwidaczniać | : (czas.) wykazywać | : (czas.) zamanifestować
demonstration : demonstration : (rzecz.) demonstracja | : (rzecz.) dowodzenie | : (rzecz.) manewr | : (rzecz.) manifestacja | : (rzecz.) pokaz | : (rzecz.) zgromadzenie
demonstrative : demonstrative : (przym.) demonstracyjny | : (przym.) dowodowy | : (przym.) dowodzący | : (przym.) poglądowy | : (przym.) wykazujący
demonstrator : demonstrator : (rzecz.) demonstrant
demoralization : demoralization : (rzecz.) demoralizacja | : (rzecz.) zdeprawowanie
demoralize : demoralize : (czas.) demoralizować | : (czas.) deprawować | : (czas.) zdemoralizować | : (czas.) zdeprawować | : (czas.) znieprawiać
demote : demote : (czas.) degradować | : (czas.) zdegradować
demotic : demotic : (przym.) demotyczny | : (przym.) potoczny
demotion : demotion : (rzecz.) degradacja
demount : demount : (czas.) demontować | : (czas.) zsiąść
demountable : demountable : (przym.) odejmowany | : (przym.) rozbieralny
demulsify : demulsify : (czas.) demulgować
demur : demur : (czas.) sprzeciwiać | : (rzecz.) obiekcja | : (rzecz.) sprzeciw | : (rzecz.) wątpliwość
demure : demure : (przym.) poważny | : (przym.) rozważny
demurrage : demurrage : (rzecz.) postojowe | : (rzecz.) przestój
demythologize : demythologize : (czas.) demitologizować
den : den : (rzecz.) jaskinia | : (rzecz.) legowisko | : (rzecz.) melina | : (rzecz.) nora | : (rzecz.) pieczara | : (rzecz.) spelunka
denary : denary : (przym.) dziesiętny
denationalization : denationalization : (rzecz.) denacjonalizacja | : (rzecz.) wynarodowienie
denationalize : denationalize : (czas.) reprywatyzować | : (czas.) sprywatyzować | : (czas.) wynaradawiać
denaturalization : denaturalization : (rzecz.) denaturalizacja | : (rzecz.) wynaturzenie
denaturalize : denaturalize : (czas.) denaturalizować | : (czas.) wynaturzać
denature : denature : (czas.) denaturować
denaturing : denaturing : (rzecz.) denaturowanie
dendrite : dendrite : (rzecz.) dendryt
dendrologist : dendrologist : (rzecz.) dendrolog
dendrology : dendrology : (rzecz.) dendrologia | : (rzecz.) drzewoznawstwo
deniable : deniable : (przym.) sporny | : (przym.) zaprzeczalny
denial : denial : (rzecz.) negacja | : (rzecz.) negowanie | : (rzecz.) odmowa | : (rzecz.) odmówienie | : (rzecz.) wyparcie | : (rzecz.) zaprzeczanie | : (rzecz.) zaprzeczenie
denied : denied : (czas.) odmawiać | : (czas.) zaprzeczyć
denier : denier : (rzecz.) denier
denigrate : denigrate : (czas.) obmawiać
denigration : denigration : (rzecz.) oczernienie | : (rzecz.) wygadywanie
denim : denim : (przym.) drelichowy | : (rzecz.) drelich | : (rzecz.) dżins
denizen : denizen : (rzecz.) mieszkaniec | : (rzecz.) naleciałość | : (rzecz.) obywatel
denominate : denominate : (czas.) nazwać | : (czas.) określać | : (czas.) określić | : (czas.) zwać
denomination : denomination : (rzecz.) denominacja | : (rzecz.) jednostka | : (rzecz.) kategoria | : (rzecz.) klasa | : (rzecz.) nazwa | : (rzecz.) nazwanie | : (rzecz.) nominał | : (rzecz.) określenie | : (rzecz.) wyznanie
denominational : denominational : (przym.) wyznaniowy
denominator : denominator : (rzecz.) mianownik
denotation : denotation : (rzecz.) denotacja | : (rzecz.) oznaczenie
denotative : denotative : (przym.) wyznaniowy
denote : denote : (czas.) oznaczać
denounce : denounce : (czas.) denuncjować | : (czas.) donosić | : (czas.) oskarżać | : (czas.) wydać | : (czas.) wypowiadać | : (czas.) wypowiedzieć | : (czas.) zadenuncjować
denouncement : denouncement : (rzecz.) wypowiedzenie
dense : dense : (przym.) gęsty | : (przym.) spoisty | : (przym.) spójny
densely : densely : (przysł.) gęsto
denseness : denseness : (rzecz.) gęstość | : (rzecz.) zwartość
densification : densification : (rzecz.) zagęszczanie
densitometer : densitometer : (rzecz.) areometr | : (rzecz.) densymetr | : (rzecz.) densytometr | : (rzecz.) gęstościomierz
densitometry : densitometry : (rzecz.) densytometria
density : density : (rzecz.) gęstość | : (rzecz.) skupienie | : (rzecz.) spoistość | : (rzecz.) tępota | : (rzecz.) zaczernienie | : (rzecz.) zagęszczenie | : (rzecz.) zwartość
dent : dent : (czas.) szczerbić | : (czas.) wgniatać | : (rzecz.) nacięcie | : (rzecz.) szczerba | : (rzecz.) uszczerbek | : (rzecz.) wgięcie | : (rzecz.) wgniecenie | : (rzecz.) wklęśnięcie
dental : dental : (przym.) dentystyczny | : (przym.) stomatologiczny | : (przym.) zębny | : (przym.) zębowy
dentally : dentally : (przysł.) zębowo
dentate : dentate : (przym.) ząbkowany
denticulate : denticulate : (przym.) ząbkowany
dentil : dentil : (rzecz.) ząbek
dentin : dentin : (rzecz.) zębina
dentine : dentine : (rzecz.) dentyna | : (rzecz.) zębina
dentist : dentist : (rzecz.) dentysta | : (rzecz.) stomatolog
dentist's : dentist's : (przym.) dentystyczny | : (przym.) stomatologiczny
dentistry : dentistry : (rzecz.) dentystyka | : (rzecz.) stomatologia
dentition : dentition : (rzecz.) uzębienie | : (rzecz.) ząbkowanie
denuclearized : denuclearized : (przym.) bezatomowy
denudation : denudation : (rzecz.) denudacja | : (rzecz.) obnażanie | : (rzecz.) ogołacanie
denude : denude : (czas.) odsłaniać | : (czas.) odsłonić
denunciation : denunciation : (rzecz.) denuncjacja | : (rzecz.) doniesienie | : (rzecz.) donos | : (rzecz.) oskarżenie | : (rzecz.) wypowiedzenie | : (rzecz.) zadenuncjowanie
denunciator : denunciator : (rzecz.) denuncjator
denunciatory : denunciatory : (przym.) donosicielski
deny : deny : (czas.) dementować | : (czas.) negować | : (czas.) odmawiać | : (czas.) odmówić | : (czas.) przeczyć | : (czas.) wypierać | : (czas.) wyrzekać | : (czas.) zaoponować | : (czas.) zapierać | : (czas.) zaprzeć | : (czas.) zaprzeczać | : (czas.) zaprzeczyć
deodorant : deodorant : (rzecz.) dezodorant
deodorisation : deodorisation : (rzecz.) dezodoryzacja
deodorise : deodorise : (czas.) zdezynfekować
deodorization : deodorization : (rzecz.) dezodoryzacja | : (rzecz.) odświeżanie | : (rzecz.) odwanianie
deodorize : deodorize : (czas.) dezodoryzować | : (czas.) odświeżyć
deodorizer : deodorizer : (rzecz.) dezodorant
deontology : deontology : (rzecz.) deontologia | : (rzecz.) etyka
deoxidization : deoxidization : (rzecz.) redukcja
deoxidize : deoxidize : (czas.) odtleniać
deoxidizer : deoxidizer : (rzecz.) odtleniacz
deoxidizing : deoxidizing : (rzecz.) odtlenianie | : (rzecz.) odtlenienie
depart : depart : (czas.) odbiegać | : (czas.) odchodzić | : (czas.) odejść | : (czas.) odjechać | : (czas.) odjeżdżać | : (czas.) odlatywać | : (czas.) odstąpić | : (czas.) odstępować | : (czas.) wyruszać
department : department : (rzecz.) departament | : (rzecz.) dział | : (rzecz.) instytut | : (rzecz.) katedra | : (rzecz.) ministerstwo | : (rzecz.) oddział | : (rzecz.) pion | : (rzecz.) referat | : (rzecz.) resort | : (rzecz.) sekcja | : (rzecz.) specjalność | : (rzecz.) stoisko | : (rzecz.) urząd | : (rzecz.) wydział
departmental : departmental : (przym.) działowy | : (przym.) oddziałowy | : (przym.) resortowy | : (przym.) wydziałowy
departure : departure : (rzecz.) odbieganie | : (rzecz.) odchylenie | : (rzecz.) odejście | : (rzecz.) odjazd | : (rzecz.) odlot | : (rzecz.) odstępstwo | : (rzecz.) wyjazd | : (rzecz.) wyjście | : (rzecz.) wymarsz
depend : depend : (czas.) liczyć | : (czas.) polegać | : (czas.) policzyć | : (czas.) zależeć
dependability : dependability : (rzecz.) niezawodność | : (rzecz.) pewność | : (rzecz.) upewnienie | : (rzecz.) zależność
dependable : dependable : (przym.) niezawodny | : (przym.) pewny
dependence : dependence : (rzecz.) poddaństwo | : (rzecz.) przyległość | : (rzecz.) uzależnienie | : (rzecz.) zależność | : (rzecz.) zaufanie
dependency : dependency : (rzecz.) uzależnienie | : (rzecz.) zależność
dependent : dependent : (przym.) niesamodzielny | : (przym.) podległy | : (przym.) podrzędny | : (przym.) zależny
dependently : dependently : (przysł.) zależnie
depersonalisation : depersonalisation : (rzecz.) depersonalizacja
depersonalization : depersonalization : (rzecz.) depersonalizacja
depict : depict : (czas.) malować | : (czas.) obrazować | : (czas.) opisywać | : (czas.) przedstawiać | : (czas.) rysować | : (czas.) zobrazować
depiction : depiction : (rzecz.) przedstawienie
depilate : depilate : (czas.) depilować
depilating : depilating : (przym.) depilacyjny
depilation : depilation : (rzecz.) depilacja | : (rzecz.) odwłaszanie
depilatory : depilatory : (przym.) depilacyjny | : (przym.) epilacyjny | : (rzecz.) depilator
deplete : deplete : (czas.) usuwać | : (czas.) uszczuplać | : (czas.) wyczerpać | : (czas.) wyczerpywać | : (czas.) wyeksploatować | : (czas.) wykorzystać | : (czas.) wyniszczyć | : (czas.) wypróżniać | : (czas.) wypróżnić
depletion : depletion : (rzecz.) uszczuplenie | : (rzecz.) wyczerpanie | : (rzecz.) wyczerpywanie | : (rzecz.) zubożenie
deplorable : deplorable : (przym.) opłakany | : (przym.) żałosny
deplore : deplore : (czas.) opłakiwać | : (czas.) potępiać | : (czas.) ubolewać
deploy : deploy : (czas.) rozmieścić | : (czas.) rozmieszczać | : (czas.) wdrożyć | : (czas.) zainstalować
deployment : deployment : (rzecz.) rozmieszczanie | : (rzecz.) rozprzestrzenianie | : (rzecz.) wdrożenie
deplumation : deplumation : (rzecz.) oskubywanie
deplume : deplume : (czas.) oskubać
depolarisation : depolarisation : (rzecz.) depolaryzacja
depolarization : depolarization : (rzecz.) depolaryzacja
depolarize : depolarize : (czas.) depolaryzować
depolarizer : depolarizer : (rzecz.) depolaryzator
depoliticize : depoliticize : (czas.) odpolityczniać | : (czas.) odpolitycznić
depopulate : depopulate : (czas.) wyludniać | : (czas.) wyludnić
depopulation : depopulation : (rzecz.) wybijanie | : (rzecz.) wyludnianie | : (rzecz.) wyludnienie
deport : deport : (czas.) deportować | : (czas.) przesiedlać | : (czas.) zachowywać | : (czas.) zesłać
deportation : deportation : (rzecz.) deportacja | : (rzecz.) deportowanie
deportee : deportee : (rzecz.) zesłaniec
deportment : deportment : (rzecz.) postawa | : (rzecz.) zachowanie
depose : depose : (czas.) dymisjonować | : (czas.) poświadczać | : (czas.) zeznawać
deposit : deposit : (czas.) deponować | : (czas.) odkładać | : (czas.) odraczać | : (czas.) strącać | : (czas.) zdeponować | : (rzecz.) akonto | : (rzecz.) depozyt | : (rzecz.) kaucja | : (rzecz.) lokata | : (rzecz.) nalot | : (rzecz.) osad | : (rzecz.) pokład | : (rzecz.) wadium | : (rzecz.) wkład | : (rzecz.) wpłata | : (rzecz.) zadatek | : (rzecz.) zastaw | : (rzecz.) zdeponowanie | : (rzecz.) złoże
depositary : depositary : (rzecz.) depozytariusz
deposition : deposition : (rzecz.) detronizacja | : (rzecz.) odkładanie | : (rzecz.) osadzanie | : (rzecz.) osadzenie | : (rzecz.) usunięcie | : (rzecz.) wbudowywanie | : (rzecz.) zeznanie
depositor : depositor : (rzecz.) deponent | : (rzecz.) depozytor
depository : depository : (rzecz.) depozyt | : (rzecz.) skład
depot : depot : (rzecz.) dworzec | : (rzecz.) kadra | : (rzecz.) magazyn | : (rzecz.) remiza | : (rzecz.) skład | : (rzecz.) składnica | : (rzecz.) wagonownia | : (rzecz.) zajezdnia
depravation : depravation : (rzecz.) deprawacja | : (rzecz.) zdeprawowanie
deprave : deprave : (czas.) demoralizować | : (czas.) deprawować | : (czas.) zdemoralizować | : (czas.) zdeprawować
depraved : depraved : (przym.) niemoralny
depravity : depravity : (rzecz.) demoralizacja | : (rzecz.) deprawacja
deprecate : deprecate : (czas.) ganić | : (czas.) odżegnać | : (czas.) odżegnywać | : (czas.) potępiać | : (czas.) przeciwdziałać
deprecation : deprecation : (rzecz.) dezaprobata | : (rzecz.) odżegnywanie
depreciate : depreciate : (czas.) deprecjonować | : (czas.) pomniejszać | : (czas.) zdeprecjonować
depreciation : depreciation : (rzecz.) amortyzacja | : (rzecz.) deprecjacja | : (rzecz.) dewaluacja
depredate : depredate : (czas.) pustoszyć | : (czas.) rabować
depredation : depredation : (rzecz.) grabież | : (rzecz.) rabunek
depress : depress : (czas.) dociskać | : (czas.) gnębić | : (czas.) naciskać | : (czas.) obniżać | : (czas.) obniżyć | : (czas.) pognębiać | : (czas.) przybijać | : (czas.) przygnębiać | : (czas.) struć | : (czas.) tłumić | : (czas.) zmartwić
depressed : depressed : (przym.) przygnębiony
depressing : depressing : (przym.) przygnębiający
depression : depression : (rzecz.) depresja | : (rzecz.) kryzys | : (rzecz.) niż | : (rzecz.) osowiałość | : (rzecz.) przygnębienie | : (rzecz.) zagłębienie | : (rzecz.) zapadlisko
depressive : depressive : (przym.) depresyjny
depressurize : depressurize : (czas.) rozhermetyzować
deprivation : deprivation : (rzecz.) ograniczenie | : (rzecz.) pozbawienie | : (rzecz.) utrata
deprive : deprive : (czas.) odebrać | : (czas.) pozbawiać | : (czas.) pozbawić
deprived : deprived : (czas.) pozbawiać
dept : dept : (rzecz.) deptanie
depth : depth : (rzecz.) dogłębność | : (rzecz.) głębia | : (rzecz.) głębina | : (rzecz.) głębokość | : (rzecz.) otchłań | : (rzecz.) toń
depth-hardening : depth-hardening : (rzecz.) hartowność
depths : depths : (rzecz.) czeluść | : (rzecz.) toń
deputation : deputation : (rzecz.) delegacja | : (rzecz.) deputacja | : (rzecz.) poselstwo
depute : depute : (czas.) upełnomocniać | : (czas.) upełnomocnić | : (czas.) wydelegować
deputize : deputize : (czas.) umieścić | : (czas.) umieszczać | : (czas.) wymieniać | : (czas.) wymienić | : (czas.) zastępować
deputy : deputy : (przym.) deputowany | : (rzecz.) delegat | : (rzecz.) wicedyrektor | : (rzecz.) zastępca | : (rzecz.) zastępczyni
derail : derail : (czas.) wykoleić | : (czas.) wykolejać
derailleur : derailleur : (rzecz.) przerzutka
derailment : derailment : (rzecz.) wykolejenie
derange : derange : (czas.) burzyć | : (czas.) dezorganizować | : (czas.) psuć | : (czas.) rozstrajać
deranged : deranged : (przym.) nienormalny
derangement : derangement : (rzecz.) dezorganizacja | : (rzecz.) nieład | : (rzecz.) nieporządek | : (rzecz.) zaburzenie | : (rzecz.) zakłócenie | : (rzecz.) zepsucie
derby : derby : (rzecz.) melonik
dereferencing : dereferencing : (rzecz.) wyłuskiwanie
deregulate : deregulate : (czas.) sprywatyzować
deregulation : deregulation : (rzecz.) deregulacja | : (rzecz.) prywatyzacja
derelict : derelict : (przym.) bezpański
dereliction : dereliction : (rzecz.) opuszczenie | : (rzecz.) porzucenie | : (rzecz.) zaniedbanie
derequisition : derequisition : (czas.) zwalniać
deride : deride : (czas.) naśmiewać | : (czas.) szydzić | : (czas.) wyśmiewać
derision : derision : (rzecz.) drwina | : (rzecz.) pośmiewisko | : (rzecz.) szyderstwo | : (rzecz.) wyśmiewanie | : (rzecz.) wyszydzanie
derisive : derisive : (przym.) niepoważny | : (przym.) szyderczy | : (przym.) urągliwy
derisively : derisively : (przysł.) kpiąco
derisiveness : derisiveness : (rzecz.) prześmiewczość
derisory : derisory : (przym.) kpiarski | : (przym.) niepoważny | : (przym.) szyderczy
derivation : derivation : (rzecz.) derywacja | : (rzecz.) pochodzenie | : (rzecz.) wyprowadzenie
derivative : derivative : (przym.) pochodny | : (przym.) wtórny | : (rzecz.) derywat | : (rzecz.) pochodna
derive : derive : (czas.) brać | : (czas.) czerpać | : (czas.) derywować | : (czas.) pobierać | : (czas.) pochodzić | : (czas.) uzyskiwać | : (czas.) wyprowadzać | : (czas.) wyprowadzić | : (czas.) wywodzić
derived : derived : (przym.) pochodny
dermal : dermal : (przym.) skórny
dermatological : dermatological : (przym.) dermatologiczny
dermatologist : dermatologist : (rzecz.) dermatolog
dermatology : dermatology : (rzecz.) dermatologia
derogate : derogate : (czas.) odstąpić | : (czas.) odstępować | : (czas.) pomniejszać | : (czas.) umniejszać | : (czas.) uwłaczać
derogation : derogation : (rzecz.) derogacja | : (rzecz.) odstępowanie | : (rzecz.) uchylenie
derrick : derrick : (rzecz.) dźwig | : (rzecz.) wiertnica
derricking : derricking : (rzecz.) podnoszenie
derriere : derriere : (rzecz.) siedzenie
desalinate : desalinate : (czas.) odsalać | : (czas.) odsolić
desalination : desalination : (rzecz.) gleby | : (rzecz.) odsalanie
desalinise : desalinise : (rzecz.) odsalanie
desalinization : desalinization : (rzecz.) odsalanie
descant : descant : (rzecz.) dyszkant
descend : descend : (czas.) chodzić | : (czas.) dziedziczyć | : (czas.) obniżać | : (czas.) opadać | : (czas.) opuszczać | : (czas.) pochodzić | : (czas.) schodzić | : (czas.) spadać | : (czas.) wejść | : (czas.) wyprowadzać | : (czas.) wywodzić | : (czas.) zastępować | : (czas.) zejść
descendant : descendant : (rzecz.) potomek
descending : descending : (przym.) zstępny
descent : descent : (rzecz.) desant | : (rzecz.) lądowanie | : (rzecz.) obniżenie | : (rzecz.) opadanie | : (rzecz.) pochodzenie | : (rzecz.) pochyłość | : (rzecz.) spadek | : (rzecz.) stok | : (rzecz.) zejście | : (rzecz.) zniżanie | : (rzecz.) zniżenie | : (rzecz.) zstąpienie
descramble : descramble : (czas.) odszyfrować
descrambler : descrambler : (rzecz.) deszyfrator
describable : describable : (przym.) opisywalny
describe : describe : (czas.) określać | : (czas.) opisać | : (czas.) opisywać
description : description : (rzecz.) deskrypcja | : (rzecz.) określanie | : (rzecz.) opis | : (rzecz.) opisanie | : (rzecz.) rodzaj | : (rzecz.) rysopis
descriptive : descriptive : (przym.) opisowy
descriptor : descriptor : (rzecz.) deskryptor
descry : descry : (czas.) ujrzeć | : (czas.) wypatrywać | : (czas.) wypatrzyć | : (czas.) zobaczyć
desecrate : desecrate : (czas.) bezcześcić | : (czas.) plugawić | : (czas.) profanować | : (czas.) zbezcześcić | : (czas.) zbezczeszczać
desecration : desecration : (rzecz.) profanacja | : (rzecz.) zbezczeszczenie
desegregate : desegregate : (czas.) eliminować | : (czas.) znieść
desegregation : desegregation : (rzecz.) desegregacja
deselect : deselect : (czas.) odznaczyć
desensitise : desensitise : (czas.) odczulać | : (czas.) odczulić
desensitization : desensitization : (rzecz.) desensybilizacja | : (rzecz.) flegmatyzacja | : (rzecz.) odczulanie | : (rzecz.) odczulenie
desensitize : desensitize : (czas.) odczulać | : (czas.) znieczulać | : (czas.) znieczulić
desert : desert : (czas.) dezerterować | : (czas.) opuścić | : (czas.) opuszczać | : (czas.) osamotnić | : (czas.) porzucać | : (czas.) porzucić | : (czas.) zdezerterować | : (czas.) zostawiać | : (czas.) zostawić | : (rzecz.) pustka | : (rzecz.) pustkowie | : (rzecz.) pustynia
deserted : deserted : (przym.) bezludny
deserter : deserter : (rzecz.) dezerter | : (rzecz.) uciekinier
desertification : desertification : (rzecz.) pustynnienie
desertion : desertion : (rzecz.) dezercja | : (rzecz.) zbiegostwo
deserve : deserve : (czas.) zasługiwać
deserved : deserved : (przym.) celny
deservedly : deservedly : (przysł.) sprawiedliwie
deserving : deserving : (przym.) godny
desiccant : desiccant : (rzecz.) desykant | : (rzecz.) osuszacz
desiccate : desiccate : (czas.) suszyć
desiccation : desiccation : (rzecz.) osuszanie | : (rzecz.) osuszenie | : (rzecz.) wysuszanie | : (rzecz.) wysychanie
desiderata : desiderata : (rzecz.) dezyderaty
desideratum : desideratum : (rzecz.) dezyderat
design : design : (czas.) pomyśleć | : (czas.) projektować | : (czas.) przeznaczać | : (czas.) zamierzać | : (rzecz.) aranżacja | : (rzecz.) cel | : (rzecz.) deseń | : (rzecz.) projekt | : (rzecz.) projektowanie | : (rzecz.) rysownictwo | : (rzecz.) rysunek | : (rzecz.) wygląd | : (rzecz.) wzór | : (rzecz.) wzornictwo | : (rzecz.) zamiar | : (rzecz.) zamysł
design-time : design-time : (przym.) projektowy
designate : designate : (czas.) desygnować | : (czas.) oznaczać | : (czas.) typować | : (czas.) wskazywać | : (czas.) wyznaczać
designation : designation : (rzecz.) desygnacja | : (rzecz.) mianowanie | : (rzecz.) określenie | : (rzecz.) opis | : (rzecz.) oznaczenie | : (rzecz.) wyznaczanie | : (rzecz.) wyznaczenie
designator : designator : (rzecz.) desygnator | : (rzecz.) oznaczenie | : (rzecz.) oznacznik
designed : designed : (przym.) projektowy
designedly : designedly : (przysł.) rozmyślnie | : (przysł.) umyślnie
designer : designer : (rzecz.) konstruktor | : (rzecz.) kreślarz | : (rzecz.) projektant | : (rzecz.) projektodawca | : (rzecz.) rysownik
designing : designing : (przym.) podstępny | : (rzecz.) konstruowanie | : (rzecz.) planowanie | : (rzecz.) projektowanie
desirability : desirability : (rzecz.) celowość | : (rzecz.) zaleta
desirable : desirable : (przym.) atrakcyjny | : (przym.) odpowiedni | : (przym.) pożądany | : (przym.) właściwy
desire : desire : (czas.) pożądać | : (czas.) pragnąć | : (czas.) życzyć | : (rzecz.) apetyt | : (rzecz.) chęć | : (rzecz.) pożądanie | : (rzecz.) pragnienie | : (rzecz.) żądza | : (rzecz.) życzenie
desist : desist : (czas.) odstąpić | : (czas.) odstępować | : (czas.) wstrzymać | : (czas.) zaniechać | : (czas.) zaprzestać
desk : desk : (rzecz.) biurko | : (rzecz.) ławka | : (rzecz.) recepcja
desktop : desktop : (przym.) biurkowy
desolate : desolate : (czas.) opuścić | : (czas.) opuszczać | : (czas.) pustoszyć | : (przym.) odludny
desolation : desolation : (rzecz.) dewastacja | : (rzecz.) osamotnienie | : (rzecz.) pustka | : (rzecz.) pustkowie | : (rzecz.) samotność | : (rzecz.) spustoszenie | : (rzecz.) zniszczenie
despair : despair : (czas.) desperować | : (czas.) rozpaczać | : (rzecz.) desperacja | : (rzecz.) rozpacz
despairingly : despairingly : (przysł.) beznadziejnie
despatch : despatch : (czas.) ekspediować | : (czas.) wysyłać
desperado : desperado : (rzecz.) desperat | : (rzecz.) straceniec
desperate : desperate : (przym.) beznadziejny | : (przym.) desperacki | : (przym.) nierozważny | : (przym.) rozpaczliwy | : (przym.) straceńczy | : (przym.) zaciekły
desperately : desperately : (przysł.) rozpaczliwie
desperation : desperation : (rzecz.) desperacja | : (rzecz.) rozpacz
despicable : despicable : (przym.) nikczemny | : (przym.) podły
despise : despise : (czas.) gardzić | : (czas.) nienawidzić | : (czas.) pogardzać | : (czas.) wzgardzić
despite : despite : (przyim.) mimo | : (przyim.) pomimo | : (przyim.) wbrew | : (rzecz.) mino
despoil : despoil : (czas.) obrabować
despoilment : despoilment : (rzecz.) zanieczyszczenie
despoliation : despoliation : (rzecz.) profanowanie
despond : despond : (czas.) przygnębić | : (czas.) zasępiać
despondency : despondency : (rzecz.) przygnębienie | : (rzecz.) zniechęcenie
despot : despot : (rzecz.) despota
despotic : despotic : (przym.) absolutny | : (przym.) bezwzględny | : (przym.) despotyczny
despotism : despotism : (rzecz.) despotyzm
desquamation : desquamation : (rzecz.) naskórka
dessert : dessert : (rzecz.) deser | : (rzecz.) legumina
destabilisation : destabilisation : (rzecz.) destabilizacja
destabilization : destabilization : (rzecz.) destabilizacja
destabilize : destabilize : (czas.) destabilizować | : (czas.) zdestabilizować
destabilizing : destabilizing : (rzecz.) destabilizowanie
destination : destination : (rzecz.) adresat | : (rzecz.) cel | : (rzecz.) przeznaczenie
destine : destine : (czas.) przeznaczać | : (czas.) wyznaczać
destiny : destiny : (rzecz.) dola | : (rzecz.) los | : (rzecz.) nieuchronność | : (rzecz.) predestynacja | : (rzecz.) przeznaczenie
destitute : destitute : (przym.) pozbawiony
destitution : destitution : (rzecz.) bieda | : (rzecz.) nędza | : (rzecz.) ogołocenie | : (rzecz.) ubóstwo
destroy : destroy : (czas.) anihilować | : (czas.) burzyć | : (czas.) niszczyć | : (czas.) poniszczyć | : (czas.) spustoszyć | : (czas.) tępić | : (czas.) uśmiercać | : (czas.) wygubić | : (czas.) zburzyć | : (czas.) zniszczyć | : (czas.) zniweczyć
destroyed : destroyed : (czas.) wytracić | : (czas.) wytrącić
destroyer : destroyer : (rzecz.) burzyciel | : (rzecz.) kontrtorpedowiec | : (rzecz.) niszczyciel
destruct : destruct : (czas.) zniszczyć
destructible : destructible : (przym.) zniszczalny
destruction : destruction : (rzecz.) destrukcja | : (rzecz.) niszczenie | : (rzecz.) rażenie | : (rzecz.) ruina | : (rzecz.) spustoszenie | : (rzecz.) zagłada | : (rzecz.) zburzenie | : (rzecz.) zgładzenie | : (rzecz.) zguba | : (rzecz.) zniszczenie | : (rzecz.) zniweczenie
destructive : destructive : (przym.) burzycielski | : (przym.) destrukcyjny | : (przym.) destruktywny | : (przym.) niszczący | : (przym.) niszczycielski | : (przym.) zabójczy | : (przym.) zgubny
destructiveness : destructiveness : (rzecz.) destrukcyjność
destructor : destructor : (rzecz.) destruktor
desultory : desultory : (przym.) bezładny | : (przym.) bezplanowy | : (przym.) chaotyczny | : (przym.) pobieżny | : (przym.) przypadkowy
detach : detach : (czas.) odczepiać | : (czas.) odczepić | : (czas.) oddzielać | : (czas.) oderwać | : (czas.) odizolować | : (czas.) odklejać | : (czas.) odkomenderować | : (czas.) odłączać | : (czas.) odłączyć | : (czas.) odlepiać | : (czas.) odlepić | : (czas.) odrywać | : (czas.) odseparować | : (czas.) zdjąć
detachable : detachable : (przym.) odejmowalny | : (przym.) odejmowany | : (przym.) odłączalny
detached : detached : (czas.) oderwać | : (przym.) bezstronny | : (przym.) odłączony
detachment : detachment : (rzecz.) dystans | : (rzecz.) hufiec | : (rzecz.) izolacja | : (rzecz.) obcość | : (rzecz.) obojętność | : (rzecz.) oddział | : (rzecz.) oddzielenie | : (rzecz.) oderwanie | : (rzecz.) odłączenie | : (rzecz.) odosobnienie | : (rzecz.) rozdzielenie | : (rzecz.) wyrywanie
detail : detail : (czas.) uszczegółowić | : (czas.) wyszczególniać | : (rzecz.) detal | : (rzecz.) szczegół | : (rzecz.) szczegółowość
detailed : detailed : (przym.) drobiazgowy | : (przym.) szczegółowy
detain : detain : (czas.) aresztować | : (czas.) przetrzymywać | : (czas.) utrzymywać | : (czas.) zatrzymywać
detainment : detainment : (rzecz.) zwlekanie
detect : detect : (czas.) dostrajać | : (czas.) dostrzegać | : (czas.) doszukać | : (czas.) odkryć | : (czas.) odkrywać | : (czas.) przechwycić | : (czas.) wyczuwać | : (czas.) wykryć | : (czas.) wykrywać | : (czas.) wypatrzyć | : (czas.) zauważyć
detectable : detectable : (przym.) wykrywalny
detectible : detectible : (przym.) widoczny | : (przym.) wykrywalny
detection : detection : (rzecz.) detekcja | : (rzecz.) odkrycie | : (rzecz.) pochwycenie | : (rzecz.) wykrycie | : (rzecz.) wykrywanie
detective : detective : (przym.) detektywistyczny | : (przym.) śledczy | : (rzecz.) detektyw | : (rzecz.) wywiadowca
detector : detector : (rzecz.) czujnik | : (rzecz.) detektor | : (rzecz.) wykrywacz
detent : detent : (rzecz.) zapadka
detente : detente : (rzecz.) odprężenie
detention : detention : (rzecz.) areszt | : (rzecz.) karcer | : (rzecz.) odosobnienie | : (rzecz.) uwięzienie | : (rzecz.) zatrzymanie
deter : deter : (czas.) odstraszać | : (czas.) odstraszyć | : (czas.) odstręczać | : (czas.) powstrzymywać
detergent : detergent : (przym.) chwastobójczy | : (przym.) czyszczący | : (rzecz.) detergent
deteriorate : deteriorate : (czas.) pogarszać | : (czas.) psuć | : (czas.) wyrodnieć
deterioration : deterioration : (rzecz.) degradacja | : (rzecz.) deterioracja | : (rzecz.) podupadanie | : (rzecz.) pogorszenie | : (rzecz.) psucie
determent : determent : (rzecz.) odstraszenie
determinable : determinable : (przym.) obrabialny | : (przym.) wyznaczalny
determinant : determinant : (rzecz.) determinanta | : (rzecz.) wyznacznik
determinate : determinate : (przym.) określony | : (przym.) ostateczny | : (przym.) oznaczony | : (przym.) wyznaczony
determination : determination : (rzecz.) determinacja | : (rzecz.) określanie | : (rzecz.) określenie | : (rzecz.) oznaczanie | : (rzecz.) oznaczenie | : (rzecz.) postanowienie | : (rzecz.) stanowczość | : (rzecz.) wyznaczanie | : (rzecz.) zdecydowanie
determinative : determinative : (rzecz.) decydowanie
determine : determine : (czas.) decydować | : (czas.) determinować | : (czas.) ograniczać | : (czas.) określać | : (czas.) postanawiać | : (czas.) rozstrzygać | : (czas.) skłaniać | : (czas.) skłonić | : (czas.) ustalać | : (czas.) ustawiać | : (czas.) wskazać | : (czas.) zadecydować | : (czas.) zakańczać | : (czas.) zdecydować
determiner : determiner : (rzecz.) określnik
determinism : determinism : (rzecz.) determinizm
deterministic : deterministic : (przym.) deterministyczny
deterrence : deterrence : (rzecz.) odstraszanie | : (rzecz.) odstraszenie
deterrent : deterrent : (przym.) zapobiegliwy | : (rzecz.) flegmatyzator
deterring : deterring : (rzecz.) odstraszanie | : (rzecz.) zastraszanie
detest : detest : (czas.) nienawidzić
detestable : detestable : (przym.) obrzydliwy | : (przym.) wstrętny
detestation : detestation : (rzecz.) nienawiść | : (rzecz.) wstręt
dethrone : dethrone : (czas.) detronizować | : (czas.) zdetronizować
dethronement : dethronement : (rzecz.) detronizacja | : (rzecz.) detronizowanie
detonate : detonate : (czas.) detonować | : (czas.) zdetonować
detonation : detonation : (rzecz.) detonacja | : (rzecz.) wybuch
detonator : detonator : (rzecz.) pobudzacz | : (rzecz.) spłonka | : (rzecz.) zapalnik
detour : detour : (rzecz.) objazd
detoxification : detoxification : (rzecz.) detoksykacja | : (rzecz.) odtruwanie
detoxifier : detoxifier : (rzecz.) odtrutka
detoxify : detoxify : (czas.) odtruwać
detract : detract : (czas.) oczerniać | : (czas.) odciągać | : (czas.) pomniejszać | : (czas.) ujmować | : (czas.) umniejszać | : (czas.) uszczuplać
detraction : detraction : (rzecz.) umniejszanie
detractor : detractor : (rzecz.) krytyk | : (rzecz.) oszczerca
detrain : detrain : (czas.) wyładowywać
detriment : detriment : (rzecz.) szkoda | : (rzecz.) ujma | : (rzecz.) uszczerbek
detrimental : detrimental : (przym.) nierentowny | : (przym.) szkodliwy
detritus : detritus : (rzecz.) detrytus
detune : detune : (czas.) rozstrajać | : (czas.) rozstroić
deuce : deuce : (rzecz.) czart | : (rzecz.) diabeł | : (rzecz.) dwójka | : (rzecz.) licho | : (rzecz.) równowaga
deuced : deuced : (przym.) diabelny | : (przym.) diabelski
deucedly : deucedly : (przysł.) diabelnie
deuterium : deuterium : (rzecz.) deuter
deuteron : deuteron : (rzecz.) deuteron
devaluate : devaluate : (czas.) dewaluować | : (czas.) zdewaluować
devaluation : devaluation : (rzecz.) dewaluacja | : (rzecz.) zdewaluowanie
devalue : devalue : (czas.) dewaluować | : (czas.) lekceważyć | : (czas.) zdewaluować
devastate : devastate : (czas.) dewastować | : (czas.) niszczyć | : (czas.) pustoszyć | : (czas.) rujnować | : (czas.) spustoszyć | : (czas.) zdewastować | : (czas.) zmniejszać
devastated : devastated : (przym.) zdruzgotany | : (przym.) zniszczony
devastating : devastating : (przym.) destrukcyjny | : (przym.) niszczycielski
devastation : devastation : (rzecz.) dewastacja | : (rzecz.) pustoszenie | : (rzecz.) ruina | : (rzecz.) spustoszenie | : (rzecz.) wyniszczenie | : (rzecz.) zniszczenie
devastator : devastator : (rzecz.) dewastator
develop : develop : (czas.) doskonalić | : (czas.) opracować | : (czas.) opracowywać | : (czas.) rozbudować | : (czas.) rozrastać | : (czas.) rozwijać | : (czas.) skonstruować | : (czas.) tworzyć | : (czas.) utworzyć | : (czas.) wypracować | : (czas.) wywołać | : (czas.) wywoływać
developer : developer : (rzecz.) inwestor | : (rzecz.) programista | : (rzecz.) wywoływacz
development : development : (rzecz.) doskonalenie | : (rzecz.) opracowanie | : (rzecz.) opracowywanie | : (rzecz.) osiągniecie | : (rzecz.) postęp | : (rzecz.) rozbudowa | : (rzecz.) rozwinięcie | : (rzecz.) rozwój | : (rzecz.) rozwożenie | : (rzecz.) wniosek | : (rzecz.) wydarzenie | : (rzecz.) wywoływanie | : (rzecz.) wzrost | : (rzecz.) zabudowa
developmental : developmental : (przym.) rozwojowy
deviance : deviance : (rzecz.) dewiacja
deviancy : deviancy : (rzecz.) zboczenie
deviant : deviant : (przym.) dewiacyjny | : (przym.) nienormalny
deviate : deviate : (czas.) odchylać | : (czas.) uchylać | : (czas.) zbaczać | : (czas.) zboczyć
deviation : deviation : (rzecz.) błąd | : (rzecz.) dewiacja | : (rzecz.) odchylanie | : (rzecz.) odchylenie | : (rzecz.) odchyłka | : (rzecz.) uchyb | : (rzecz.) zbaczanie | : (rzecz.) zboczenie
deviator : deviator : (rzecz.) dewiator
deviatory : deviatory : (przym.) dewiacyjny
device : device : (rzecz.) automat | : (rzecz.) chwyt | : (rzecz.) dewiza | : (rzecz.) godło | : (rzecz.) hasło | : (rzecz.) maszynka | : (rzecz.) metoda | : (rzecz.) plan | : (rzecz.) pomysł | : (rzecz.) przyrząd | : (rzecz.) sposób | : (rzecz.) urządzenie
devil : devil : (rzecz.) bies | : (rzecz.) czart | : (rzecz.) czort | : (rzecz.) diabeł | : (rzecz.) kaduk | : (rzecz.) licho | : (rzecz.) szatan
devil-may-care : devil-may-care : (przym.) beztroski
devilfish : devilfish : (przym.) diabelski
devilish : devilish : (przym.) diabelski | : (przym.) piekielny | : (przym.) szatański | : (przysł.) diabelsko
devilishly : devilishly : (przysł.) diabelsko
devilment : devilment : (rzecz.) diabelstwo | : (rzecz.) łobuzerstwo
devilry : devilry : (rzecz.) demonologia | : (rzecz.) diabelstwo
devious : devious : (przym.) okrężny | : (przym.) pokrętny
deviousness : deviousness : (rzecz.) przebiegłość
devise : devise : (czas.) koncypować | : (czas.) obmyślać | : (czas.) opracowywać | : (czas.) wymyślać | : (czas.) wymyślić | : (czas.) wynajdować | : (czas.) wynaleźć
devoid : devoid : (przym.) pozbawiony | : (przym.) próżny
devolution : devolution : (rzecz.) dziedzictwo | : (rzecz.) sukcesja
devolve : devolve : (czas.) przechodzić | : (czas.) przekazywać
devote : devote : (czas.) oddawać | : (czas.) poświęcać | : (czas.) przeznaczać | : (czas.) przeznaczyć
devoted : devoted : (przym.) oddany | : (przym.) poświęcający
devotee : devotee : (rzecz.) czciciel | : (rzecz.) entuzjasta | : (rzecz.) wielbiciel | : (rzecz.) zapaleniec | : (rzecz.) zelant
devotion : devotion : (rzecz.) dewocja | : (rzecz.) nabożeństwo | : (rzecz.) oddanie | : (rzecz.) pobożność | : (rzecz.) poświęcenie | : (rzecz.) przywiązanie | : (rzecz.) religijność
devotional : devotional : (przym.) nabożny
devotions : devotions : (rzecz.) pacierz
devour : devour : (czas.) chłonąć | : (czas.) pochłaniać | : (czas.) pożerać | : (czas.) pożreć
devourer : devourer : (rzecz.) pożeracz
devout : devout : (przym.) bogobojny | : (przym.) gorliwy | : (przym.) pobożny | : (przym.) szczery
devoutly : devoutly : (przysł.) gorliwie | : (przysł.) pobożnie | : (przysł.) szczerze
devoutness : devoutness : (rzecz.) gorliwość | : (rzecz.) pobożność
dew : dew : (rzecz.) rosa
dewater : dewater : (czas.) odwadniać
dewatering : dewatering : (rzecz.) odwadniacz | : (rzecz.) odwadnianie
dewlap : dewlap : (rzecz.) podgardle
dewy : dewy : (przym.) rosisty
dexterity : dexterity : (rzecz.) bystrość | : (rzecz.) sprawność | : (rzecz.) zręczność | : (rzecz.) zwinność
dexterous : dexterous : (przym.) sprawny | : (przym.) zręczny | : (przym.) zwinny
dextrin : dextrin : (rzecz.) dekstryna
dextrorotatory : dextrorotatory : (przym.) prawoskrętny
dextrose : dextrose : (rzecz.) dekstroza | : (rzecz.) glikoza
dextrous : dextrous : (przym.) obrotny | : (przym.) sprawny | : (przym.) sprytny | : (przym.) zręczny
dharma : dharma : (rzecz.) cnota | : (rzecz.) prawo
diabetes : diabetes : (rzecz.) cukrzyca | : (rzecz.) diabetyk
diabetic : diabetic : (przym.) cukrzycowy | : (przym.) diaboliczny | : (rzecz.) cukrzyk | : (rzecz.) diabetyk
diabolic : diabolic : (przym.) diabelski | : (przym.) diaboliczny | : (przym.) piekielny | : (przym.) szatański
diabolical : diabolical : (przym.) diabelski | : (przym.) diaboliczny | : (przym.) piekielny | : (przym.) szatański
diacetylmorphine : diacetylmorphine : (rzecz.) heroina
diacritic : diacritic : (przym.) diakrytyczny
diacritical : diacritical : (przym.) diakrytyczny
diadem : diadem : (rzecz.) diadem
diagnosable : diagnosable : (przym.) diagnozowalny
diagnose : diagnose : (czas.) diagnozować | : (czas.) rozpoznać | : (czas.) rozpoznawać | : (czas.) zdiagnozować
diagnosis : diagnosis : (rzecz.) diagnostyka | : (rzecz.) diagnoza | : (rzecz.) diagnozowanie | : (rzecz.) rozpoznanie
diagnostic : diagnostic : (przym.) diagnostyczny | : (rzecz.) diagnostyka | : (rzecz.) objaw
diagnostician : diagnostician : (rzecz.) diagnosta
diagnostics : diagnostics : (rzecz.) diagnostyka
diagonal : diagonal : (przym.) diagonalny | : (przym.) poprzeczny | : (przym.) przekątny | : (przym.) skośny | : (przym.) ukośny | : (rzecz.) przekątna | : (rzecz.) przekątnia
diagonally : diagonally : (przysł.) diagonalnie | : (przysł.) ukośnie
diagram : diagram : (rzecz.) diagram | : (rzecz.) wykres
diagrammatic : diagrammatic : (przym.) graficzny | : (przym.) schematyczny
dial : dial : (czas.) łączyć | : (czas.) wybierać | : (czas.) wykręcać | : (rzecz.) cyferblat | : (rzecz.) pokrętło | : (rzecz.) strojenie | : (rzecz.) tarcza | : (rzecz.) zakres
dial-back : dial-back : (rzecz.) oddzwanianie
dialect : dialect : (rzecz.) dialekt | : (rzecz.) gwara | : (rzecz.) narzecze
dialectal : dialectal : (przym.) dialektalny | : (przym.) gwarowy
dialectical : dialectical : (przym.) dialektowy | : (przym.) dialektyczny
dialectician : dialectician : (rzecz.) dialektyk | : (rzecz.) dialektyka
dialectics : dialectics : (rzecz.) dialektyka
dialectology : dialectology : (rzecz.) dialektologia
dialler : dialler : (przym.) mierniczy
dialog : dialog : (rzecz.) dialog
dialogite : dialogite : (rzecz.) dialogit | : (rzecz.) rodochrozyt
dialogue : dialogue : (rzecz.) dialog | : (rzecz.) porozumienie | : (rzecz.) rozmowa | : (rzecz.) rozmówka
dialysis : dialysis : (rzecz.) dializa
diamagnetic : diamagnetic : (przym.) diamagnetyczny
diamagnetism : diamagnetism : (rzecz.) diamagnetyzm
diameter : diameter : (rzecz.) średnica
diametric : diametric : (przym.) diametralny
diametrical : diametrical : (przym.) diametralny
diametrically : diametrically : (przysł.) biegunowo | : (przysł.) diametralnie
diamond : diamond : (rzecz.) brylant | : (rzecz.) diament | : (rzecz.) karo | : (rzecz.) romb
diamonds : diamonds : (rzecz.) karo
diapason : diapason : (rzecz.) diapazon
diaper : diaper : (rzecz.) dymek | : (rzecz.) pielucha | : (rzecz.) pieluszka
diaphanous : diaphanous : (przym.) przezroczysty
diaphone : diaphone : (rzecz.) diafon
diaphoretic : diaphoretic : (przym.) napotny
diaphragm : diaphragm : (rzecz.) blenda | : (rzecz.) diafragma | : (rzecz.) membrana | : (rzecz.) przegroda | : (rzecz.) przepona | : (rzecz.) przesłona | : (rzecz.) przysłona
diaphragmatic : diaphragmatic : (przym.) przeponowy
diarist : diarist : (rzecz.) pamiętnikarz
diarrhoea : diarrhoea : (rzecz.) biegunka | : (rzecz.) rozstrój | : (rzecz.) rozwolnienie | : (rzecz.) sraczka
diarrhoeic : diarrhoeic : (przym.) biegunkowy
diary : diary : (rzecz.) diariusz | : (rzecz.) dziennik | : (rzecz.) kalendarz | : (rzecz.) kalendarzyk | : (rzecz.) notatnik | : (rzecz.) pamiętnik
diastase : diastase : (rzecz.) diastaza
diastole : diastole : (rzecz.) rozkurcz
diastolic : diastolic : (przym.) rozkurczowy
diastrophism : diastrophism : (rzecz.) diastrofizm
diathermy : diathermy : (rzecz.) diatermia
diathesis : diathesis : (rzecz.) skaza
diatom : diatom : (rzecz.) okrzemka
diatomic : diatomic : (przym.) dwuatomowy
diatonic : diatonic : (przym.) diatoniczny
diatribe : diatribe : (rzecz.) diatryba
dibasic : dibasic : (przym.) dwuzasadowy
dibs : dibs : (rzecz.) forsa
dice : dice : (rzecz.) kość | : (rzecz.) kostka
dicey : dicey : (przym.) niepewny | : (przym.) ryzykowny
dichotomous : dichotomous : (przym.) dychotomiczny
dichotomy : dichotomy : (rzecz.) dwudzielność | : (rzecz.) dychotomia
dichromate : dichromate : (rzecz.) dwuchromian
dick : dick : (rzecz.) kutas
dickens : dickens : (rzecz.) diabeł | : (rzecz.) łobuziak | : (rzecz.) szatan | : (rzecz.) urwis
dicker : dicker : (rzecz.) przetarg | : (rzecz.) transakcja | : (rzecz.) wymiana
dictate : dictate : (czas.) dyktować | : (czas.) nakazywać | : (czas.) podyktować | : (czas.) rozkazywać | : (rzecz.) dyktat | : (rzecz.) nakaz | : (rzecz.) przepis | : (rzecz.) rozkaz
dictation : dictation : (rzecz.) dyktando | : (rzecz.) dyktator | : (rzecz.) dyktowanie
dictator : dictator : (rzecz.) dyktator
dictatorial : dictatorial : (przym.) dyktatorski
dictatorship : dictatorship : (rzecz.) autorytatywność | : (rzecz.) dyktatorstwo | : (rzecz.) dyktatura
diction : diction : (rzecz.) dykcja
dictionary : dictionary : (rzecz.) słownik
dictum : dictum : (rzecz.) powiedzenie | : (rzecz.) wypowiedź
did : did : (czas.) czynić
didactic : didactic : (przym.) dydaktyczny | : (przym.) pedagogiczny
didactical : didactical : (przym.) dydaktyczny | : (przym.) pedagogiczny
didactically : didactically : (przysł.) dydaktycznie
didacticism : didacticism : (rzecz.) dydaktyzm
didactics : didactics : (rzecz.) dydaktyka
diddle : diddle : (czas.) kpić | : (czas.) nabierać | : (czas.) okpić | : (czas.) wykiwać
die : die : (czas.) ginąć | : (czas.) konać | : (czas.) mrzeć | : (czas.) skonać | : (czas.) umierać | : (czas.) umrzeć | : (czas.) zamierać | : (czas.) zdychać | : (czas.) zemrzeć | : (rzecz.) ciągadło | : (rzecz.) kokila | : (rzecz.) matryca | : (rzecz.) narzynka | : (rzecz.) tłocznik
die-stock : die-stock : (rzecz.) gwintownica
diehard : diehard : (przym.) twardogłowy | : (rzecz.) konserwatysta
dielectric : dielectric : (przym.) dielektryczny | : (rzecz.) dielektryk
dieresis : dieresis : (rzecz.) oddzielenie | : (rzecz.) rozdzielenie
diet : diet : (czas.) odchudzać | : (rzecz.) dieta | : (rzecz.) pożywienie | : (rzecz.) sejm | : (rzecz.) wyżywienie
dietary : dietary : (przym.) dietetyczny
dietetic : dietetic : (przym.) dietetyczny
dietetics : dietetics : (rzecz.) dietetyka
dietician : dietician : (rzecz.) dietetyk
differ : differ : (czas.) różnić
difference : difference : (rzecz.) dyferencja | : (rzecz.) nieporozumienie | : (rzecz.) różnica | : (rzecz.) rozrzut | : (rzecz.) spór
different : different : (przym.) inny | : (przym.) niejednakowy | : (przym.) odmienny | : (przym.) odrębny | : (przym.) rozmaity | : (przym.) różnoraki | : (przym.) rożny | : (przym.) różny | : (przym.) tożsamy
differentiable : differentiable : (przym.) różniczkowalny
differential : differential : (przym.) dyferencjalny | : (przym.) różnicowy | : (przym.) różniczkowy | : (rzecz.) charakterystyka | : (rzecz.) dyferencjał | : (rzecz.) pochodna | : (rzecz.) różniczka | : (rzecz.) zróżnicowanie
differentiate : differentiate : (czas.) odróżniać | : (czas.) rozgraniczać | : (czas.) różnić | : (czas.) różnicować | : (czas.) różniczkować | : (czas.) rozróżniać | : (czas.) wyróżniać | : (czas.) zróżniczkować
differentiation : differentiation : (rzecz.) różnicowanie | : (rzecz.) różniczkowanie | : (rzecz.) rozróżnianie
differently : differently : (przysł.) odmiennie | : (przysł.) różnie
difficult : difficult : (przym.) ciężki | : (przym.) niełatwy | : (przym.) trudny
difficulty : difficulty : (rzecz.) kłopot | : (rzecz.) problem | : (rzecz.) trudność | : (rzecz.) utrudnienie
diffidence : diffidence : (rzecz.) nieśmiałość
diffident : diffident : (przym.) bojaźliwy | : (przym.) nieufny | : (przym.) płochliwy
diffraction : diffraction : (rzecz.) dyfrakcja | : (rzecz.) uginanie
diffractive : diffractive : (przym.) dyfrakcyjny
diffuse : diffuse : (czas.) przenikać | : (czas.) rozchodzić | : (czas.) rozlewać | : (czas.) rozpraszać | : (czas.) rozprzestrzeniać | : (czas.) rozsiewać | : (czas.) szerzyć | : (przym.) niejasny
diffused : diffused : (przym.) niejasny
diffuser : diffuser : (rzecz.) dyfuzor
diffusion : diffusion : (rzecz.) dyfuzja | : (rzecz.) emanowanie | : (rzecz.) rozpowszechnienie | : (rzecz.) rozpraszanie | : (rzecz.) rozproszenie | : (rzecz.) rozprzestrzenianie | : (rzecz.) rozprzestrzenienie
diffusive : diffusive : (przym.) dyfuzyjny
dig : dig : (czas.) głębić | : (czas.) kopać | : (czas.) roztwarzać | : (czas.) wciskać | : (czas.) wkopywać | : (czas.) wygrzebywać | : (czas.) wykopać | : (czas.) zagłębić | : (czas.) zakopać | : (rzecz.) dójka | : (rzecz.) przytyk | : (rzecz.) szpilka | : (rzecz.) szturchaniec
digest : digest : (czas.) obmyślić | : (czas.) przemyśleć | : (czas.) przetrawiać | : (czas.) przetrawić | : (czas.) strawić | : (czas.) trawić | : (czas.) zrozumieć | : (rzecz.) kompendium | : (rzecz.) przegląd | : (rzecz.) streszczenie | : (rzecz.) wybór | : (rzecz.) wyciąg | : (rzecz.) zbiór
digested : digested : (czas.) wytrawić
digester : digester : (rzecz.) warnik
digestibility : digestibility : (rzecz.) strawność
digestible : digestible : (przym.) przyswajalny | : (przym.) strawny
digestion : digestion : (rzecz.) fermentacja | : (rzecz.) gnicie | : (rzecz.) roztwarzanie | : (rzecz.) trawienie
digestive : digestive : (przym.) strawny | : (przym.) trawienny
digger : digger : (rzecz.) bagier | : (rzecz.) czerparka | : (rzecz.) kopacz | : (rzecz.) kopaczka | : (rzecz.) koparka
digging : digging : (rzecz.) kopanie
diggings : diggings : (rzecz.) ukop | : (rzecz.) wykopalisko
digit : digit : (rzecz.) cyfra | : (rzecz.) palec
digital : digital : (przym.) cyfrowy | : (przym.) palczasty
digitalis : digitalis : (rzecz.) naparstnica
digitalisation : digitalisation : (rzecz.) digitalizacja
digitally : digitally : (przysł.) cyfrowo
digitise : digitise : (przym.) dyskretyzowany
digitization : digitization : (rzecz.) cyfryzacja | : (rzecz.) digitalizacja
digitize : digitize : (czas.) dyskretyzować | : (czas.) przekształcać
digitizer : digitizer : (rzecz.) dyskretyzator
digitizing : digitizing : (rzecz.) digitalizacja
dignified : dignified : (przym.) dostojny | : (przym.) dystyngowany | : (przym.) godny | : (przym.) nobliwy
dignify : dignify : (czas.) uczcić | : (czas.) uszlachetniać | : (czas.) uszlachetnić
dignitary : dignitary : (rzecz.) dostojnik | : (rzecz.) dygnitarz
dignity : dignity : (rzecz.) dostojeństwo | : (rzecz.) dygnitarstwo | : (rzecz.) dystynkcja | : (rzecz.) godność | : (rzecz.) powaga
digraph : digraph : (rzecz.) dwuznak
digress : digress : (czas.) odbiegać | : (czas.) zbaczać
digression : digression : (rzecz.) dygresja
digressive : digressive : (przym.) nawiasowy | : (przym.) uboczny
dike : dike : (rzecz.) grobla | : (rzecz.) przekop | : (rzecz.) tama | : (rzecz.) wał | : (rzecz.) zapora
dilacerate : dilacerate : (czas.) rozerwać
dilapidate : dilapidate : (czas.) obdrapać | : (czas.) odrapać | : (czas.) podniszczyć | : (czas.) rozjeździć | : (czas.) rozklekotać | : (czas.) wytarmosić | : (czas.) zdezelować | : (czas.) zniszczyć | : (czas.) zszarpać
dilapidation : dilapidation : (rzecz.) trwonienie
dilatability : dilatability : (rzecz.) rozszerzalność
dilatation : dilatation : (rzecz.) dylatacja | : (rzecz.) rozszerzanie | : (rzecz.) rozszerzenie
dilate : dilate : (czas.) rozciągać | : (czas.) rozszerzać
dilation : dilation : (rzecz.) rozszerzanie | : (rzecz.) rozszerzenie
dilatometer : dilatometer : (rzecz.) dylatometr
dilator : dilator : (rzecz.) rozszerzacz
dilatory : dilatory : (przym.) powolny
dilemma : dilemma : (rzecz.) dylemat | : (rzecz.) rozterka
dilettante : dilettante : (rzecz.) dyletant | : (rzecz.) pilność | : (rzecz.) pracowitość
dilettantism : dilettantism : (rzecz.) amatorstwo | : (rzecz.) dyletanctwo | : (rzecz.) dyletantyzm
diligence : diligence : (rzecz.) dbałość | : (rzecz.) pilność | : (rzecz.) pracowitość | : (rzecz.) skrzętność | : (rzecz.) staranność
diligent : diligent : (przym.) pilny | : (przym.) pracowity | : (przym.) staranny | : (przym.) sumienny
diligently : diligently : (przysł.) pilnie
dill : dill : (rzecz.) koper | : (rzecz.) koperek | : (rzecz.) kopra
dilly-dally : dilly-dally : (czas.) ociągać | : (czas.) zawahać
dillydally : dillydally : (czas.) ociągać | : (czas.) zawahać
dilute : dilute : (czas.) osłabiać | : (czas.) rozcieńczać | : (czas.) rozcieńczyć | : (czas.) rozpuszczać | : (czas.) rozrzedzać | : (czas.) rozrzedzić | : (czas.) rozwodnić
diluted : diluted : (czas.) rozcieńczać
diluter : diluter : (rzecz.) rozcieńczalnik
dilution : dilution : (rzecz.) rozcieńczanie | : (rzecz.) rozcieńczenie | : (rzecz.) rozrzedzanie | : (rzecz.) roztwór | : (rzecz.) rozwodnienie
diluvium : diluvium : (rzecz.) dyluwium
dim : dim : (czas.) ciemnieć | : (czas.) mącić | : (czas.) przyćmiewać | : (czas.) przygaszać | : (czas.) przytłumiać | : (czas.) ściemniać | : (czas.) słabnąć | : (czas.) zaćmić | : (czas.) zamglić | : (czas.) zamroczyć | : (czas.) zgasić | : (przym.) ciemny | : (przym.) matowy | : (przym.) mdławy | : (przym.) mdły | : (przym.) mętny | : (przym.) mglisty | : (przym.) mroczny | : (przym.) niejasny | : (przym.) niewyraźny | : (przym.) nikły | : (przym.) ponury | : (przym.) przyćmiony | : (przym.) przytłumiony | : (przym.) zamglony
dime : dime : (rzecz.) moneta
dimension : dimension : (rzecz.) aspekt | : (rzecz.) gabaryt | : (rzecz.) rozmiar | : (rzecz.) wielkość | : (rzecz.) wymiar
dimensional : dimensional : (przym.) wymiarowy
dimensionality : dimensionality : (rzecz.) rząd | : (rzecz.) stopień | : (rzecz.) wymiar | : (rzecz.) wymiarowość
dimensionally : dimensionally : (przysł.) wymiarowo
dimensioning : dimensioning : (rzecz.) wymiarowanie
dimensionless : dimensionless : (przym.) bezwymiarowy
dimensions : dimensions : (rzecz.) wymiary
dimidiate : dimidiate : (czas.) przepoławiać
diminish : diminish : (czas.) maleć | : (czas.) ubywać | : (czas.) zmaleć | : (czas.) zmniejszać
diminution : diminution : (rzecz.) redukcja | : (rzecz.) uszczuplenie | : (rzecz.) zdrobnienie | : (rzecz.) zmniejszenie
diminutive : diminutive : (przym.) dorodny | : (przym.) miniaturowy | : (przym.) zdrobniały | : (rzecz.) zdrobnienie
dimmer : dimmer : (rzecz.) ciemność | : (rzecz.) przełącznik | : (rzecz.) ściemniacz
dimmers : dimmers : (rzecz.) ściemniacz
dimmest : dimmest : (przym.) ciemny
dimness : dimness : (rzecz.) mglistość | : (rzecz.) półmrok
dimorphic : dimorphic : (przym.) dwupostaciowy
dimorphism : dimorphism : (rzecz.) dwupostaciowość | : (rzecz.) dymorfizm
dimple : dimple : (rzecz.) dołek | : (rzecz.) wgłębienie
dimwit : dimwit : (rzecz.) gamoń | : (rzecz.) głupek
din : din : (czas.) hałasować | : (rzecz.) gwar | : (rzecz.) hałas | : (rzecz.) harmider | : (rzecz.) kołatanie | : (rzecz.) łoskot | : (rzecz.) szum | : (rzecz.) wrzask | : (rzecz.) wrzawa | : (rzecz.) zgiełk
dine : dine : (czas.) obiadować
diner : diner : (rzecz.) gość | : (rzecz.) knajpka | : (rzecz.) restauracja
ding : ding : (rzecz.) przedmiot | : (rzecz.) rzecz | : (rzecz.) sprawa
ding-dong : ding-dong : (rzecz.) dzwon | : (rzecz.) dzwonienie
dingbat : dingbat : (rzecz.) ornament | : (rzecz.) ozdoba
dingdong : dingdong : (rzecz.) dzwon | : (rzecz.) dzwonienie
dinghy : dinghy : (rzecz.) bączek | : (rzecz.) łódka | : (rzecz.) ponton
dinginess : dinginess : (rzecz.) obskurność
dingy : dingy : (przym.) obskurny
dining-room : dining-room : (rzecz.) jadalnia
dinky : dinky : (przym.) przemiły | : (przym.) śliczny
dinner : dinner : (rzecz.) kolacja | : (rzecz.) obiad | : (rzecz.) przyjęcie
dinner-jacket : dinner-jacket : (rzecz.) smoking
dinner-party : dinner-party : (rzecz.) przyjęcie
dinosaur : dinosaur : (rzecz.) dinozaur
dinosaurs : dinosaurs : (rzecz.) dinozaury
dint : dint : (rzecz.) szczerba | : (rzecz.) wgięcie
dinting : dinting : (rzecz.) przybierka
diocesan : diocesan : (przym.) diecezjalny
diocese : diocese : (rzecz.) diecezja
diode : diode : (rzecz.) dioda
diode-pentode : diode-pentode : (rzecz.) dioda-pentoda
diorite : diorite : (rzecz.) dioryt
dioxide : dioxide : (rzecz.) dwutlenek
dip : dip : (czas.) maczać | : (czas.) obniżać | : (czas.) obniżyć | : (czas.) opadać | : (czas.) skąpać | : (czas.) spuszczać | : (czas.) umoczyć | : (czas.) zamoczyć | : (czas.) zanurzać | : (czas.) zanurzyć | : (rzecz.) kąpiel | : (rzecz.) nurek | : (rzecz.) pochylenie | : (rzecz.) sos | : (rzecz.) spadek | : (rzecz.) wgłębienie | : (rzecz.) zanurzenie
diphase : diphase : (przym.) dwufazowy
diphtheria : diphtheria : (rzecz.) błonica | : (rzecz.) dyfteria | : (rzecz.) dyfteryt
diphthong : diphthong : (rzecz.) dwugłoska | : (rzecz.) dyftong
diphthongize : diphthongize : (czas.) dyftongizować
diplexer : diplexer : (rzecz.) diplekser
diploma : diploma : (rzecz.) dyplom
diplomacy : diplomacy : (rzecz.) dyplomacja | : (rzecz.) polityczność
diplomat : diplomat : (rzecz.) dyplomata
diplomatic : diplomatic : (przym.) dyplomatyczny
diplomatically : diplomatically : (przysł.) dyplomatycznie
diplomatist : diplomatist : (rzecz.) dyplomata
dipolar : dipolar : (przym.) dipolowy | : (przym.) dwubiegunowy
dipole : dipole : (rzecz.) dipol | : (rzecz.) dublet | : (rzecz.) dwubiegun
dipper : dipper : (rzecz.) anabaptysta | : (rzecz.) czerpak | : (rzecz.) nurek
dipping : dipping : (rzecz.) maczanie | : (rzecz.) moczenie | : (rzecz.) ukłon | : (rzecz.) zanurzanie | : (rzecz.) zanurzenie
dipsomaniac : dipsomaniac : (rzecz.) opój
dipstick : dipstick : (rzecz.) bagnet
diptych : diptych : (rzecz.) dyptych | : (rzecz.) dyptyk
dir : dir : (rzecz.) kier
dire : dire : (przym.) okropny | : (przym.) skrajny | : (przym.) straszny
direct : direct : (czas.) kierować | : (czas.) nakazywać | : (czas.) prowadzić | : (czas.) przykazywać | : (czas.) reżyserować | : (czas.) wskazać | : (czas.) zarządzać | : (przym.) bezpośredni | : (przym.) prosty | : (przym.) szczery
direction : direction : (rzecz.) adres | : (rzecz.) dyrekcja | : (rzecz.) kierownictwo | : (rzecz.) kierunek | : (rzecz.) reżyseria | : (rzecz.) wskazówka | : (rzecz.) zarząd | : (rzecz.) zarządzenie
directional : directional : (przym.) kierunkowy
directionally : directionally : (przysł.) kierunkowo
directive : directive : (przym.) kierujący | : (przym.) nakierowujący | : (przym.) wskazujący | : (przym.) wytyczny | : (rzecz.) dyrektywa | : (rzecz.) rozkaz | : (rzecz.) wytyczna | : (rzecz.) zarządzenie
directivity : directivity : (rzecz.) kierunkowość
directly : directly : (przysł.) bezpośrednio | : (przysł.) natychmiast | : (przysł.) niebawem | : (przysł.) wprost
directness : directness : (rzecz.) bezpośredniość
director : director : (rzecz.) dyrektor | : (rzecz.) reżyser | : (rzecz.) zarządca
director's : director's : (przym.) dyrekcyjny
directorate : directorate : (rzecz.) dyrektoriat | : (rzecz.) zarząd
directorship : directorship : (rzecz.) kierownictwo
directory : directory : (rzecz.) drogowskaz | : (rzecz.) dyrektorstwo | : (rzecz.) katalog | : (rzecz.) spis
direful : direful : (przym.) okropny | : (przym.) straszny
dirge : dirge : (rzecz.) tren
dirigible : dirigible : (przym.) sterowny | : (rzecz.) sterowiec
dirk : dirk : (rzecz.) sztylet
dirt : dirt : (rzecz.) błoto | : (rzecz.) brud | : (rzecz.) kurz | : (rzecz.) zanieczyszczenie | : (rzecz.) ziemia
dirtily : dirtily : (przysł.) brudno | : (przysł.) nieczysto
dirty : dirty : (czas.) brudzić | : (czas.) morusać | : (czas.) napaskudzić | : (czas.) osmolić | : (czas.) paprać | : (czas.) smolić | : (czas.) ubabrać | : (czas.) ubrudzić | : (czas.) usmarować | : (czas.) uświnić | : (czas.) uwalać | : (czas.) wybrudzić | : (czas.) zapaskudzić | : (czas.) zaświnić | : (czas.) zawalać | : (czas.) zbrudzić | : (przym.) brudny | : (przym.) brzydki | : (przym.) niechlujny | : (przym.) nieczysty | : (przym.) nieprzyzwoity | : (przym.) nieświeży
disability : disability : (rzecz.) inwalidztwo | : (rzecz.) kalectwo | : (rzecz.) niepełność | : (rzecz.) niepełnosprawność | : (rzecz.) ubezwłasnowolnienie | : (rzecz.) ułomność | : (rzecz.) upośledzenie
disable : disable : (czas.) blokować | : (czas.) obezwładniać | : (czas.) odejmować | : (czas.) odłączać | : (czas.) ograniczać | : (czas.) okaleczać | : (czas.) pozbawiać | : (czas.) pozbawić | : (czas.) unieruchomić | : (czas.) unieszkodliwiać | : (czas.) unieszkodliwić | : (czas.) wyłączyć
disabled : disabled : (przym.) kaleki | : (przym.) niepełnosprawny | : (przym.) niestandardowy | : (przym.) nietypowy | : (przym.) ułomny | : (przym.) upośledzony
disaccord : disaccord : (rzecz.) inność | : (rzecz.) niezgoda | : (rzecz.) rozbicie
disadvantage : disadvantage : (rzecz.) minus | : (rzecz.) szkoda | : (rzecz.) wada
disadvantageous : disadvantageous : (przym.) niekorzystny
disaffect : disaffect : (czas.) odpychać | : (czas.) zrażać
disaffection : disaffection : (rzecz.) niechęć | : (rzecz.) nielojalność | : (rzecz.) niezadowolenie
disagree : disagree : (czas.) dementować | : (czas.) szkodzić
disagreeable : disagreeable : (przym.) niemiły | : (przym.) nieprzyjemny | : (przym.) przykry
disagreeably : disagreeably : (przysł.) nieprzyjemnie
disagreement : disagreement : (rzecz.) kłótnia | : (rzecz.) konflikt | : (rzecz.) nieporozumienie | : (rzecz.) niezgoda | : (rzecz.) niezgodność | : (rzecz.) rozbieżność | : (rzecz.) sprzeczka
disallow : disallow : (czas.) oddalać | : (czas.) odrzucać | : (czas.) zakazywać
disambiguate : disambiguate : (czas.) ujednoznaczniać | : (rzecz.) ujednoznacznienie
disambiguated : disambiguated : (czas.) ujednoznaczniać
disambiguates : disambiguates : (czas.) ujednoznaczniać
disambiguating : disambiguating : (czas.) ujednoznaczniać
disambiguation : disambiguation : (rzecz.) ujednoznacznienie
disannul : disannul : (czas.) skreślać | : (czas.) unieważniać
disappear : disappear : (czas.) ginąć | : (czas.) niknąć | : (czas.) pierzchać | : (czas.) zanikać | : (czas.) znikać | : (czas.) zniknąć
disappearance : disappearance : (rzecz.) zaginięcie | : (rzecz.) zanik | : (rzecz.) zanikanie | : (rzecz.) zaniknięcie | : (rzecz.) znikanie | : (rzecz.) znikniecie | : (rzecz.) zniknięcie
disappoint : disappoint : (czas.) rozczarować | : (czas.) rozczarowywać | : (czas.) zawieść | : (czas.) zawodzić
disappointed : disappointed : (przym.) rozczarowany
disappointing : disappointing : (czas.) rozczarowywać
disappointment : disappointment : (rzecz.) rozczarowanie | : (rzecz.) zawód
disapprobation : disapprobation : (rzecz.) dezaprobata
disapproval : disapproval : (rzecz.) dezaprobata | : (rzecz.) nieprzychylność
disapprove : disapprove : (czas.) dezaprobować
disarm : disarm : (czas.) rozbrajać | : (czas.) rozbroić
disarmament : disarmament : (rzecz.) rozbrojenie
disarmingly : disarmingly : (przysł.) rozbrajająco
disarrange : disarrange : (czas.) bałaganić | : (czas.) dezorganizować | : (czas.) rozprzęgać | : (czas.) zdezorganizować
disarray : disarray : (czas.) rozpadać | : (rzecz.) nieład | : (rzecz.) nieporządek | : (rzecz.) rozprzężenie | : (rzecz.) zamęt
disassemble : disassemble : (czas.) demontować | : (czas.) dezasemblować | : (czas.) rozbierać | : (czas.) rozmontować | : (czas.) rozmontowywać
disassembling : disassembling : (rzecz.) dezasemblowanie | : (rzecz.) rozmontowywanie | : (rzecz.) zdemontowanie
disassembly : disassembly : (rzecz.) demontaż
disaster : disaster : (rzecz.) kataklizm | : (rzecz.) katastrofa | : (rzecz.) klęska | : (rzecz.) nieszczęście | : (rzecz.) tragedia
disastrous : disastrous : (przym.) fatalny | : (przym.) katastrofalny | : (przym.) nieszczęsny | : (przym.) okropny | : (przym.) zgubny
disastrously : disastrously : (przysł.) fatalnie | : (przysł.) katastrofalnie
disavow : disavow : (czas.) dezawuować | : (czas.) wypierać | : (czas.) wyrzekać | : (czas.) zdezawuować
disavowal : disavowal : (rzecz.) wyparcie | : (rzecz.) wyrzeczenie
disband : disband : (czas.) rozchodzić | : (czas.) rozdzielać | : (czas.) rozdzielić | : (czas.) rozpuścić | : (czas.) rozpuszczać | : (czas.) rozróżniać | : (czas.) rozwiązać | : (czas.) rozwiązywać | : (czas.) spostrzegać | : (czas.) współdzielić
disbelief : disbelief : (rzecz.) niedowierzanie | : (rzecz.) nieufność | : (rzecz.) niewiara
disburse : disburse : (czas.) wypłacać | : (czas.) wypłacić
disbursement : disbursement : (rzecz.) płatność | : (rzecz.) wydatek
disc : disc : (rzecz.) dysk | : (rzecz.) dyskietka | : (rzecz.) krążek | : (rzecz.) płyta | : (rzecz.) tarcza
discard : discard : (czas.) odrzucać | : (czas.) odrzucić | : (czas.) odwołać | : (czas.) pozbywać | : (czas.) wyrzucać | : (czas.) zaniechać | : (czas.) zarzucać | : (czas.) zrzucić | : (rzecz.) zrzutka
discards : discards : (rzecz.) braki | : (rzecz.) odpady
discern : discern : (czas.) dostrzegać | : (czas.) rozeznać | : (czas.) rozeznawać | : (czas.) rozróżniać | : (czas.) rozróżnić | : (czas.) spostrzegać
discernible : discernible : (przym.) rozróżnialny | : (przym.) spostrzegalny | : (przym.) zauważalny
discernibly : discernibly : (przysł.) dostrzegalnie
discerning : discerning : (przym.) bystry | : (przym.) wnikliwy
discernment : discernment : (rzecz.) orientacja | : (rzecz.) rozeznanie | : (rzecz.) rozróżnienie
discharge : discharge : (czas.) spełniać | : (czas.) spłacać | : (czas.) spuszczać | : (czas.) wydalać | : (czas.) wydzielać | : (czas.) wyładować | : (czas.) wyładowywać | : (czas.) wypełniać | : (czas.) wypisywać | : (czas.) wyrzucać | : (czas.) zwalniać | : (rzecz.) absolutorium | : (rzecz.) emisja | : (rzecz.) skwitowanie | : (rzecz.) spuszczanie | : (rzecz.) wydalenie | : (rzecz.) wydzielina | : (rzecz.) wyładowanie | : (rzecz.) zrzut | : (rzecz.) zwolnienie
discharger : discharger : (rzecz.) garłacz | : (rzecz.) odgromnik
discharges : discharges : (rzecz.) odchody | : (rzecz.) rozładowanie | : (rzecz.) zrzucanie | : (rzecz.) zrzucenie
disciple : disciple : (rzecz.) uczeń | : (rzecz.) wyznawca
disciplinarian : disciplinarian : (rzecz.) służbista
disciplinary : disciplinary : (przym.) dyscyplinarny
discipline : discipline : (czas.) dyscyplinować | : (czas.) karać | : (czas.) kontrolować | : (czas.) zdyscyplinować | : (rzecz.) dyscyplina | : (rzecz.) dziedzina | : (rzecz.) karność | : (rzecz.) rygor | : (rzecz.) subordynacja | : (rzecz.) zdyscyplinowanie
disclaim : disclaim : (czas.) wypierać | : (czas.) zrzekać
disclaimer : disclaimer : (rzecz.) zaprzeczenie | : (rzecz.) zastrzeżenie | : (rzecz.) zrzeczenie
disclose : disclose : (czas.) demaskować | : (czas.) odsłaniać | : (czas.) odsłonić | : (czas.) ujawniać | : (czas.) ujawnić | : (czas.) wyjawiać
disclosure : disclosure : (rzecz.) odkrycie | : (rzecz.) odsłonięcie | : (rzecz.) ujawnianie | : (rzecz.) ujawnienie | : (rzecz.) wyjawienie | : (rzecz.) zdemaskowanie
disco : disco : (rzecz.) dyskoteka
discography : discography : (rzecz.) dyskografia | : (rzecz.) fonografia
discoloration : discoloration : (rzecz.) odbarwienie
discolour : discolour : (czas.) odbarwiać | : (czas.) odbarwić | : (czas.) wypłowieć
discolouration : discolouration : (rzecz.) blaknięcie | : (rzecz.) odbarwienie
discomfit : discomfit : (czas.) skonsternować | : (czas.) udaremniać | : (czas.) udaremnić | : (czas.) zmieszać | : (czas.) zniechęcać | : (czas.) zniechęcić
discomfort : discomfort : (rzecz.) dolegliwość | : (rzecz.) dyskomfort | : (rzecz.) niedogodność | : (rzecz.) niepokój | : (rzecz.) niewygoda | : (rzecz.) skrępowanie
discompose : discompose : (czas.) dezorganizować | : (czas.) żenować | : (czas.) zmieszać
disconcert : disconcert : (czas.) peszyć | : (czas.) stropić | : (czas.) żenować
disconnect : disconnect : (czas.) odłączać | : (czas.) odłączyć | : (czas.) rozczepiać | : (czas.) rozłączać | : (czas.) rozłączyć | : (czas.) uchylać | : (czas.) wyłączać
disconnected : disconnected : (przym.) niespójny
disconnection : disconnection : (rzecz.) odczepienie | : (rzecz.) rozłączenie
disconsolate : disconsolate : (przym.) ponury | : (przym.) posępny
discontent : discontent : (rzecz.) malkontenctwo | : (rzecz.) niezadowolenie
discontinuance : discontinuance : (rzecz.) przerwa | : (rzecz.) przerwanie | : (rzecz.) umorzenie | : (rzecz.) zaprzestanie
discontinuation : discontinuation : (rzecz.) odstawienie | : (rzecz.) przerwanie
discontinue : discontinue : (czas.) przerwać | : (czas.) przerywać | : (czas.) ustawać | : (czas.) zaprzestać
discontinued : discontinued : (czas.) odstawić
discontinuity : discontinuity : (rzecz.) nieciągłość | : (rzecz.) przerwa
discontinuous : discontinuous : (przym.) nieciągły
discord : discord : (rzecz.) dysonans | : (rzecz.) niezgoda | : (rzecz.) waśń
discordance : discordance : (rzecz.) dysonans | : (rzecz.) niezgodność
discordant : discordant : (przym.) dysonansowy | : (przym.) nieharmonijny | : (przym.) niezgodny
discordantly : discordantly : (przysł.) fałszywie | : (przysł.) niezgodnie
discotheque : discotheque : (rzecz.) dyskoteka
discount : discount : (czas.) dyskontować | : (czas.) potrącać | : (rzecz.) bonifikata | : (rzecz.) dyskonto | : (rzecz.) obniżka | : (rzecz.) opust | : (rzecz.) rabat | : (rzecz.) upust | : (rzecz.) zniżka
discounted : discounted : (czas.) zdyskontować
discountenance : discountenance : (czas.) dezaprobować | : (czas.) zawstydzać | : (czas.) zawstydzić
discounts : discounts : (rzecz.) dyskont
discourage : discourage : (czas.) odbierać | : (czas.) odwodzić | : (czas.) razić | : (czas.) zniechęcać | : (czas.) zniechęcić | : (czas.) zrażać | : (czas.) zrazić
discouragement : discouragement : (rzecz.) zniechęcenie
discourse : discourse : (czas.) rozmawiać | : (czas.) rozprawiać | : (rzecz.) dyskurs | : (rzecz.) dyskusja | : (rzecz.) mowa | : (rzecz.) rozmowa | : (rzecz.) rozprawa
discourteous : discourteous : (przym.) niegrzeczny | : (przym.) nieuprzejmy
discourtesy : discourtesy : (rzecz.) niegrzeczność | : (rzecz.) nieuprzejmość
discover : discover : (czas.) odkryć | : (czas.) odkrywać
discoverable : discoverable : (przym.) wykrywalny
discoverer : discoverer : (rzecz.) odkrywca | : (rzecz.) odkrywczyni
discoverers : discoverers : (rzecz.) odkrywcy
discoveries : discoveries : (rzecz.) odkrycia
discovery : discovery : (rzecz.) odkrycie | : (rzecz.) odkrywanie | : (rzecz.) odnajdowanie | : (rzecz.) odnalezienie | : (rzecz.) ujawnienie | : (rzecz.) wykrywanie | : (rzecz.) wynalazek | : (rzecz.) wynalezienie
discredit : discredit : (czas.) dyskredytować | : (czas.) falsyfikować | : (czas.) kompromitować | : (czas.) podważać | : (czas.) zdyskredytować | : (rzecz.) niesława | : (rzecz.) nieufność | : (rzecz.) powątpiewanie
discreditable : discreditable : (przym.) niegodny | : (przym.) podły
discreet : discreet : (przym.) dyskretny | : (przym.) rozsądny | : (przym.) roztropny | : (przym.) rozważny | : (przym.) taktowny
discreetly : discreetly : (przysł.) dyskretnie | : (przysł.) roztropnie
discrepancy : discrepancy : (rzecz.) niezgodność | : (rzecz.) rozbieżność | : (rzecz.) sprzeczność
discrepant : discrepant : (przym.) sprzeczny
discrete : discrete : (przym.) dyskretny | : (przym.) nieciągły
discretely : discretely : (przym.) nieciągły
discretion : discretion : (rzecz.) dyskrecja | : (rzecz.) oględność | : (rzecz.) osąd | : (rzecz.) rozsądek | : (rzecz.) roztropność | : (rzecz.) rozwaga | : (rzecz.) takt | : (rzecz.) uznanie | : (rzecz.) uznaniowość
discretional : discretional : (przym.) dobrowolny | : (przym.) dowolny | : (przym.) dyskrecjonalny | : (przym.) nieobowiązkowy
discretionary : discretionary : (przym.) dobrowolny | : (przym.) dowolny | : (przym.) dyskrecjonalny | : (przym.) nieobowiązkowy
discriminate : discriminate : (czas.) dyskryminować | : (czas.) faworyzować | : (czas.) rozróżniać | : (czas.) rozróżnić
discrimination : discrimination : (rzecz.) dyskryminacja | : (rzecz.) dyskryminowanie | : (rzecz.) odróżnianie | : (rzecz.) przenikliwość | : (rzecz.) rozeznanie | : (rzecz.) rozróżnianie | : (rzecz.) smak | : (rzecz.) wybór
discriminator : discriminator : (rzecz.) dyskryminator
discriminatory : discriminatory : (przym.) dyskryminacyjny
discursive : discursive : (przym.) dygresyjny | : (przym.) dyskursywny | : (przym.) urywkowy
discus : discus : (rzecz.) dysk
discuss : discuss : (czas.) dyskutować | : (czas.) omawiać | : (czas.) omówić | : (czas.) podyskutować | : (czas.) przedyskutować | : (czas.) rozprawiać | : (czas.) roztrząsać
discussion : discussion : (rzecz.) debata | : (rzecz.) debatowanie | : (rzecz.) dyskusja | : (rzecz.) omówienie
disdain : disdain : (czas.) gardzić | : (czas.) pogardzać | : (rzecz.) lekceważenie | : (rzecz.) pogarda | : (rzecz.) politowanie | : (rzecz.) wzgarda
disdainful : disdainful : (przym.) lekceważący | : (przym.) pogardliwy | : (przym.) wzgardliwy
disease : disease : (rzecz.) choroba | : (rzecz.) nieszczęście | : (rzecz.) przypadłość | : (rzecz.) schorzenie
diseased : diseased : (przym.) chory
disembark : disembark : (czas.) lądować | : (czas.) wylądować | : (czas.) wyładować | : (czas.) wyładowywać | : (czas.) wyokrętować | : (czas.) wysadzać | : (czas.) wysadzić | : (czas.) wysiadać
disembarkation : disembarkation : (rzecz.) opuszczanie | : (rzecz.) wyładowanie | : (rzecz.) wyładunek | : (rzecz.) wysiadanie
disembody : disembody : (czas.) rozbrajać
disembowel : disembowel : (czas.) wypatroszyć
disenable : disenable : (czas.) uniemożliwiać
disenchant : disenchant : (czas.) odczarować | : (czas.) rozczarować | : (czas.) rozczarowywać
disenchantment : disenchantment : (rzecz.) odczarowanie | : (rzecz.) rozczarowanie
disencumber : disencumber : (czas.) uwalniać | : (czas.) uwolnić
disengage : disengage : (czas.) oddzielać | : (czas.) odłączać | : (czas.) odłączyć | : (czas.) rozłączać | : (czas.) uwalniać | : (czas.) uwolnić | : (czas.) wyprzęgać | : (czas.) zwalniać
disengagement : disengagement : (rzecz.) odłączenie | : (rzecz.) rozłączanie | : (rzecz.) uwolnienie
disentangle : disentangle : (czas.) odmotać | : (czas.) odplątywać | : (czas.) rozgmatwać | : (czas.) rozplątać | : (czas.) rozplątywać | : (czas.) rozsupłać | : (czas.) rozwikłać | : (czas.) wymotać | : (czas.) wyplątać | : (czas.) wyswobodzić
disentanglement : disentanglement : (rzecz.) rozwikłanie
disentomb : disentomb : (czas.) ekshumować | : (czas.) wykopać
disequilibrium : disequilibrium : (rzecz.) nierównowaga
disestablish : disestablish : (czas.) oddzielać | : (czas.) oddzielić
disfavour : disfavour : (rzecz.) nieprzychylność
disfeature : disfeature : (czas.) zniekształcać
disfiguration : disfiguration : (rzecz.) szpecenie
disfigure : disfigure : (czas.) oszpecać | : (czas.) zniekształcać
disfigurement : disfigurement : (rzecz.) oszpecenie | : (rzecz.) zeszpecenie
disfranchise : disfranchise : (czas.) odbierać
disgorge : disgorge : (czas.) wymiotować | : (czas.) wypluć | : (czas.) zwracać | : (czas.) zwymiotować
disgrace : disgrace : (czas.) hańbić | : (czas.) kompromitować | : (czas.) spodlić | : (czas.) zhańbić | : (rzecz.) bezczeszczenie | : (rzecz.) blamaż | : (rzecz.) dyshonor | : (rzecz.) hańba | : (rzecz.) hańbienie | : (rzecz.) niełaska | : (rzecz.) sromota | : (rzecz.) wstyd | : (rzecz.) zakała
disgraceful : disgraceful : (przym.) haniebny | : (przym.) niechlubny | : (przym.) sromotny
disgracefully : disgracefully : (przysł.) haniebnie
disguise : disguise : (czas.) maskować | : (czas.) przebierać | : (czas.) przebrać | : (czas.) skrywać | : (czas.) ucharakteryzować | : (czas.) zakamuflować | : (czas.) zamaskować | : (czas.) zmieniać | : (rzecz.) kostium | : (rzecz.) maska | : (rzecz.) przebranie
disgust : disgust : (czas.) brzydzić | : (czas.) mierzyć | : (czas.) rozgoryczać | : (rzecz.) brzydzenie | : (rzecz.) obmierzłość | : (rzecz.) obrzydliwość | : (rzecz.) obrzydnięcie | : (rzecz.) obrzydzenie | : (rzecz.) odraza | : (rzecz.) wstręt
disgusting : disgusting : (przym.) obrzydliwy | : (przym.) przebrzydły | : (przym.) wstrętny
disgustingly : disgustingly : (przysł.) obrzydliwie | : (przysł.) wstrętnie
dish : dish : (czas.) wgniatać | : (rzecz.) danie | : (rzecz.) kuweta | : (rzecz.) misa | : (rzecz.) naczynie | : (rzecz.) półmisek | : (rzecz.) potrawa | : (rzecz.) talerz | : (rzecz.) wanienka
dish-water : dish-water : (rzecz.) pomyje
dish-waters : dish-waters : (rzecz.) pomyje
disharmonious : disharmonious : (przym.) dysharmonijny
disharmony : disharmony : (rzecz.) dysharmonia | : (rzecz.) rozstrój
dishcloth : dishcloth : (rzecz.) ścierka | : (rzecz.) zmywak
dishearten : dishearten : (czas.) przygnębiać | : (czas.) zniechęcać
dishevel : dishevel : (czas.) rozczochrać | : (czas.) rozdmuchać | : (czas.) roztargać | : (czas.) skudłacić | : (czas.) wichrzyć | : (czas.) wzburzyć | : (czas.) zwichrzyć
dishevelled : dishevelled : (przym.) wichrowaty
dishevelment : dishevelment : (rzecz.) rozczochranie
dishful : dishful : (rzecz.) półmisek
dishonest : dishonest : (przym.) nieczysty | : (przym.) niehonorowy | : (przym.) nierzetelny | : (przym.) nieuczciwy
dishonestly : dishonestly : (przysł.) nieuczciwie
dishonesty : dishonesty : (rzecz.) nierzetelność | : (rzecz.) nieuczciwość | : (rzecz.) oszustwo
dishonour : dishonour : (czas.) hańbić | : (czas.) zniesławić | : (rzecz.) dyshonor | : (rzecz.) hańba
dishonourable : dishonourable : (przym.) haniebny | : (przym.) niecny | : (przym.) nikczemny
dishpan : dishpan : (rzecz.) szaflik
dishrag : dishrag : (rzecz.) ścierka | : (rzecz.) zmywak
dishtowel : dishtowel : (rzecz.) zmywak
dishwasher : dishwasher : (rzecz.) pomywacz | : (rzecz.) zmywarka
dishwashing : dishwashing : (rzecz.) mycie | : (rzecz.) zmywanie
dishwater : dishwater : (rzecz.) lura | : (rzecz.) pomyje
disillusion : disillusion : (czas.) rozczarować | : (czas.) rozczarowywać | : (czas.) zawodzić | : (rzecz.) otrzeźwienie | : (rzecz.) rozczarowanie
disillusionment : disillusionment : (rzecz.) rozczarowanie
disimpassioned : disimpassioned : (przym.) beznamiętny | : (przym.) spokojny
disinclination : disinclination : (rzecz.) niechęć
disinclined : disinclined : (przym.) niechętny | : (przym.) nieskłonny
disinfect : disinfect : (czas.) dezynfekować | : (czas.) odkażać | : (czas.) odkazić | : (czas.) wydezynfekować | : (czas.) zdezynfekować
disinfectant : disinfectant : (przym.) dezynfekujący | : (rzecz.) dezynfekcja | : (rzecz.) odkażanie
disinfected : disinfected : (czas.) odkazić | : (czas.) zdezynfekować
disinfection : disinfection : (rzecz.) dezynfekcja | : (rzecz.) odkażenie
disinformation : disinformation : (rzecz.) dezinformacja
disingenuous : disingenuous : (przym.) nieszczery
disinherit : disinherit : (czas.) wydziedziczać | : (czas.) wydziedziczyć
disinheritance : disinheritance : (rzecz.) wydziedziczenie
disintegrate : disintegrate : (czas.) rozdrabniać | : (czas.) rozdrobnić | : (czas.) rozkładać | : (czas.) rozkruszać | : (czas.) rozpadać
disintegration : disintegration : (rzecz.) dezintegracja | : (rzecz.) rozdrabnianie | : (rzecz.) rozdrobnienie | : (rzecz.) rozkład | : (rzecz.) rozpad
disintegrator : disintegrator : (rzecz.) dezintegrator | : (rzecz.) dezyntegrator
disinter : disinter : (czas.) ekshumować | : (czas.) odgrzebać
disinterest : disinterest : (rzecz.) bezinteresowność | : (rzecz.) bezstronność
disinterested : disinterested : (przym.) bezinteresowny | : (przym.) bezstronny | : (przym.) obiektywny
disinterestedly : disinterestedly : (przysł.) bezinteresownie
disinterestedness : disinterestedness : (rzecz.) bezinteresowność | : (rzecz.) bezstronność
disinterment : disinterment : (rzecz.) ekshumacja
disjoin : disjoin : (czas.) rozdzielać | : (czas.) rozłączać
disjoint : disjoint : (czas.) rozebrać | : (czas.) wywichnąć | : (czas.) zwichnąć
disjointed : disjointed : (przym.) bezładny | : (przym.) chaotyczny
disjunction : disjunction : (rzecz.) alternatywa | : (rzecz.) dysjunkcja
disjunctive : disjunctive : (przym.) dysjunkcyjny | : (przym.) dysjunktywny | : (przym.) rozłączny
disk : disk : (rzecz.) dysk | : (rzecz.) dyskietka | : (rzecz.) krążek | : (rzecz.) płyta | : (rzecz.) tarcza
diskette : diskette : (rzecz.) dyskietka
dislike : dislike : (rzecz.) antypatia | : (rzecz.) idiosynkrazja | : (rzecz.) niechęć | : (rzecz.) odraza
dislocate : dislocate : (czas.) dyslokować | : (czas.) hamować | : (czas.) przemieścić | : (czas.) przemieszczać | : (czas.) przesunąć | : (czas.) wywichnąć | : (czas.) zaburzać | : (czas.) zdezorganizować | : (czas.) zwichnąć
dislocation : dislocation : (rzecz.) burzenie | : (rzecz.) dyslokacja | : (rzecz.) przemieszczenie | : (rzecz.) wybicie | : (rzecz.) zwichnięcie
dislodge : dislodge : (czas.) przemieszczać | : (czas.) usuwać | : (czas.) wypędzać | : (czas.) wypierać | : (czas.) wyrywać | : (czas.) wysiedlać
dislodgement : dislodgement : (rzecz.) usunięcie | : (rzecz.) wyparcie | : (rzecz.) wysiedlenie
disloyal : disloyal : (przym.) nielojalny | : (przym.) nieprawomyślny | : (przym.) wiarołomny
disloyalty : disloyalty : (rzecz.) nielojalność | : (rzecz.) niewierność | : (rzecz.) wiarołomność
dismal : dismal : (przym.) fatalny | : (przym.) nędzny | : (przym.) ponury | : (przym.) posępny | : (przym.) słaby | : (przym.) straszny
dismally : dismally : (przysł.) bardzo | : (przysł.) przeraźliwie | : (przysł.) strasznie
dismantle : dismantle : (czas.) demontować | : (czas.) rozbrajać | : (czas.) rozebrać | : (czas.) rozmontować | : (czas.) rozmontowywać | : (czas.) zdemontować
dismantlement : dismantlement : (rzecz.) rozłożenie
dismay : dismay : (czas.) konsternować | : (czas.) przerażać | : (czas.) przerazić | : (czas.) rozczarowywać | : (czas.) skonsternować | : (czas.) wystraszyć | : (rzecz.) konsternacja | : (rzecz.) niesmak | : (rzecz.) przerażenie | : (rzecz.) rozczarowanie
dismember : dismember : (czas.) poćwiartować | : (czas.) rozczłonkować | : (czas.) rozczłonkowywać
dismemberment : dismemberment : (rzecz.) rozczłonkowanie
dismiss : dismiss : (czas.) eliminować | : (czas.) oddalać | : (czas.) oddalić | : (czas.) odprawiać | : (czas.) odrzucać | : (czas.) odwoływać | : (czas.) pozbyć | : (czas.) wyeliminować | : (czas.) wyrzucać | : (czas.) zwalniać | : (czas.) zwolnić
dismissal : dismissal : (rzecz.) dymisja | : (rzecz.) oddalenie | : (rzecz.) odprawa | : (rzecz.) odprawienie | : (rzecz.) odwołanie | : (rzecz.) wydalenie | : (rzecz.) wymówienie | : (rzecz.) zbycie | : (rzecz.) zwolnienie
dismount : dismount : (czas.) demontować | : (czas.) schodzić | : (czas.) wymontować | : (czas.) zdemontować | : (czas.) zdjąć | : (czas.) zsiadać
dismounted : dismounted : (czas.) wymontować
disobedience : disobedience : (rzecz.) nieposłuszeństwo
disobedient : disobedient : (przym.) nieposłuszny | : (przym.) niesforny | : (przym.) oporny
disorder : disorder : (czas.) roztrzepać | : (czas.) rozwichrzyć | : (rzecz.) bałagan | : (rzecz.) bezład | : (rzecz.) choroba | : (rzecz.) dolegliwość | : (rzecz.) nieład | : (rzecz.) nieporządek | : (rzecz.) rozprzężenie | : (rzecz.) rozstrój | : (rzecz.) zaburzenie
disorderly : disorderly : (przym.) burzliwy | : (przym.) chaotyczny | : (przym.) nieporządny
disorganization : disorganization : (rzecz.) dezorganizacja
disorganize : disorganize : (czas.) dezorganizować | : (czas.) zdezorganizować
disorient : disorient : (czas.) zdezorientować
disorientate : disorientate : (czas.) dezorientować | : (czas.) zdezorientować
disorientation : disorientation : (rzecz.) dezorientacja
disown : disown : (czas.) dezawuować | : (czas.) wypierać | : (czas.) wyrzekać
disparage : disparage : (czas.) dyskredytować | : (czas.) ubliżać | : (czas.) zbluzgać | : (czas.) zdyskredytować
disparagement : disparagement : (rzecz.) dyskredytowanie | : (rzecz.) ujma
disparate : disparate : (przym.) odmienny | : (przym.) różny
disparity : disparity : (rzecz.) nierówność | : (rzecz.) różnica
dispassion : dispassion : (rzecz.) beznamiętność
dispassionate : dispassionate : (przym.) beznamiętny | : (przym.) bezstronny | : (przym.) obojętny | : (przym.) spokojny
dispatch : dispatch : (czas.) alokować | : (czas.) ekspediować | : (czas.) nadawać | : (czas.) odprawiać | : (czas.) pałaszować | : (czas.) wyekspediować | : (czas.) wysyłać | : (czas.) załatwiać | : (czas.) załatwić | : (rzecz.) depesza | : (rzecz.) ekspedycja | : (rzecz.) pośpiech | : (rzecz.) wiadomość | : (rzecz.) wysyłka | : (rzecz.) załatwienie
dispatcher : dispatcher : (rzecz.) dyspozytor | : (rzecz.) wysyłanie
dispel : dispel : (czas.) rozpędzać | : (czas.) rozpędzić | : (czas.) rozpraszać | : (czas.) rozsiać | : (czas.) rozsypać | : (czas.) rozwiać | : (czas.) rozwierać
dispensable : dispensable : (przym.) zbędny | : (przym.) zbyteczny
dispensary : dispensary : (rzecz.) ambulatorium | : (rzecz.) apteka | : (rzecz.) poradnia | : (rzecz.) przychodnia
dispensation : dispensation : (rzecz.) dyspensa | : (rzecz.) rozdawanie | : (rzecz.) zgoda
dispense : dispense : (czas.) dawkować | : (czas.) dozować | : (czas.) dyrektorować | : (czas.) dyspensować | : (czas.) obyć | : (czas.) przygotowywać | : (czas.) rozdzielać | : (czas.) udzielać | : (czas.) wydawać
dispenser : dispenser : (rzecz.) aptekarz | : (rzecz.) dozownik | : (rzecz.) dystrybutor | : (rzecz.) maszyna | : (rzecz.) zasobnik
dispersal : dispersal : (rzecz.) dyspersja | : (rzecz.) rozpraszanie | : (rzecz.) rozproszenie
dispersant : dispersant : (rzecz.) dyspergator
disperse : disperse : (czas.) dyspergować | : (czas.) rozbiegać | : (czas.) rozganiać | : (czas.) rozpędzać | : (czas.) rozpędzić | : (czas.) rozpraszać | : (czas.) rozproszyć | : (czas.) rozprzestrzeniać | : (czas.) rozrzucać | : (czas.) rozsiać | : (czas.) rozsypać | : (czas.) rozsypywać
dispersing : dispersing : (czas.) rozproszyć
dispersion : dispersion : (rzecz.) dyspersja | : (rzecz.) rozproszenie | : (rzecz.) rozrzut | : (rzecz.) rozsiew | : (rzecz.) rozszczepienie
dispirit : dispirit : (czas.) nadąsać | : (czas.) przygnębiać | : (czas.) zdeprymować
displace : displace : (czas.) przemieścić | : (czas.) przemieszczać | : (czas.) przenieść | : (czas.) przenosić | : (czas.) przesiedlać | : (czas.) przestawiać | : (czas.) przestawić | : (czas.) przesuwać | : (czas.) rugować | : (czas.) wypierać | : (czas.) wyprzeć | : (czas.) wysiedlać | : (czas.) zastąpić | : (czas.) zastępować
displacement : displacement : (rzecz.) przemieszczenie | : (rzecz.) przesiedlenie | : (rzecz.) przestawienie | : (rzecz.) przesunięcie | : (rzecz.) przesuwanie | : (rzecz.) wyparcie | : (rzecz.) wypieranie | : (rzecz.) wyporność | : (rzecz.) wysiedlenie
display : display : (czas.) eksponować | : (czas.) manifestować | : (czas.) okazywać | : (czas.) pojawić | : (czas.) przejawiać | : (czas.) roztaczać | : (czas.) ujawniać | : (czas.) ujawnić | : (czas.) wykładać | : (czas.) wystawiać | : (czas.) wyświetlać | : (czas.) wywiesić | : (rzecz.) buńczuczność | : (rzecz.) ekran | : (rzecz.) eksponat | : (rzecz.) manifestacja | : (rzecz.) monitor | : (rzecz.) objaw | : (rzecz.) obrazowanie | : (rzecz.) ostentacja | : (rzecz.) pokaz | : (rzecz.) popis | : (rzecz.) wystawa | : (rzecz.) wyświetlacz | : (rzecz.) wyświetlenie | : (rzecz.) zobrazowanie
display-oriented : display-oriented : (przym.) ekranowy
displease : displease : (czas.) degustować | : (czas.) denerwować | : (czas.) drażnić | : (czas.) irytować | : (czas.) oburzać | : (czas.) podrażniać | : (czas.) podrażnić | : (czas.) urażać | : (czas.) zdenerwować | : (czas.) zirytować
displeasure : displeasure : (rzecz.) niezadowolenie | : (rzecz.) oburzenie | : (rzecz.) przykrość
disport : disport : (czas.) zabawiać
disposable : disposable : (przym.) dyspozycyjny
disposal : disposal : (rzecz.) dysponowanie | : (rzecz.) dyspozycja | : (rzecz.) kierownictwo | : (rzecz.) likwidacja | : (rzecz.) oddanie | : (rzecz.) pozbycie | : (rzecz.) pozbywanie | : (rzecz.) rozmieszczenie | : (rzecz.) rozporządzanie | : (rzecz.) rozporządzenie | : (rzecz.) unieszkodliwienie | : (rzecz.) usunięcie | : (rzecz.) usuwanie | : (rzecz.) utylizacja | : (rzecz.) utylizowanie | : (rzecz.) zbycie
dispose : dispose : (czas.) dysponować | : (czas.) pozbyć | : (czas.) pozbywać | : (czas.) rozkładać | : (czas.) rozmieszczać | : (czas.) rozporządzać | : (czas.) roztasować | : (czas.) sprzedawać | : (czas.) ustawiać | : (czas.) wyzbyć | : (czas.) zbyć | : (czas.) zbywać
disposed : disposed : (czas.) unieszkodliwić | : (czas.) utylizować | : (przym.) gotowy | : (przym.) skłonny
disposer : disposer : (rzecz.) dysponent
disposition : disposition : (rzecz.) dyslokacja | : (rzecz.) dyspozycja | : (rzecz.) rozkład | : (rzecz.) rozłożenie | : (rzecz.) skłonność | : (rzecz.) sprzedaż | : (rzecz.) usposobienie | : (rzecz.) zarządzenie
dispossess : dispossess : (czas.) wysiedlać | : (czas.) wywłaszczać
dispraise : dispraise : (czas.) ganić | : (czas.) poniżać | : (rzecz.) ganienie | : (rzecz.) poniżanie
disproof : disproof : (rzecz.) odparcie | : (rzecz.) zbijanie
disproportion : disproportion : (rzecz.) dysproporcja
disproportionate : disproportionate : (przym.) nieproporcjonalny | : (przym.) niewspółmierny
disproportionately : disproportionately : (przysł.) nieproporcjonalnie
disprove : disprove : (czas.) bić | : (czas.) falsyfikować | : (czas.) obalać | : (czas.) zbić
disputable : disputable : (przym.) sporny | : (przym.) wątpliwy
disputant : disputant : (rzecz.) dyskutant | : (rzecz.) dysputant
dispute : dispute : (czas.) dyskutować | : (czas.) dysputować | : (czas.) kwestionować | : (czas.) podważać | : (czas.) roztrząsać | : (czas.) spierać | : (czas.) sprzeczać | : (czas.) walczyć | : (czas.) wątpić | : (czas.) zaprzeczać | : (rzecz.) dysputa | : (rzecz.) nieporozumienie | : (rzecz.) spór | : (rzecz.) zatarg
disqualification : disqualification : (rzecz.) dyskwalifikacja | : (rzecz.) dyskwalifikowanie | : (rzecz.) odebranie
disqualified : disqualified : (czas.) zdyskwalifikować
disqualify : disqualify : (czas.) dyskwalifikować | : (czas.) wykluczać | : (czas.) zakazać | : (czas.) zdyskwalifikować
disquiet : disquiet : (rzecz.) niepokój | : (rzecz.) zaniepokojenie
disquietude : disquietude : (rzecz.) niepokój | : (rzecz.) zaniepokojenie
disregard : disregard : (czas.) abstrahować | : (czas.) ignorować | : (czas.) lekceważyć | : (czas.) pomijać | : (czas.) poniewierać | : (rzecz.) lekceważenie | : (rzecz.) poniewierka
disrelish : disrelish : (rzecz.) niechęć | : (rzecz.) odraza
disrepair : disrepair : (rzecz.) zniszczenie
disreputable : disreputable : (przym.) haniebny
disrepute : disrepute : (rzecz.) kompromitacja
disrespect : disrespect : (rzecz.) lekceważenie | : (rzecz.) nieuszanowanie
disrespectful : disrespectful : (przym.) niedelikatny | : (przym.) obraźliwy
disrespectfully : disrespectfully : (przysł.) lekceważąco
disrobe : disrobe : (czas.) rozbierać
disrupt : disrupt : (czas.) kruszyć | : (czas.) niszczyć | : (czas.) pokrzyżować | : (czas.) przerywać | : (czas.) przeszkadzać | : (czas.) rozerwać | : (czas.) rozrywać | : (czas.) rozweselać | : (czas.) zaburzać | : (czas.) zaburzyć | : (czas.) zakłócać | : (czas.) zakłócić
disruption : disruption : (rzecz.) rozdział | : (rzecz.) rozerwanie | : (rzecz.) zakłócenie
disruptive : disruptive : (przym.) destrukcyjny | : (przym.) kruszący | : (przym.) rozrywający | : (przym.) zakłóceniowy
dissatisfaction : dissatisfaction : (rzecz.) niezadowolenie
dissatisfied : dissatisfied : (przym.) halucynacyjny
dissatisfy : dissatisfy : (czas.) rozgniewać
dissect : dissect : (czas.) analizować | : (czas.) rozciąć | : (czas.) rozcinać
dissection : dissection : (rzecz.) preparat | : (rzecz.) rozebranie | : (rzecz.) sekcja
dissemble : dissemble : (czas.) przemilczać | : (czas.) udawać | : (czas.) ukrywać
dissembler : dissembler : (rzecz.) fałszywiec | : (rzecz.) obłudnik
disseminate : disseminate : (czas.) posiać | : (czas.) rozpowszechniać | : (czas.) rozprowadzać | : (czas.) rozsiewać | : (czas.) siać | : (czas.) szerzyć
dissemination : dissemination : (rzecz.) rozpowszechnienie | : (rzecz.) rozsiew | : (rzecz.) szerzenie
dissension : dissension : (rzecz.) niezgoda | : (rzecz.) zwada
dissent : dissent : (czas.) różnić | : (rzecz.) herezja | : (rzecz.) odstępstwo | : (rzecz.) rozłam | : (rzecz.) różnica
dissenter : dissenter : (rzecz.) dysydent | : (rzecz.) heretyk | : (rzecz.) innowierca | : (rzecz.) nonkonformista | : (rzecz.) odszczepieniec
dissertation : dissertation : (rzecz.) dysertacja | : (rzecz.) elaborat
disservice : disservice : (rzecz.) szkoda | : (rzecz.) uszczerbek
dissever : dissever : (czas.) oddzielać | : (czas.) rozdzielać
dissidence : dissidence : (rzecz.) opozycja
dissident : dissident : (przym.) odmienny | : (rzecz.) dysydent | : (rzecz.) odszczepieniec
dissimilar : dissimilar : (przym.) niepodobny | : (przym.) odmienny
dissimilarity : dissimilarity : (rzecz.) niepodobieństwo | : (rzecz.) odmienność | : (rzecz.) różnica
dissimilation : dissimilation : (rzecz.) dysymilacja
dissimilitude : dissimilitude : (rzecz.) nierówność | : (rzecz.) różnica
dissimulate : dissimulate : (czas.) udawać | : (czas.) ukrywać
dissimulation : dissimulation : (rzecz.) obłuda | : (rzecz.) symulowanie | : (rzecz.) udawanie
dissipate : dissipate : (czas.) birbantować | : (czas.) odprowadzać | : (czas.) rozganiać | : (czas.) rozpraszać | : (czas.) rozproszyć | : (czas.) roztrwaniać | : (czas.) trwonić
dissipated : dissipated : (przym.) rozpustny
dissipation : dissipation : (rzecz.) dyssypacja | : (rzecz.) rozgonienie | : (rzecz.) rozpraszanie | : (rzecz.) rozproszenie | : (rzecz.) rozpusta | : (rzecz.) roztrwonienie | : (rzecz.) trwonienie
dissipative : dissipative : (przym.) rozpraszający | : (przym.) stratny
dissociable : dissociable : (przym.) antyspołeczny
dissociate : dissociate : (czas.) dysocjować | : (czas.) odcinać | : (czas.) oddzielać | : (czas.) odłączać | : (czas.) rozdzielać | : (czas.) rozłączać
dissociation : dissociation : (rzecz.) dysocjacja | : (rzecz.) odłączanie | : (rzecz.) rozdzielenie | : (rzecz.) rozkojarzenie | : (rzecz.) rozpad
dissolubility : dissolubility : (rzecz.) rozpuszczalność
dissoluble : dissoluble : (przym.) rozerwalny | : (przym.) rozpuszczalny | : (przym.) rozwiązalny
dissolute : dissolute : (przym.) rozpustny
dissolution : dissolution : (rzecz.) rozkład | : (rzecz.) rozpad | : (rzecz.) rozpuszczanie | : (rzecz.) rozpuszczenie | : (rzecz.) roztwór | : (rzecz.) rozwiązanie
dissolve : dissolve : (czas.) rozkładać | : (czas.) rozpuszczać | : (czas.) rozwiązać | : (czas.) rozwiązywać | : (czas.) zrywać
dissolved : dissolved : (czas.) rozpuścić
dissolvent : dissolvent : (przym.) rozkładowy | : (rzecz.) rozpuszczalnik
dissonance : dissonance : (rzecz.) dysonans
dissuade : dissuade : (czas.) odradzać | : (czas.) odwieść | : (czas.) odwodzić
dissuasion : dissuasion : (rzecz.) odradzanie | : (rzecz.) odwodzenie
dissymmetry : dissymmetry : (rzecz.) asymetria | : (rzecz.) chiralność
distaff : distaff : (rzecz.) kądziel
distance : distance : (czas.) dystansować | : (czas.) odseparowywać | : (rzecz.) dal | : (rzecz.) dalekość | : (rzecz.) drogomierz | : (rzecz.) dystans | : (rzecz.) oddalenie | : (rzecz.) odległość | : (rzecz.) odstęp
distant : distant : (przym.) chłodny | : (przym.) daleki | : (przym.) krewny | : (przym.) nieobecny | : (przym.) odległy | : (przym.) zamiejscowy | : (przym.) zamierzchły
distantly : distantly : (przysł.) daleko
distaste : distaste : (rzecz.) antypatia | : (rzecz.) awersja | : (rzecz.) niechęć | : (rzecz.) niesmak | : (rzecz.) wstręt
distasteful : distasteful : (przym.) nieprzyjemny | : (przym.) obrzydliwy | : (przym.) przykry | : (przym.) wstrętny
distend : distend : (czas.) rozciągać | : (czas.) rozszerzać
distensible : distensible : (przym.) rozciągliwy | : (przym.) rozszerzalny
distension : distension : (rzecz.) rozszerzanie
distich : distich : (rzecz.) dwuwiersz | : (rzecz.) dystych
distil : distil : (czas.) destylować | : (czas.) sączyć | : (czas.) wydestylować | : (czas.) wypreparowywać
distillate : distillate : (rzecz.) destylat
distillation : distillation : (rzecz.) destylacja
distillatory : distillatory : (przym.) destylacyjny
distiller : distiller : (rzecz.) destylator | : (rzecz.) gorzelnik
distillery : distillery : (rzecz.) destylarnia | : (rzecz.) gorzelnia | : (rzecz.) gorzelnictwo
distinct : distinct : (przym.) dobitny | : (przym.) niedwuznaczny | : (przym.) niewątpliwy | : (przym.) oddzielny | : (przym.) odmienny | : (przym.) odrębny | : (przym.) różny | : (przym.) rozróżnialny | : (przym.) wybitny | : (przym.) wydatny | : (przym.) wyrazisty | : (przym.) wyraźny
distinction : distinction : (rzecz.) dystynkcja | : (rzecz.) odrębność | : (rzecz.) odróżnienie | : (rzecz.) odznaczenie | : (rzecz.) rozgraniczenie | : (rzecz.) różnica | : (rzecz.) rozróżnienie | : (rzecz.) wyróżnienie
distinctive : distinctive : (przym.) charakterystyczny | : (przym.) specyficzny | : (przym.) wyraźny | : (przym.) znamienny
distinctively : distinctively : (przysł.) wyróżniająco
distinctiveness : distinctiveness : (rzecz.) odrębność
distinctly : distinctly : (przysł.) dobitnie | : (przysł.) jasno | : (przysł.) wydatnie | : (przysł.) wyraźnie
distinctness : distinctness : (rzecz.) odmienność | : (rzecz.) wyrazistość
distinguee : distinguee : (przym.) dystyngowany
distinguish : distinguish : (czas.) odróżniać | : (czas.) odznaczyć | : (czas.) rozpoznawać | : (czas.) rozróżniać | : (czas.) rozróżnić | : (czas.) wyróżniać
distinguishable : distinguishable : (przym.) rozpoznawalny | : (przym.) rozróżnialny
distinguished : distinguished : (czas.) odróżnić | : (przym.) dostojny | : (przym.) dystyngowany | : (przym.) wybitny | : (przym.) znakomity
distort : distort : (czas.) przekręcać | : (czas.) wykrzywiać | : (czas.) wykrzywić | : (czas.) wypaczać | : (czas.) wypaczyć | : (czas.) zniekształcać | : (czas.) zniekształcić
distorted : distorted : (przym.) zniekształcony
distortion : distortion : (rzecz.) dystorsja | : (rzecz.) odkształcenie | : (rzecz.) przekłamanie | : (rzecz.) spaczanie | : (rzecz.) spaczenie | : (rzecz.) wykoślawienie | : (rzecz.) wykrzywienie | : (rzecz.) wypaczenie | : (rzecz.) zakłócanie | : (rzecz.) zakłócenie | : (rzecz.) zniekształcanie | : (rzecz.) zniekształcenie
distract : distract : (czas.) niepokoić | : (czas.) odciągać | : (czas.) oderwać | : (czas.) odrywać | : (czas.) przeszkadzać | : (czas.) rozpraszać | : (czas.) rozrywać
distractedness : distractedness : (rzecz.) roztrzepanie
distraction : distraction : (rzecz.) dystrakcja | : (rzecz.) oderwanie | : (rzecz.) rozproszenie | : (rzecz.) rozrywka | : (rzecz.) rozstrój | : (rzecz.) roztargnienie | : (rzecz.) rozterka | : (rzecz.) zakłócenie
distress : distress : (czas.) martwić | : (czas.) udręczać | : (czas.) unieszczęśliwiać | : (rzecz.) boleść | : (rzecz.) cierpienie | : (rzecz.) niebezpieczeństwo | : (rzecz.) nieszczęście | : (rzecz.) przykrość | : (rzecz.) rozpacz | : (rzecz.) strapienie | : (rzecz.) udręka | : (rzecz.) zmartwienie
distressed : distressed : (przym.) bolesny
distressful : distressful : (przym.) rozpaczliwy | : (przym.) smutny
distressing : distressing : (przym.) rozpaczliwy
distribute : distribute : (czas.) dystrybuować | : (czas.) dzielić | : (czas.) rozdawać | : (czas.) rozdzielać | : (czas.) rozkolportować | : (czas.) roznosić | : (czas.) rozpowszechniać | : (czas.) rozpraszać | : (czas.) rozprowadzać | : (czas.) rozprowadzić | : (czas.) rozsiedlać | : (czas.) rozsyłać
distributing : distributing : (przym.) rozdzielczy
distribution : distribution : (rzecz.) dystrybucja | : (rzecz.) dystrybuowanie | : (rzecz.) kolportaż | : (rzecz.) podział | : (rzecz.) repartycja | : (rzecz.) rozdanie | : (rzecz.) rozdawnictwo | : (rzecz.) rozdział | : (rzecz.) rozdzielanie | : (rzecz.) rozdzielenie | : (rzecz.) rozdzielnictwo | : (rzecz.) rozkład | : (rzecz.) rozmieszczenie | : (rzecz.) roznoszenie | : (rzecz.) rozproszenie | : (rzecz.) rozrząd | : (rzecz.) rozsyłka
distributional : distributional : (przym.) dystrybucyjny
distributive : distributive : (przym.) rozdawniczy | : (przym.) rozdzielczy
distributor : distributor : (rzecz.) dostawca | : (rzecz.) dystrybutor | : (rzecz.) kolporter | : (rzecz.) rozdzielacz | : (rzecz.) rozdzielnik | : (rzecz.) roznosiciel | : (rzecz.) zapłon
distributor's : distributor's : (przym.) kolporterski
district : district : (rzecz.) dystrykt | : (rzecz.) dzielnica | : (rzecz.) obręb | : (rzecz.) obwód | : (rzecz.) okręg | : (rzecz.) powiat | : (rzecz.) region | : (rzecz.) rejon | : (rzecz.) rewir | : (rzecz.) województwo
distrust : distrust : (rzecz.) niedowierzanie | : (rzecz.) nieufność | : (rzecz.) podejrzliwość
distrustful : distrustful : (przym.) nieufny | : (przym.) podejrzliwy
distrustfully : distrustfully : (przysł.) nieufnie
disturb : disturb : (czas.) mącić | : (czas.) niepokoić | : (czas.) przeszkadzać | : (czas.) ruszać | : (czas.) wzburzać | : (czas.) zakłócać | : (czas.) zmieniać
disturbance : disturbance : (rzecz.) awantura | : (rzecz.) burda | : (rzecz.) niepokój | : (rzecz.) niepokojenie | : (rzecz.) zaburzenie | : (rzecz.) zakłócenie
disturbingly : disturbingly : (przysł.) niepokojąco
disulfide : disulfide : (rzecz.) dwusiarczek
disunite : disunite : (czas.) rozłączać
disunity : disunity : (rzecz.) niezgoda | : (rzecz.) rozbicie
disuse : disuse : (rzecz.) odzwyczajenie | : (rzecz.) zaprzestanie | : (rzecz.) zarzucenie
disutility : disutility : (rzecz.) nieużyteczność
disyllable : disyllable : (rzecz.) dwuzgłoskowiec
ditch : ditch : (czas.) drenować | : (czas.) porzucać | : (czas.) rzucać | : (czas.) wywalać | : (rzecz.) bariera | : (rzecz.) kanał | : (rzecz.) okop | : (rzecz.) przekop | : (rzecz.) rów
ditcher : ditcher : (rzecz.) dróżnik | : (rzecz.) koparka
ditching : ditching : (rzecz.) kopanie | : (rzecz.) zarzucanie
dither : dither : (czas.) dygotać | : (rzecz.) drżenie | : (rzecz.) wahanie
dithyramb : dithyramb : (rzecz.) dytyramb
dithyrambic : dithyrambic : (przym.) dytyrambiczny
ditto : ditto : (rzecz.) piosenka
ditty : ditty : (rzecz.) piosenka | : (rzecz.) śpiewka
diuretic : diuretic : (przym.) moczopędny
diurnal : diurnal : (przym.) codzienny | : (przym.) dobowy | : (przym.) dzienny
diurnally : diurnally : (przysł.) codziennie
diva : diva : (rzecz.) diwa
divagation : divagation : (rzecz.) dywagacja
divalent : divalent : (przym.) dwuwartościowy
divan : divan : (rzecz.) palarnia
dive : dive : (czas.) nurkować | : (czas.) pikować | : (czas.) pogrążać | : (czas.) rzucać | : (czas.) wskakiwać | : (czas.) zanurzać | : (rzecz.) melina | : (rzecz.) nurek | : (rzecz.) nurkowanie | : (rzecz.) speluna | : (rzecz.) spelunka | : (rzecz.) zanurzenie
diver : diver : (rzecz.) nurek | : (rzecz.) płetwonurek | : (rzecz.) poławiacz
diver's : diver's : (przym.) nurkowy
diverge : diverge : (czas.) odbiegać | : (czas.) odchylać | : (czas.) rozbiegać | : (czas.) rozchodzić
divergence : divergence : (rzecz.) dywergencja | : (rzecz.) odchylenie | : (rzecz.) rozbieżność
divergent : divergent : (przym.) rozbieżny | : (przym.) różnorodny
diverse : diverse : (przym.) odmienny | : (przym.) rozliczny | : (przym.) rozmaity | : (przym.) różnoraki | : (przym.) różnorodny | : (przym.) różny
diversely : diversely : (przysł.) rozmaicie | : (przysł.) różnie
diversification : diversification : (rzecz.) dywersyfikacja | : (rzecz.) urozmaicenie | : (rzecz.) zróżnicowanie
diversified : diversified : (przym.) niejednolity
diversiform : diversiform : (przym.) różnokształtny
diversify : diversify : (czas.) różnicować | : (czas.) rozszerzać | : (czas.) urozmaicać | : (czas.) zróżnicować
diversion : diversion : (rzecz.) atrakcja | : (rzecz.) dywersja | : (rzecz.) objazd | : (rzecz.) odchylenie | : (rzecz.) odwrócenie | : (rzecz.) rozrywka | : (rzecz.) zmiana
diversionary : diversionary : (przym.) dywersyjny
diversity : diversity : (rzecz.) niejednolitość | : (rzecz.) rozmaitość | : (rzecz.) różnorodność | : (rzecz.) urozmaicenie | : (rzecz.) zróżnicowanie
divert : divert : (czas.) kierować | : (czas.) odchylać | : (czas.) odciągać | : (czas.) odwracać | : (czas.) przeznaczać | : (czas.) śmieszyć | : (czas.) zabawiać | : (czas.) zawracać | : (czas.) zbaczać | : (czas.) zmieniać
divest : divest : (czas.) pozbawiać | : (czas.) rezygnować | : (czas.) rozbierać | : (czas.) uwalniać | : (czas.) wynaradawiać | : (czas.) zrezygnować
divide : divide : (czas.) dwoić | : (czas.) dzielić | : (czas.) podzielać | : (czas.) podzielić | : (czas.) porozdzielać | : (czas.) przedzielać | : (czas.) różnić | : (czas.) rozwidlać | : (czas.) skłócać | : (rzecz.) dzielenie | : (rzecz.) podziel | : (rzecz.) wododział
dividend : dividend : (rzecz.) dywidenda | : (rzecz.) tantiema | : (rzecz.) wygrana
divider : divider : (rzecz.) dzielnik | : (rzecz.) przegroda | : (rzecz.) rozdzielacz
dividers : dividers : (rzecz.) cyrkiel
divination : divination : (rzecz.) przepowiednia | : (rzecz.) wróżbiarstwo | : (rzecz.) wróżenie
divine : divine : (czas.) domyślać | : (czas.) przepowiadać | : (czas.) zgadywać | : (przym.) boski | : (przym.) boży | : (przym.) duchowny
divinely : divinely : (przysł.) bosko | : (przysł.) cudownie
diviner : diviner : (rzecz.) różdżkarz | : (rzecz.) wróżbita
diving-board : diving-board : (rzecz.) skocznia | : (rzecz.) trampolina
divinity : divinity : (rzecz.) boskość | : (rzecz.) bóstwo | : (rzecz.) religia | : (rzecz.) teologia
divisibility : divisibility : (rzecz.) podzielność | : (rzecz.) rozdzielność
divisible : divisible : (przym.) podzielny
division : division : (rzecz.) bariera | : (rzecz.) dywizja | : (rzecz.) dział | : (rzecz.) działka | : (rzecz.) dzielenie | : (rzecz.) liga | : (rzecz.) oddział | : (rzecz.) podział | : (rzecz.) przedział | : (rzecz.) rozdwojenie | : (rzecz.) rozdzielenie | : (rzecz.) rozłam | : (rzecz.) rozpad | : (rzecz.) sekcja | : (rzecz.) wydzielenie
divisional : divisional : (przym.) dywizyjny
divisor : divisor : (rzecz.) dzielnik | : (rzecz.) podzielnik
divorce : divorce : (czas.) rozwieść | : (czas.) rozwodzić | : (rzecz.) rozłączenie | : (rzecz.) rozwód
divorced : divorced : (przym.) rozwiedziony
divorcee : divorcee : (rzecz.) rozwódka | : (rzecz.) rozwodnik
divorcé : divorcé : (rzecz.) rozwód
divot : divot : (rzecz.) garstka | : (rzecz.) kawałek
divulgation : divulgation : (rzecz.) rozgłoszenie
divulge : divulge : (czas.) wyjawiać
divvy : divvy : (rzecz.) dywidenda
dizzily : dizzily : (przysł.) zawrotnie
dizzy : dizzy : (przym.) zawrotny
do : do : (czas.) czynić | : (czas.) nadawać | : (czas.) radzić | : (czas.) robić | : (czas.) sprawiać | : (czas.) wystarczać | : (czas.) zrobić | : (czas.) zrzucać
do-all : do-all : (przym.) wszechstronny
do-hickey : do-hickey : (rzecz.) mechanizm
do-it-yourself : do-it-yourself : (rzecz.) majsterkowanie
do-jigger : do-jigger : (rzecz.) mechanizm
do-nothing : do-nothing : (rzecz.) nierób | : (rzecz.) obibok
doable : doable : (przym.) wykonalny
doc : doc : (przym.) portowy | : (rzecz.) dok | : (rzecz.) dokument | : (rzecz.) mędrek | : (rzecz.) plik
docile : docile : (przym.) pojętny | : (przym.) posłuszny | : (przym.) potulny
docilely : docilely : (przysł.) pojętnie
docility : docility : (rzecz.) posłuszeństwo | : (rzecz.) uległość
dock : dock : (czas.) dokować | : (czas.) obcinać | : (czas.) potrącać | : (rzecz.) dok | : (rzecz.) ława | : (rzecz.) podogonie | : (rzecz.) szczaw
dockage : dockage : (rzecz.) obcięcie | : (rzecz.) potrącenie
dockyard : dockyard : (rzecz.) stocznia
doctor : doctor : (czas.) fałszować | : (rzecz.) doktor | : (rzecz.) doktorat | : (rzecz.) lekarz | : (rzecz.) zgarniacz
doctor's : doctor's : (przym.) doktorski
doctoral : doctoral : (przym.) doktorski
doctorate : doctorate : (rzecz.) doktorat
doctrinaire : doctrinaire : (rzecz.) doktryner
doctrinal : doctrinal : (przym.) doktrynalny
doctrinarian : doctrinarian : (przym.) doktrynerski | : (rzecz.) doktryner
doctrine : doctrine : (rzecz.) doktryna
document : document : (czas.) dokumentować | : (czas.) opisywać | : (rzecz.) dokument
documentaries : documentaries : (przym.) udokumentowany
documentary : documentary : (przym.) dokumentalny | : (przym.) dokumentarny
documentation : documentation : (rzecz.) dokumentacja | : (rzecz.) dokumentowanie
documented : documented : (czas.) udokumentować
dodecagon : dodecagon : (rzecz.) dwunastokąt
dodecahedron : dodecahedron : (rzecz.) dwunastościan
dodge : dodge : (czas.) kluczyć | : (czas.) omijać | : (czas.) uskakiwać | : (czas.) wymijać | : (czas.) wymykać | : (rzecz.) machinacja | : (rzecz.) sztuczka | : (rzecz.) unik
dodger : dodger : (rzecz.) spychacz
dodgy : dodgy : (przym.) dziurawy | : (przym.) przebiegły | : (przym.) szachrajski
doe : doe : (rzecz.) królica | : (rzecz.) łania
doe-hare : doe-hare : (rzecz.) zajęczyca
doer : doer : (rzecz.) rzemieślnik | : (rzecz.) sprawca | : (rzecz.) wykonawca | : (rzecz.) wynalazca
doeskin : doeskin : (rzecz.) ircha
doff : doff : (czas.) muskać | : (czas.) zdejmować
doffer : doffer : (rzecz.) odbieracz
dog : dog : (rzecz.) pies | : (rzecz.) zabierak | : (rzecz.) zaczep | : (rzecz.) zapadka | : (rzecz.) zderzak
dog-catcher : dog-catcher : (rzecz.) hycel | : (rzecz.) rakarz
dog-collar : dog-collar : (rzecz.) koloratka | : (rzecz.) obroża
dog-days : dog-days : (rzecz.) kanikuła
dogberry : dogberry : (przym.) dereniowy | : (rzecz.) dereń
dogcatcher : dogcatcher : (rzecz.) hycel | : (rzecz.) rakarz
doge : doge : (rzecz.) doża
dogfish : dogfish : (rzecz.) koleń | : (rzecz.) rekinek
doggedly : doggedly : (przysł.) uparcie | : (przysł.) zawzięcie
doggedness : doggedness : (rzecz.) upór | : (rzecz.) zacietrzewienie | : (rzecz.) zawziętość
doggerel : doggerel : (rzecz.) fraszka
doggie : doggie : (rzecz.) piesek | : (rzecz.) psiak | : (rzecz.) psina
doggy : doggy : (rzecz.) piesek | : (rzecz.) psina
dogma : dogma : (rzecz.) dogmat
dogmatic : dogmatic : (przym.) dogmatyczny
dogmatically : dogmatically : (przysł.) apodyktycznie | : (przysł.) dogmatycznie
dogmatism : dogmatism : (rzecz.) apodyktyczność | : (rzecz.) dogmatyzm
dogmatist : dogmatist : (rzecz.) dogmatyk
dogmatize : dogmatize : (czas.) dogmatyzować
dogwood : dogwood : (rzecz.) dereń
doily : doily : (rzecz.) serwetka
doldrums : doldrums : (rzecz.) zastój
dole : dole : (rzecz.) cząstka | : (rzecz.) część | : (rzecz.) jałmużna | : (rzecz.) zapomoga | : (rzecz.) zasiłek
doleful : doleful : (przym.) rzewny | : (przym.) smętny | : (przym.) żałosny
dolefully : dolefully : (przysł.) smętnie
dolerite : dolerite : (rzecz.) doleryt
doll : doll : (rzecz.) kukiełka | : (rzecz.) lala | : (rzecz.) lalka
dollar : dollar : (rzecz.) dolar
dollish : dollish : (przym.) lalkowaty
dollop : dollop : (rzecz.) masa
dolly : dolly : (rzecz.) lalka | : (rzecz.) statyw | : (rzecz.) tłuczek
dolmen : dolmen : (rzecz.) dolmen
dolomite : dolomite : (rzecz.) dolomit
dolorous : dolorous : (przym.) smętny
dolphin : dolphin : (rzecz.) dalba | : (rzecz.) delfin
dolt : dolt : (rzecz.) ciamajda
domain : domain : (rzecz.) domena | : (rzecz.) dziedzina | : (rzecz.) panowanie
dome : dome : (rzecz.) kopuła | : (rzecz.) kopułka | : (rzecz.) sklepienie
dome-like : dome-like : (przym.) kopulasty
dome-shaped : dome-shaped : (przym.) kopulasty
domed : domed : (przym.) kopulasty
domestic : domestic : (przym.) bytowy | : (przym.) domowy | : (przym.) krajowy | : (przym.) wewnętrzny | : (rzecz.) służąca
domestically : domestically : (przysł.) domowo | : (przysł.) wewnętrznie
domesticate : domesticate : (czas.) oswajać | : (czas.) oswoić | : (czas.) udomawiać | : (czas.) udomowić
domestication : domestication : (rzecz.) aklimatyzacja | : (rzecz.) oswojenie | : (rzecz.) ucywilizowanie
domesticity : domesticity : (rzecz.) domatorstwo | : (rzecz.) oswojenie
domical : domical : (przym.) kopułowy
domicile : domicile : (rzecz.) miejsce
dominance : dominance : (rzecz.) dominacja | : (rzecz.) przewaga
dominant : dominant : (przym.) dominujący | : (przym.) majoryzujący | : (przym.) panujący
dominate : dominate : (czas.) dominować | : (czas.) górować | : (czas.) panować | : (czas.) przeważać | : (czas.) zdominować
domination : domination : (rzecz.) dominacja | : (rzecz.) wszechwładza | : (rzecz.) zwierzchnictwo
dominator : dominator : (rzecz.) władca
domineer : domineer : (czas.) dominować | : (czas.) tyranizować
domineering : domineering : (przym.) apodyktyczny | : (przym.) władczy
domineeringly : domineeringly : (przysł.) despotycznie
dominie : dominie : (rzecz.) pastor
dominion : dominion : (rzecz.) dominium | : (rzecz.) panowanie | : (rzecz.) władza | : (rzecz.) władztwo | : (rzecz.) zwierzchnictwo
domino : domino : (rzecz.) domino | : (rzecz.) klocek | : (rzecz.) kostka
dominoes : dominoes : (rzecz.) domino
don : don : (czas.) wdziewać | : (rzecz.) nauczyciel
donate : donate : (czas.) darować | : (czas.) darowywać | : (czas.) podarować | : (czas.) sprezentować
donated : donated : (czas.) uzbierać
donation : donation : (rzecz.) dar | : (rzecz.) darowizna | : (rzecz.) datek | : (rzecz.) dotacja | : (rzecz.) oddawanie | : (rzecz.) ofiarowanie
donator : donator : (rzecz.) dawca
done : done : (czas.) czynić | : (czas.) odbyć | : (czas.) odbywać | : (czas.) uczynić
dong : dong : (rzecz.) kutas
donjon : donjon : (rzecz.) ostróg
donkey : donkey : (rzecz.) osioł
donnish : donnish : (przym.) profesorski
donor : donor : (rzecz.) darczyńca | : (rzecz.) dawca | : (rzecz.) donor | : (rzecz.) ofiarodawca
donut : donut : (rzecz.) pączek
doodle : doodle : (czas.) bazgrać
doodlebug : doodlebug : (rzecz.) różdżka
doom : doom : (czas.) osądzać | : (czas.) osądzić | : (czas.) skazywać | : (rzecz.) fatalność | : (rzecz.) fatum | : (rzecz.) los | : (rzecz.) przeznaczenie | : (rzecz.) sąd | : (rzecz.) stracenie | : (rzecz.) wyrok | : (rzecz.) zagłada | : (rzecz.) zatracenie | : (rzecz.) zatrata
door : door : (rzecz.) drzwi | : (rzecz.) drzwiczki | : (rzecz.) futryna | : (rzecz.) odrzwia | : (rzecz.) wrota
door-case : door-case : (rzecz.) odrzwia
door-frames : door-frames : (rzecz.) odrzwia
door-handle : door-handle : (rzecz.) klamka
door-keeper : door-keeper : (rzecz.) portier | : (rzecz.) stróż
door-knob : door-knob : (rzecz.) klamka
door-mat : door-mat : (rzecz.) wycieraczka
doorbell : doorbell : (rzecz.) dzwonek
doorkeeper : doorkeeper : (rzecz.) dozorca | : (rzecz.) portier | : (rzecz.) stróż
doorknob : doorknob : (rzecz.) klamka
doorman : doorman : (rzecz.) portier
doormat : doormat : (rzecz.) słomianka | : (rzecz.) wycieraczka
doorpost : doorpost : (rzecz.) stojak
doors : doors : (rzecz.) drzwi
doorstep : doorstep : (rzecz.) próg
doorway : doorway : (rzecz.) brama | : (rzecz.) dostęp | : (rzecz.) przejście | : (rzecz.) wejście | : (rzecz.) wjazd
dope : dope : (czas.) narkotyzować | : (czas.) odurzać | : (rzecz.) cellon | : (rzecz.) dodatek | : (rzecz.) domieszka | : (rzecz.) doping | : (rzecz.) gapa | : (rzecz.) idiota | : (rzecz.) maź | : (rzecz.) narkotyk | : (rzecz.) zaprawa
dopey : dopey : (przym.) głupkowaty
dork : dork : (rzecz.) dziwak | : (rzecz.) kretyn | : (rzecz.) oryginał
dorm : dorm : (rzecz.) akademik
dormancy : dormancy : (rzecz.) sen | : (rzecz.) spoczynek
dormant : dormant : (przym.) bezczynny | : (przym.) nieaktywny | : (przym.) nieczynny
dormitory : dormitory : (rzecz.) akademik | : (rzecz.) bursa | : (rzecz.) internat
dormouse : dormouse : (rzecz.) koszatka | : (rzecz.) popielica
dorsal : dorsal : (przym.) grzbietowy
dosage : dosage : (rzecz.) dawkowanie | : (rzecz.) dozowanie
dose : dose : (czas.) aplikować | : (czas.) dawkować | : (czas.) dozować | : (rzecz.) dawka | : (rzecz.) dawkowanie | : (rzecz.) doza
dosimeter : dosimeter : (rzecz.) dawkomierz | : (rzecz.) dozymetr
doss : doss : (rzecz.) noclegownia
dossier : dossier : (rzecz.) akta | : (rzecz.) dokumentacja
dossiers : dossiers : (rzecz.) akta
dot : dot : (czas.) kropkować | : (czas.) pstrzyć | : (czas.) wykropkować | : (rzecz.) bobas | : (rzecz.) kropka | : (rzecz.) pędrak
dotage : dotage : (rzecz.) zdziecinnienie
dotard : dotard : (rzecz.) ramol
dote : dote : (czas.) hołubić | : (czas.) ramoleć | : (czas.) ubóstwiać | : (czas.) zdziecinnieć
doting : doting : (przym.) troskliwy
dotty : dotty : (przym.) durnowaty
double : double : (czas.) dublować | : (czas.) kontrować | : (czas.) podwajać | : (czas.) podwoić | : (czas.) powiększać | : (czas.) rekontrować | : (czas.) zdwajać | : (przym.) deblowy | : (przym.) podwójny | : (przysł.) dwójnasób | : (przysł.) podwójnie | : (rzecz.) debel | : (rzecz.) dubler | : (rzecz.) dublowanie | : (rzecz.) kaskader | : (rzecz.) kontrafałda | : (rzecz.) podwajanie | : (rzecz.) podwój | : (rzecz.) sobowtór
double-bass : double-bass : (rzecz.) basetla | : (rzecz.) kontrabas
double-breasted : double-breasted : (przym.) dwurzędowy
double-byte : double-byte : (przym.) dwubajtowy
double-dealer : double-dealer : (rzecz.) krętacz
double-dealing : double-dealing : (rzecz.) dwulicowość
double-decker : double-decker : (rzecz.) piętrus
double-edged : double-edged : (przym.) obosieczny
double-ended : double-ended : (przym.) dwustronny
double-pole : double-pole : (przym.) dwubiegunowy
double-sided : double-sided : (przym.) dwustronny
double-talk : double-talk : (rzecz.) pustosłowie
double-tongued : double-tongued : (przym.) fałszywy
doubler : doubler : (rzecz.) dubler | : (rzecz.) łączniarka | : (rzecz.) opera | : (rzecz.) skręcarka
doublet : doublet : (rzecz.) dublet | : (rzecz.) kubrak | : (rzecz.) zdwojenie
doubletalk : doubletalk : (czas.) zwodzić | : (rzecz.) pustosłowie
doubling : doubling : (czas.) podwajać | : (rzecz.) dublowanie | : (rzecz.) dwojenie | : (rzecz.) kontrowanie | : (rzecz.) podszycie | : (rzecz.) podwajanie | : (rzecz.) podwojenie | : (rzecz.) zdwajanie | : (rzecz.) zdwojenie
doubloon : doubloon : (rzecz.) dublon
doubly : doubly : (przysł.) dwójnasób | : (przysł.) podwójnie
doubt : doubt : (czas.) powątpiewać | : (czas.) wątpić | : (czas.) zwątpić | : (rzecz.) niepewność | : (rzecz.) powątpiewanie | : (rzecz.) wątpliwość | : (rzecz.) zwątpienie
doubtful : doubtful : (przym.) niepewny | : (przym.) wątpliwy
doubtfully : doubtfully : (przysł.) niepewnie | : (przysł.) powątpiewająco | : (przysł.) wątpliwie
doubtless : doubtless : (przym.) niewątpliwy | : (przysł.) niewątpliwie
douceur : douceur : (rzecz.) gratyfikacja | : (rzecz.) łapówka
douche : douche : (rzecz.) natrysk | : (rzecz.) tusz
dough : dough : (rzecz.) ciasto | : (rzecz.) forsa | : (rzecz.) kasa | : (rzecz.) pieniądze | : (rzecz.) szmal
doughnut : doughnut : (rzecz.) pączek
doughty : doughty : (przym.) dzielny | : (przym.) tęgi
doughy : doughy : (przym.) ciastowaty | : (przym.) ciastowy | : (przym.) zakalcowaty
dour : dour : (przym.) srogi
dourness : dourness : (rzecz.) srogość
douse : douse : (czas.) oblewać | : (czas.) przysłaniać | : (czas.) zanurzać
dove : dove : (rzecz.) gołąb | : (rzecz.) gołąbek | : (rzecz.) gołębica
dovecot : dovecot : (rzecz.) gołębnik
dovecote : dovecote : (rzecz.) gołębnik
doves : doves : (rzecz.) turkawka
dovetail : dovetail : (czas.) pasować | : (rzecz.) połączenie | : (rzecz.) zacios
dowdy : dowdy : (przym.) niemodny | : (przym.) zaniedbany
dowel : dowel : (rzecz.) dybel | : (rzecz.) kołek
dower : dower : (czas.) uposażyć | : (rzecz.) posag
down : down : (czas.) paść | : (czas.) przełamywać | : (czas.) wyłączać | : (czas.) zestrzelić | : (rzecz.) dół | : (rzecz.) meszek | : (rzecz.) puch | : (rzecz.) puszek | : (rzecz.) stos | : (rzecz.) wydma
down-to-earth : down-to-earth : (przym.) praktyczny | : (przym.) przyziemny | : (przym.) rozsądny
downer : downer : (rzecz.) barbituran
downfall : downfall : (rzecz.) degrengolada | : (rzecz.) klęska | : (rzecz.) ruina | : (rzecz.) upadek | : (rzecz.) zguba
downhearted : downhearted : (przym.) smutny
downhill : downhill : (przym.) spadzisty | : (rzecz.) nachylenie
download : download : (czas.) kopiować | : (czas.) pobierać | : (czas.) pobrać | : (czas.) przesłać | : (czas.) ściągać | : (czas.) ściągnąć | : (czas.) sprowadzać | : (czas.) sprowadzić
downloads : downloads : (rzecz.) pobieranie | : (rzecz.) ściąga
downplay : downplay : (czas.) bagatelizować | : (czas.) zbagatelizować
downplaying : downplaying : (rzecz.) bagatelizowanie
downpour : downpour : (rzecz.) deszcz | : (rzecz.) ulewa
downright : downright : (przym.) całkowity | : (przym.) szczery | : (przym.) wierutny
downsizing : downsizing : (rzecz.) redukcja | : (rzecz.) wyrobów
downtime : downtime : (rzecz.) przestój
downtown : downtown : (rzecz.) centrum | : (rzecz.) śródmieście
downturn : downturn : (rzecz.) spadek | : (rzecz.) zmniejszenie
downward : downward : (przym.) opadający | : (przym.) spadkowy | : (przym.) zstępny
downwind : downwind : (przym.) zawietrzny
downy : downy : (przym.) falisty | : (przym.) puchaty | : (przym.) puchowy | : (przym.) puszysty
dowry : dowry : (rzecz.) posag | : (rzecz.) wiano
dowser : dowser : (rzecz.) różdżkarz
doxy : doxy : (rzecz.) kochanica | : (rzecz.) pogląd
doyen : doyen : (rzecz.) nestor
doze : doze : (czas.) drzemać | : (rzecz.) drzemka
dozen : dozen : (rzecz.) tuzin
dozer : dozer : (rzecz.) spycharka
drab : drab : (przym.) bezbarwny | : (przym.) monotonny | : (przym.) nudny | : (przym.) szary
drabness : drabness : (rzecz.) szarzyzna
draconian : draconian : (przym.) drakoński
draft : draft : (czas.) odkomenderować | : (czas.) szkicować | : (rzecz.) brudnopis | : (rzecz.) ciąg | : (rzecz.) cug | : (rzecz.) konspekt | : (rzecz.) pobór | : (rzecz.) projekt | : (rzecz.) przewiew | : (rzecz.) rysunek | : (rzecz.) standard | : (rzecz.) szkic | : (rzecz.) weksel | : (rzecz.) zaciąg | : (rzecz.) zanurzenie | : (rzecz.) zarys
draftee : draftee : (rzecz.) rekrut
drafting : drafting : (rzecz.) ciągnienie | : (rzecz.) kreślenie | : (rzecz.) odciąganie | : (rzecz.) projektowanie | : (rzecz.) szkicowanie
draftsman : draftsman : (rzecz.) kreślarz | : (rzecz.) rysownik
drag : drag : (czas.) bronować | : (czas.) ciągać | : (czas.) ciągnąć | : (czas.) dłużyć | : (czas.) powłóczyć | : (czas.) prowadzić | : (czas.) przeciągać | : (czas.) trałować | : (czas.) włóczyć | : (rzecz.) męka | : (rzecz.) mordęga | : (rzecz.) nudziarz | : (rzecz.) opór | : (rzecz.) wlec | : (rzecz.) włóczka | : (rzecz.) włók | : (rzecz.) włóka | : (rzecz.) zawlec
drag-bar : drag-bar : (rzecz.) sprzęg
drag-net : drag-net : (rzecz.) niewód
draggle : draggle : (czas.) ociągać | : (czas.) wyszargać | : (czas.) zaszargać
dragnet : dragnet : (rzecz.) knieja | : (rzecz.) niewód | : (rzecz.) sieć | : (rzecz.) włok
dragoman : dragoman : (rzecz.) dragoman
dragon : dragon : (rzecz.) smok
dragon's : dragon's : (przym.) smoczy
dragon-fly : dragon-fly : (rzecz.) ważka
dragonfly : dragonfly : (rzecz.) ważka
dragoon : dragoon : (rzecz.) dragon
drain : drain : (czas.) drenować | : (czas.) meliorować | : (czas.) odcedzać | : (czas.) odcedzić | : (czas.) odlewać | : (czas.) odwadniać | : (czas.) odwodnić | : (czas.) osuszać | : (czas.) sączkować | : (czas.) sączyć | : (czas.) spływać | : (czas.) suszyć | : (rzecz.) dren | : (rzecz.) drenaż | : (rzecz.) kanał | : (rzecz.) kanalizacja | : (rzecz.) odpływ | : (rzecz.) ropociąg | : (rzecz.) rynsztok | : (rzecz.) sączek | : (rzecz.) ściek | : (rzecz.) studzienka
drainage : drainage : (rzecz.) drenaż | : (rzecz.) drenowanie | : (rzecz.) melioracja | : (rzecz.) odwadnianie | : (rzecz.) osuszanie | : (rzecz.) sączkowanie
drainer : drainer : (rzecz.) odwadniarka
drainpipe : drainpipe : (rzecz.) dren | : (rzecz.) rynna
drake : drake : (rzecz.) jętka | : (rzecz.) kaczor
dram : dram : (rzecz.) drachma | : (rzecz.) handlowa | : (rzecz.) łut | : (rzecz.) naparstek
drama : drama : (rzecz.) dramat | : (rzecz.) dramaturgia | : (rzecz.) krytyk | : (rzecz.) słuchowisko | : (rzecz.) sztuka | : (rzecz.) teatr
dramatic : dramatic : (przym.) dramatyczny
dramatically : dramatically : (przysł.) dramatycznie
dramatist : dramatist : (rzecz.) dramaturg
dramatization : dramatization : (rzecz.) dramatyzacja | : (rzecz.) teatralizacja
dramatize : dramatize : (czas.) dramatyzować | : (czas.) udramatyzować
dramaturgic : dramaturgic : (przym.) dramaturgiczny
dramaturgy : dramaturgy : (rzecz.) dramatopisarstwo | : (rzecz.) dramaturgia | : (rzecz.) scenopisarstwo
drape : drape : (czas.) drapować | : (czas.) udrapować | : (rzecz.) firana | : (rzecz.) stora | : (rzecz.) zasłona
draper : draper : (rzecz.) bławatnik | : (rzecz.) sukiennik
drapery : drapery : (rzecz.) draperia | : (rzecz.) drapowanie | : (rzecz.) sukiennictwo
drapes : drapes : (rzecz.) firanki
drastic : drastic : (przym.) drastyczny | : (przym.) stanowczy
drastically : drastically : (przysł.) drastycznie
dratted : dratted : (przym.) nieznośny
draught : draught : (rzecz.) ciąg | : (rzecz.) haust | : (rzecz.) łyk | : (rzecz.) podmuch | : (rzecz.) przeciąg | : (rzecz.) przewiew | : (rzecz.) rysunek | : (rzecz.) wyporność | : (rzecz.) zanurzenie
draught-bar : draught-bar : (rzecz.) sprzęg
draught-board : draught-board : (rzecz.) szachownica
draughtboard : draughtboard : (rzecz.) szachownica
draughtsman : draughtsman : (rzecz.) kamień | : (rzecz.) kreślarz | : (rzecz.) rysownik
draughtsmanship : draughtsmanship : (rzecz.) kreślarstwo
draughty : draughty : (przym.) nieszczelny | : (przym.) przewiewny
draw : draw : (czas.) czerpać | : (czas.) dobyć | : (czas.) nabrać | : (czas.) naczerpać | : (czas.) nakreślać | : (czas.) nakreślić | : (czas.) narysować | : (czas.) natoczyć | : (czas.) odsysać | : (czas.) podejmować | : (czas.) projektować | : (czas.) przyciągać | : (czas.) remisować | : (czas.) rysować | : (czas.) ssać | : (czas.) wyciągać | : (czas.) wzbudzać | : (czas.) zaciągać | : (rzecz.) ciąg | : (rzecz.) remis | : (rzecz.) rysunek | : (rzecz.) wyciąganie | : (rzecz.) wyciągnięcie | : (rzecz.) wywab
draw-twister : draw-twister : (rzecz.) skręcarka-rozciągarka
drawback : drawback : (rzecz.) brak | : (rzecz.) niedociągnięcie | : (rzecz.) przeszkoda | : (rzecz.) sztuczka | : (rzecz.) wada
drawbar : drawbar : (rzecz.) dyszel | : (rzecz.) sprzęg
drawer : drawer : (rzecz.) rysownik | : (rzecz.) szuflada | : (rzecz.) trasant | : (rzecz.) wystawca
drawing : drawing : (rzecz.) ciągnienie | : (rzecz.) fasunek | : (rzecz.) losowanie | : (rzecz.) pluskiewka | : (rzecz.) rysowanie | : (rzecz.) rysunek | : (rzecz.) zaciąganie | : (rzecz.) zredagowanie
drawing-board : drawing-board : (rzecz.) rysownica
drawing-pen : drawing-pen : (rzecz.) grafion
drawing-room : drawing-room : (rzecz.) salon
drawings : drawings : (rzecz.) rysunki
drawknife : drawknife : (rzecz.) ośnik
drawl : drawl : (czas.) cedzić | : (czas.) przeciągać | : (rzecz.) akcent | : (rzecz.) cedzenie
drawn : drawn : (czas.) zdawać | : (przym.) remisowy
dray : dray : (rzecz.) bryka | : (rzecz.) dwukółka | : (rzecz.) platforma
dread : dread : (czas.) bać | : (rzecz.) lęk | : (rzecz.) przerażenie | : (rzecz.) strach
dreadful : dreadful : (przym.) nudny | : (przym.) okropny | : (przym.) paskudny | : (przym.) straszny
dreadfully : dreadfully : (przysł.) przerażająco | : (przysł.) strasznie
dreadnought : dreadnought : (rzecz.) pancernik
dream : dream : (czas.) marzyć | : (czas.) pomarzyć | : (czas.) prześnić | : (czas.) śnić | : (czas.) uroić | : (czas.) zamarzyć | : (czas.) zaroić | : (rzecz.) marzenie | : (rzecz.) rój | : (rzecz.) sen
dreamer : dreamer : (rzecz.) fantasta | : (rzecz.) iluzjonista | : (rzecz.) marzyciel
dreamily : dreamily : (przysł.) półprzytomnie | : (przysł.) sennie
dreamlike : dreamlike : (przym.) senny | : (przym.) zjawiskowy
dreamy : dreamy : (przym.) marzycielski | : (przym.) senny
dreariness : dreariness : (rzecz.) posępność
dreary : dreary : (przym.) drętwy | : (przym.) mroczny | : (przym.) ponury | : (przym.) posępny | : (przym.) straszny
dredge : dredge : (czas.) dragować | : (czas.) wyszlamować | : (rzecz.) bagrownica | : (rzecz.) draga
dredger : dredger : (rzecz.) bagier | : (rzecz.) bagrownica | : (rzecz.) pogłębiarka
dreg : dreg : (rzecz.) osad | : (rzecz.) pozostałość
dregs : dregs : (rzecz.) fusy | : (rzecz.) męt | : (rzecz.) męty | : (rzecz.) osad
drench : drench : (czas.) moczyć | : (czas.) namoczyć | : (czas.) przemoczyć | : (czas.) zraszać | : (rzecz.) dawka
drencher : drencher : (rzecz.) zraszacz
dress : dress : (czas.) bandażować | : (czas.) odziać | : (czas.) odziewać | : (czas.) opatrywać | : (czas.) opatrzyć | : (czas.) przyrządzać | : (czas.) ubierać | : (czas.) uszlachetniać | : (rzecz.) frak | : (rzecz.) strój | : (rzecz.) sukienka | : (rzecz.) suknia | : (rzecz.) szata | : (rzecz.) ubiór | : (rzecz.) ubranie
dresser : dresser : (rzecz.) garderobiana | : (rzecz.) komoda | : (rzecz.) kredens | : (rzecz.) toaletka
dressing : dressing : (rzecz.) apretura | : (rzecz.) dekoracja | : (rzecz.) garderoba | : (rzecz.) klejonka | : (rzecz.) klepanie | : (rzecz.) nadziewanie | : (rzecz.) obrywka | : (rzecz.) opatrunek | : (rzecz.) opatrywanie | : (rzecz.) przewiązanie | : (rzecz.) przyprawa | : (rzecz.) sos | : (rzecz.) toaleta | : (rzecz.) ubieranie | : (rzecz.) uczesanie
dressing-case : dressing-case : (rzecz.) neseser
dressing-gown : dressing-gown : (rzecz.) peniuar | : (rzecz.) podomka | : (rzecz.) szlafrok
dressing-room : dressing-room : (rzecz.) przymierzalnia | : (rzecz.) szatnia | : (rzecz.) ubieralnia
dressing-table : dressing-table : (rzecz.) toaleta
dressmaker : dressmaker : (rzecz.) krawcowa | : (rzecz.) krawiec
dressmaking : dressmaking : (rzecz.) krawiectwo
dressy : dressy : (przym.) elegancki | : (przym.) szykowny | : (przym.) wytworny
drew : drew : (czas.) narysować | : (czas.) naszkicować | : (czas.) rysować | : (czas.) szkicować
dribble : dribble : (czas.) dryblować | : (czas.) kapać | : (czas.) kozłować | : (czas.) przeciekać | : (czas.) sączyć | : (rzecz.) drybling
dried : dried : (przym.) ironiczny
drier : drier : (rzecz.) suszarka | : (rzecz.) suszarnia | : (rzecz.) suszka
driest : driest : (przym.) ironiczny | : (przym.) suchy
drift : drift : (czas.) dryfować | : (czas.) nalatywać | : (czas.) nanosić | : (czas.) nieść | : (czas.) spławiać | : (czas.) sunąć | : (czas.) sypać | : (czas.) zdryfować | : (rzecz.) dążenie | : (rzecz.) dążność | : (rzecz.) dryf | : (rzecz.) dryfowanie | : (rzecz.) dryft | : (rzecz.) kontynentu | : (rzecz.) pęd | : (rzecz.) prąd | : (rzecz.) tendencja | : (rzecz.) zaspa | : (rzecz.) zawieja | : (rzecz.) znoszenie
drift-anchor : drift-anchor : (rzecz.) dryf
drift-ice : drift-ice : (rzecz.) tłuka
driftage : driftage : (rzecz.) nanos
drifter : drifter : (rzecz.) dryfter | : (rzecz.) lugier | : (rzecz.) przebijak | : (rzecz.) tułacz
drifting : drifting : (czas.) dryfować
drill : drill : (czas.) borować | : (czas.) ćwiczyć | : (czas.) drążyć | : (czas.) musztrować | : (czas.) świdrować | : (czas.) tresować | : (czas.) wiercić | : (czas.) wydrążać | : (czas.) wywiercić | : (rzecz.) ćwiczenie | : (rzecz.) drelich | : (rzecz.) dryl | : (rzecz.) musztarda | : (rzecz.) musztra | : (rzecz.) świder | : (rzecz.) wiertarka | : (rzecz.) wiertło | : (rzecz.) wiertniczy
drill-down : drill-down : (rzecz.) uszczegóławianie
drilldown : drilldown : (rzecz.) uszczegóławianie
driller : driller : (rzecz.) wiertacz | : (rzecz.) wiertarka
drilling : drilling : (rzecz.) wiercenie | : (rzecz.) wiertnictwo | : (rzecz.) wiertniczy
drillings : drillings : (przym.) zwierciny
drink : drink : (czas.) pić | : (rzecz.) napój | : (rzecz.) trunek
drinkable : drinkable : (przym.) pijalny | : (przym.) pitny | : (przym.) smaczny | : (rzecz.) napój
drinker : drinker : (rzecz.) pijak
drinking : drinking : (czas.) pijać | : (rzecz.) picie | : (rzecz.) pijaństwo
drinking-bout : drinking-bout : (rzecz.) pijatyka | : (rzecz.) popijawa
drip : drip : (czas.) cieknąć | : (czas.) kapać | : (czas.) nakapać | : (czas.) nasączać | : (czas.) ociekać | : (czas.) sączyć | : (czas.) ściekać | : (rzecz.) kapanie | : (rzecz.) kroplówka
dripping : dripping : (przym.) kapiący | : (przym.) ociekający | : (rzecz.) cieczenie | : (rzecz.) kapanie | : (rzecz.) ociekanie | : (rzecz.) ściekanie
dripstone : dripstone : (rzecz.) naciek | : (rzecz.) stalaktyt
drive : drive : (czas.) dopędzać | : (czas.) dowieźć | : (czas.) jechać | : (czas.) kierować | : (czas.) napędzać | : (czas.) obwieźć | : (czas.) odwieźć | : (czas.) podjechać | : (czas.) poganiać | : (czas.) pogrążyć | : (czas.) prowadzić | : (czas.) przepędzać | : (czas.) przypierać | : (czas.) wpędzać | : (czas.) zapędzać | : (czas.) zawieźć | : (rzecz.) aleja | : (rzecz.) determinacja | : (rzecz.) energia | : (rzecz.) jazda | : (rzecz.) napęd | : (rzecz.) napędzanie | : (rzecz.) podjazd | : (rzecz.) przejazd | : (rzecz.) przejażdżka | : (rzecz.) wjazd
drivel : drivel : (czas.) ślinić | : (rzecz.) ślina
driveller : driveller : (rzecz.) pleciuga
driver : driver : (rzecz.) kierowca | : (rzecz.) kontroler | : (rzecz.) maszynista | : (rzecz.) stangret | : (rzecz.) sterownik | : (rzecz.) szofer | : (rzecz.) woźnica | : (rzecz.) wzbudnica | : (rzecz.) zabieracz | : (rzecz.) zabierak
driveway : driveway : (rzecz.) podjazd
driving : driving : (rzecz.) jazda | : (rzecz.) prowadzenie | : (rzecz.) przejażdżka
drizzle : drizzle : (czas.) mżyć | : (czas.) siąpić | : (rzecz.) deszczyk | : (rzecz.) kapuśniak | : (rzecz.) mżawka
drizzly : drizzly : (przym.) dżdżysty
drogue : drogue : (rzecz.) dryfkotwa
droll : droll : (przym.) dziwaczny | : (przym.) ucieszny | : (przym.) zabawny | : (rzecz.) żartowniś
drollery : drollery : (rzecz.) śmiesznostka
dromedary : dromedary : (rzecz.) dromader | : (rzecz.) wielbłąd
drone : drone : (czas.) brzęczeć | : (czas.) burczeć | : (czas.) huczeć | : (czas.) szumieć | : (rzecz.) brzęk | : (rzecz.) bumelant | : (rzecz.) huk | : (rzecz.) szum | : (rzecz.) truteń | : (rzecz.) wadium | : (rzecz.) warkot
drool : drool : (czas.) bzdurzyć | : (czas.) ślinić
droop : droop : (czas.) oklapnąć | : (czas.) opadać | : (czas.) spuszczać | : (czas.) wiotczeć | : (czas.) zwisać | : (rzecz.) obwisanie | : (rzecz.) obwisłość | : (rzecz.) omdlewanie | : (rzecz.) opadanie | : (rzecz.) zwiśnięcie
droops : droops : (czas.) opadać | : (czas.) zwieszać
drop : drop : (czas.) kropić | : (czas.) obniżać | : (czas.) opadać | : (czas.) spadać | : (czas.) spuszczać | : (czas.) upadać | : (czas.) upaść | : (czas.) upuścić | : (czas.) upuszczać | : (czas.) zniżać | : (czas.) zrzucać | : (rzecz.) kropla | : (rzecz.) spadek | : (rzecz.) utrata | : (rzecz.) zrzut
drop-cap : drop-cap : (rzecz.) inicjał
droplet : droplet : (rzecz.) kropelka
dropout : dropout : (rzecz.) dziura | : (rzecz.) odszczepieniec | : (rzecz.) osoba
dropper : dropper : (rzecz.) kroplomierz | : (rzecz.) wieszak | : (rzecz.) wkraplacz | : (rzecz.) zakraplacz
droppings : droppings : (rzecz.) łajno | : (rzecz.) odchody | : (rzecz.) pomiot
dropsy : dropsy : (rzecz.) obrzęk
dross : dross : (rzecz.) wyskrobki | : (rzecz.) żużel
drought : drought : (rzecz.) posucha | : (rzecz.) susz | : (rzecz.) susza
droughts : droughts : (rzecz.) susz
drove : drove : (rzecz.) stado | : (rzecz.) trzoda
drover : drover : (rzecz.) poganiacz
drown : drown : (czas.) tonąć | : (czas.) topić | : (czas.) utonąć | : (czas.) utopić | : (czas.) zagłuszać | : (czas.) zatapiać
drowse : drowse : (czas.) drzemać | : (czas.) przedrzemać | : (rzecz.) drzemka
drowsily : drowsily : (przysł.) ospale | : (przysł.) sennie
drowsiness : drowsiness : (rzecz.) senność
drowsy : drowsy : (przym.) ospały | : (przym.) półsenny | : (przym.) senny
drub : drub : (czas.) łupić | : (czas.) młócić | : (czas.) tłuc
drubbing : drubbing : (rzecz.) cięgi | : (rzecz.) obicie
drudge : drudge : (czas.) harować | : (rzecz.) mordęga | : (rzecz.) popychadło
drudgery : drudgery : (rzecz.) dłubanina | : (rzecz.) harówka | : (rzecz.) katorga | : (rzecz.) pańszczyzna | : (rzecz.) ślęczenie | : (rzecz.) znój
drudgework : drudgework : (rzecz.) harówka
drug : drug : (czas.) ćpać | : (czas.) narkotyzować | : (rzecz.) lek | : (rzecz.) lekarstwo | : (rzecz.) narkotyk
drug-addict : drug-addict : (rzecz.) narkoman
drug-store : drug-store : (rzecz.) drogeria
druggist : druggist : (rzecz.) apteka | : (rzecz.) aptekarz | : (rzecz.) farmaceuta
drugstore : drugstore : (rzecz.) apteka | : (rzecz.) drogeria
druidic : druidic : (przym.) druidyczny
drum : drum : (czas.) bębnić | : (czas.) odbębnić | : (czas.) pobębnić | : (czas.) zabębnić | : (czas.) zjednać | : (rzecz.) bęben | : (rzecz.) bębenek | : (rzecz.) beczka | : (rzecz.) dobosz | : (rzecz.) werbel
drumbeat : drumbeat : (rzecz.) bębnienie
drummer : drummer : (rzecz.) dobosz | : (rzecz.) perkusista
drumming : drumming : (rzecz.) bębnowanie
drums : drums : (rzecz.) perkusja
drumstick : drumstick : (rzecz.) pałka | : (rzecz.) podudzie
drunk : drunk : (czas.) wypić | : (rzecz.) pijak | : (rzecz.) pijatyka | : (rzecz.) pijus | : (rzecz.) pita
drunkard : drunkard : (rzecz.) opój | : (rzecz.) pijak | : (rzecz.) pijanica
drunken : drunken : (przym.) nietrzeźwy | : (przym.) pijacki
drunkenly : drunkenly : (przysł.) pijacko
drunkenness : drunkenness : (rzecz.) opilstwo | : (rzecz.) pijaństwo
drupe : drupe : (rzecz.) pestkowiec
dry : dry : (czas.) dosuszać | : (czas.) nasuszyć | : (czas.) osuszyć | : (czas.) schnąć | : (czas.) suszyć | : (czas.) ususzyć | : (czas.) wysuszyć | : (czas.) wysychać | : (czas.) zaniemówić | : (czas.) zasuszyć | : (przym.) bezdeszczowy | : (przym.) beznamiętny | : (przym.) drętwy | : (przym.) ironiczny | : (przym.) nudny | : (przym.) suchy | : (przym.) wytrawny
dryad : dryad : (rzecz.) driada
dryer : dryer : (rzecz.) osuszacz | : (rzecz.) suszarka | : (rzecz.) suszarnia | : (rzecz.) suszka
dryly : dryly : (przysł.) oschle | : (przysł.) sucho
dryness : dryness : (rzecz.) suchość
dual : dual : (przym.) dwoisty | : (przym.) podwójny
dualism : dualism : (rzecz.) dualizm
duality : duality : (rzecz.) dualizm | : (rzecz.) dualność | : (rzecz.) dwudzielność | : (rzecz.) podwójność
dub : dub : (czas.) dubbingować | : (czas.) przezywać
dubbing : dubbing : (rzecz.) równanie | : (rzecz.) struganie
dubiety : dubiety : (rzecz.) niepewność
dubious : dubious : (przym.) niepewny | : (przym.) wątpliwy
dubiously : dubiously : (przysł.) niepewnie
dubiousness : dubiousness : (rzecz.) wątpliwość
ducal : ducal : (przym.) książęcy
ducat : ducat : (rzecz.) dukat
duchy : duchy : (rzecz.) księstwo
duck : duck : (czas.) kulić | : (czas.) pławić | : (czas.) zanurzyć | : (czas.) zginać | : (rzecz.) kaczka | : (rzecz.) kaczuszka
duck's : duck's : (przym.) kaczy
duck-weed : duck-weed : (rzecz.) rzęsa
duckbill : duckbill : (rzecz.) dziobak
duckling : duckling : (rzecz.) kaczątko | : (rzecz.) kaczuszka
duckweed : duckweed : (rzecz.) rzęsa
ducky : ducky : (rzecz.) złotko
duct : duct : (rzecz.) cewka | : (rzecz.) cło | : (rzecz.) kanał | : (rzecz.) należność | : (rzecz.) niewypał | : (rzecz.) przewód
ductile : ductile : (przym.) ciągliwy | : (przym.) posłuszny
ductility : ductility : (rzecz.) ciągliwość | : (rzecz.) kowalność | : (rzecz.) plastyczność
ducting : ducting : (przym.) przewody | : (rzecz.) kierowanie | : (rzecz.) prowadzenie
ductwork : ductwork : (przym.) przewody
dud : dud : (rzecz.) bubel | : (rzecz.) niedołęga | : (rzecz.) niewypał
dude : dude : (rzecz.) maminsynek
duds : duds : (rzecz.) manatki | : (rzecz.) ubranie
due : due : (przym.) należny | : (przym.) odpowiedni | : (przym.) planowy | : (przym.) płatny | : (przym.) stosowny | : (rzecz.) składka
duel : duel : (czas.) pojedynkować | : (rzecz.) duet | : (rzecz.) pojedynek
dues : dues : (rzecz.) należności
duet : duet : (rzecz.) duet | : (rzecz.) dukt | : (rzecz.) kanał | : (rzecz.) przewód | : (rzecz.) wentylatora
duff : duff : (przym.) bezużyteczny | : (rzecz.) dupa | : (rzecz.) siedzenie
duffer : duffer : (rzecz.) cymbał | : (rzecz.) niedojda | : (rzecz.) niezdara | : (rzecz.) niezgraba | : (rzecz.) oferma
dug-out : dug-out : (rzecz.) ziemianka
dugout : dugout : (rzecz.) wykop | : (rzecz.) ziemianka
dukedom : dukedom : (rzecz.) księstwo
dulcet : dulcet : (przym.) melodyjny | : (przym.) słodki
dull : dull : (czas.) matowieć | : (czas.) przytępiać | : (czas.) stępiać | : (czas.) stępieć | : (czas.) tępić | : (czas.) tępieć | : (czas.) zmatowieć | : (przym.) bezduszny | : (przym.) matowy | : (przym.) mętny | : (przym.) monotonny | : (przym.) mroczny | : (przym.) nieciekawy | : (przym.) niepojętny | : (przym.) nudny | : (przym.) pochmurny | : (przym.) szary | : (przym.) tępy
dullard : dullard : (rzecz.) ciemięga | : (rzecz.) głupiec | : (rzecz.) tępak
dulled : dulled : (przym.) mroczny
dullness : dullness : (rzecz.) matowość | : (rzecz.) nuda | : (rzecz.) tępość
dully : dully : (przysł.) nudno
duly : duly : (przysł.) należycie | : (przysł.) słusznie
dumb : dumb : (przym.) bezgłośny | : (przym.) durnowaty | : (przym.) durny | : (przym.) głupi | : (przym.) idiotyczny | : (przym.) niemy
dumbbell : dumbbell : (rzecz.) cążki | : (rzecz.) hantle
dumbfound : dumbfound : (czas.) ogłuszyć | : (czas.) oszałamiać | : (czas.) oszołomić
dumbfounded : dumbfounded : (czas.) zdębieć
dumbly : dumbly : (przysł.) głupio | : (przysł.) milcząco | : (przysł.) niemo
dumbness : dumbness : (rzecz.) głupek | : (rzecz.) niemota
dummy : dummy : (rzecz.) atrapa | : (rzecz.) dziadek | : (rzecz.) głupek | : (rzecz.) imitacja | : (rzecz.) kukła | : (rzecz.) makieta | : (rzecz.) manekin | : (rzecz.) marionetka | : (rzecz.) pozór | : (rzecz.) pozorowanie | : (rzecz.) smoczek | : (rzecz.) statysta | : (rzecz.) zaślepka
dump : dump : (czas.) pozbyć | : (czas.) przysypać | : (czas.) rzucać | : (czas.) rzucić | : (czas.) wyrzucać | : (czas.) zostawiać | : (czas.) zostawić | : (czas.) zrzucić | : (czas.) zsypać | : (czas.) zsypywać | : (rzecz.) hałda | : (rzecz.) kulfon | : (rzecz.) skład | : (rzecz.) śmietnik | : (rzecz.) śmietnisko | : (rzecz.) usypisko | : (rzecz.) wywrót | : (rzecz.) zrzucenie | : (rzecz.) zrzutowisko
dump-cart : dump-cart : (rzecz.) wywrotka
dumpcart : dumpcart : (rzecz.) wywrotka
dumper : dumper : (rzecz.) ciężarówka | : (rzecz.) wywrotka | : (rzecz.) wywrotnica
dumpiness : dumpiness : (rzecz.) pękatość
dumping : dumping : (rzecz.) wyrzucanie | : (rzecz.) wysypywanie
dumpling : dumpling : (rzecz.) kluska | : (rzecz.) knedel | : (rzecz.) pieróg | : (rzecz.) pyza
dumplings : dumplings : (rzecz.) knedle
dumpy : dumpy : (przym.) krępy | : (przym.) pękaty | : (przym.) przysadkowaty | : (przym.) przysadzisty
dun : dun : (czas.) molestować | : (czas.) napastować | : (przym.) ciemnobrązowy
dunce : dunce : (rzecz.) głupiec | : (rzecz.) nieuk | : (rzecz.) tępak
dunderhead : dunderhead : (rzecz.) bałwan | : (rzecz.) cymbał | : (rzecz.) tuman
dune : dune : (rzecz.) gnój | : (rzecz.) łajno | : (rzecz.) nawóz | : (rzecz.) wydma
dung : dung : (rzecz.) gnój | : (rzecz.) gnojenie | : (rzecz.) kał | : (rzecz.) łajno | : (rzecz.) nawóz | : (rzecz.) obornik | : (rzecz.) pomiot
dungaree : dungaree : (rzecz.) drelich
dungeon : dungeon : (rzecz.) baszta | : (rzecz.) ciemnica | : (rzecz.) wieża
dunghill : dunghill : (rzecz.) gnojowisko | : (rzecz.) gnojownią
dunk : dunk : (czas.) maczać
duo : duo : (rzecz.) zespół
duodecimal : duodecimal : (przym.) dwunastkowy
duodenum : duodenum : (rzecz.) dwunastnica
duologue : duologue : (rzecz.) dialog
dupe : dupe : (czas.) durzyć | : (czas.) nabierać | : (czas.) naciągać | : (czas.) oszukać | : (czas.) oszukiwać | : (czas.) otumaniać | : (rzecz.) gapa | : (rzecz.) naiwniak
duper : duper : (rzecz.) oszust
dupery : dupery : (rzecz.) naciąganie | : (rzecz.) okpienie
duple : duple : (przym.) podwójny
duplex : duplex : (przym.) dupleksowy | : (przym.) podwójny
duplicate : duplicate : (czas.) duplikować | : (czas.) kopiować | : (czas.) powielać | : (czas.) powielić | : (czas.) zdublować | : (przym.) dodatkowy | : (przym.) podwójny | : (rzecz.) duplikat | : (rzecz.) kopia | : (rzecz.) odpis | : (rzecz.) wtórnik
duplication : duplication : (rzecz.) dublowanie | : (rzecz.) duplikacja | : (rzecz.) kopiowanie | : (rzecz.) podwajanie | : (rzecz.) podwojenie | : (rzecz.) powielanie | : (rzecz.) reprodukowanie
duplications : duplications : (rzecz.) duplikacja
duplicator : duplicator : (rzecz.) kopiarka | : (rzecz.) powielacz
duplicity : duplicity : (rzecz.) dwulicowość | : (rzecz.) fałsz | : (rzecz.) obłuda
durability : durability : (rzecz.) trwałość | : (rzecz.) trwanie
durable : durable : (przym.) trwały | : (przym.) wytrzymały
duralumin : duralumin : (rzecz.) dural | : (rzecz.) duraluminium
durance : durance : (rzecz.) uwięzienie
duration : duration : (rzecz.) czasokres | : (rzecz.) obowiązywanie | : (rzecz.) trwałość | : (rzecz.) trwanie
duress : duress : (rzecz.) przymus
during : during : (przyim.) podczas | : (przyim.) przez
dusk : dusk : (rzecz.) mrok | : (rzecz.) półmrok | : (rzecz.) szarówka | : (rzecz.) zmierzch | : (rzecz.) zmrok
duskiness : duskiness : (rzecz.) śniadość
dusky : dusky : (przym.) ciemny | : (przym.) mroczny
dust : dust : (czas.) czyścić | : (czas.) kurzyć | : (czas.) napylać | : (czas.) odkurzać | : (czas.) posypać | : (czas.) przetrzepać | : (czas.) pylić | : (czas.) ścierać | : (czas.) zakurzyć | : (rzecz.) kurz | : (rzecz.) kurzawa | : (rzecz.) miał | : (rzecz.) odkurzanie | : (rzecz.) proch | : (rzecz.) pył | : (rzecz.) pylica | : (rzecz.) zapylenie
dust-bin : dust-bin : (rzecz.) kosz
dust-cart : dust-cart : (rzecz.) śmieciarka
dust-coat : dust-coat : (rzecz.) prochowiec
dust-cover : dust-cover : (rzecz.) obwoluta
dust-free : dust-free : (przym.) bezpyłowy
dust-pan : dust-pan : (rzecz.) śmietniczka
dust-proof : dust-proof : (przym.) pyłoszczelny
dustbin : dustbin : (rzecz.) kosz | : (rzecz.) śmietnik
dustcoat : dustcoat : (rzecz.) prochowiec
dustcover : dustcover : (rzecz.) obwoluta
duster : duster : (rzecz.) dupa | : (rzecz.) miotełka | : (rzecz.) odpylacz | : (rzecz.) opylacz | : (rzecz.) siedzenie
dusting : dusting : (rzecz.) kurz | : (rzecz.) napylanie | : (rzecz.) odkurzanie | : (rzecz.) okurzanie | : (rzecz.) opylanie | : (rzecz.) pudrowanie | : (rzecz.) pylenie
dustman : dustman : (rzecz.) śmieciarz
dustpan : dustpan : (rzecz.) śmietniczka | : (rzecz.) szufelka
dustproof : dustproof : (przym.) pyłoszczelny
dusty : dusty : (przym.) pylasty | : (przym.) pylisty | : (przym.) pyłowy | : (przym.) zakurzony
duteous : duteous : (przym.) obowiązkowy
dutiful : dutiful : (przym.) obowiązkowy | : (przym.) posłuszny | : (przym.) sumienny
dutifully : dutifully : (przysł.) obowiązkowo | : (przysł.) sumiennie
duty : duty : (rzecz.) cło | : (rzecz.) dług | : (rzecz.) dyżur | : (rzecz.) obciążenie | : (rzecz.) obowiązek | : (rzecz.) powinność | : (rzecz.) służba
duty-free : duty-free : (przym.) bezcłowy | : (przym.) wolnocłowy
duvet : duvet : (rzecz.) kołdra | : (rzecz.) pierzyna
dwarf : dwarf : (czas.) karłowacieć | : (czas.) ograniczać | : (czas.) pomniejszać | : (czas.) przygniatać | : (czas.) stopować | : (rzecz.) karlik | : (rzecz.) karzeł | : (rzecz.) krasnal | : (rzecz.) krasnolud | : (rzecz.) krasnoludek | : (rzecz.) niedorostek
dwarfish : dwarfish : (przym.) karzełkowaty
dwarfism : dwarfism : (rzecz.) karłowatość
dwell : dwell : (czas.) mieszkać | : (czas.) przebywać | : (czas.) rezydować | : (czas.) zamieszkiwać | : (czas.) zatrzymać
dweller : dweller : (rzecz.) mieszkaniec
dwelling : dwelling : (rzecz.) gród | : (rzecz.) mieszkanie | : (rzecz.) siedziba
dwindle : dwindle : (czas.) kurczyć | : (czas.) zanikać | : (czas.) zmniejszać
dyad : dyad : (rzecz.) dwójka | : (rzecz.) para
dyadic : dyadic : (przym.) podwójny
dye : dye : (czas.) barwić | : (czas.) farbować | : (czas.) zafarbować | : (rzecz.) barwa | : (rzecz.) barwnik | : (rzecz.) farba
dye-stuff : dye-stuff : (rzecz.) barwnik | : (rzecz.) farba
dye-works : dye-works : (rzecz.) farbiarnia
dyeing : dyeing : (rzecz.) farbiarstwo | : (rzecz.) wybarwienie
dyer : dyer : (rzecz.) farbiarz
dyestuff : dyestuff : (rzecz.) barwnik | : (rzecz.) farba
dying : dying : (rzecz.) farbowanie | : (rzecz.) umieranie | : (rzecz.) zamarcie
dyke : dyke : (czas.) otamować | : (rzecz.) rów | : (rzecz.) zapora
dynamic : dynamic : (przym.) dynamiczny | : (rzecz.) dynamizm
dynamically : dynamically : (przysł.) dynamicznie
dynamics : dynamics : (rzecz.) dynamika
dynamism : dynamism : (rzecz.) dynamiczność | : (rzecz.) dynamizm
dynamite : dynamite : (rzecz.) dynamit
dynamo : dynamo : (rzecz.) prądnica
dynamometer : dynamometer : (rzecz.) dynamometr | : (rzecz.) hamownia | : (rzecz.) siłomierz
dynast : dynast : (rzecz.) dynasta
dynastic : dynastic : (przym.) dynastyczny
dynasty : dynasty : (rzecz.) dynastia
dynatron : dynatron : (rzecz.) dynatron
dyne : dyne : (rzecz.) dyna
dynode : dynode : (rzecz.) dynoda
dysenteric : dysenteric : (przym.) biegunkowy | : (przym.) czerwonkowy | : (przym.) dyzenteryjny
dysentery : dysentery : (rzecz.) biegunka | : (rzecz.) czerwonka | : (rzecz.) dyzenteria
dysfunction : dysfunction : (rzecz.) dysfunkcja | : (rzecz.) zaburzenie
dysfunctional : dysfunctional : (przym.) patologiczny
dyslexia : dyslexia : (rzecz.) dysleksja
dyslexic : dyslexic : (przym.) dyslektyczny
dyslogistic : dyslogistic : (przym.) ujemny
dyspepsia : dyspepsia : (rzecz.) dyspensa | : (rzecz.) niestrawność
dysprosium : dysprosium : (rzecz.) dysproz
dystrophy : dystrophy : (rzecz.) dystrofia
décor : décor : (rzecz.) wykończenie | : (rzecz.) wystrój
détente : détente : (rzecz.) odprężenie
