wc : WC : (rzecz.) sanitariat | : (rzecz.) szalet
wednesday : Wednesday : (rzecz.) środa
william : William : (rzecz.) Wilhelm
wacky : wacky : (przym.) głupi | : (przym.) nieobliczalny
wad : wad : (czas.) nabijać | : (czas.) wypychać | : (czas.) zatykać | : (rzecz.) pakuły | : (rzecz.) pęk | : (rzecz.) podkład | : (rzecz.) przybitka | : (rzecz.) wata | : (rzecz.) watolina
wade : wade : (czas.) brnąć | : (czas.) brodzić | : (czas.) pluskać | : (czas.) przebrnąć | : (czas.) przedzierać
wader : wader : (rzecz.) brodziec
wafer : wafer : (rzecz.) andrut | : (rzecz.) gofr | : (rzecz.) opłatek | : (rzecz.) płytka | : (rzecz.) wafel
waffle : waffle : (czas.) ględzić | : (czas.) trajkotać | : (rzecz.) gofr | : (rzecz.) trajkotanie | : (rzecz.) wafel
waffles : waffles : (rzecz.) gofrowanie
waft : waft : (czas.) bujać | : (czas.) nieść | : (czas.) sunąć | : (czas.) unosić | : (rzecz.) podmuch | : (rzecz.) powiew | : (rzecz.) tchnienie
wag : wag : (czas.) kiwać | : (czas.) machać | : (czas.) merdać | : (czas.) poruszać | : (czas.) ruszać | : (czas.) wagarować | : (czas.) wahać | : (czas.) wywijać | : (czas.) zamachać | : (czas.) zamerdać | : (rzecz.) filut | : (rzecz.) kawalarz | : (rzecz.) kiwnięcie | : (rzecz.) kpiarz | : (rzecz.) machnięcie | : (rzecz.) poruszenie | : (rzecz.) wagarowicz | : (rzecz.) żartowniś
wage : wage : (rzecz.) pensja | : (rzecz.) zarobek | : (rzecz.) żołd
wage-earner : wage-earner : (rzecz.) pracownik
wage-earning : wage-earning : (przym.) najemny
wager : wager : (czas.) zakładać | : (rzecz.) stawka | : (rzecz.) zakład
waggish : waggish : (przym.) kpiarski | : (przym.) żartobliwy
wagon : wagon : (rzecz.) fura | : (rzecz.) furgon | : (rzecz.) wagon | : (rzecz.) wóz
wagtail : wagtail : (rzecz.) pliszka
waif : waif : (rzecz.) płacz | : (rzecz.) podrzutek | : (rzecz.) skarga
wail : wail : (czas.) płakać | : (czas.) skarżyć | : (czas.) zawodzić | : (rzecz.) płacz | : (rzecz.) płakanie | : (rzecz.) skarga | : (rzecz.) zawodzenie
wainscot : wainscot : (rzecz.) boazeria | : (rzecz.) wykładzina
wainscoting : wainscoting : (rzecz.) wykładzina
waist : waist : (rzecz.) kibić | : (rzecz.) pas | : (rzecz.) przewężenie | : (rzecz.) śródokręcie | : (rzecz.) stanik | : (rzecz.) talia
waistcoat : waistcoat : (rzecz.) bezrękawnik | : (rzecz.) kamizelka
waistline : waistline : (rzecz.) talia
wait : wait : (czas.) aktywować | : (czas.) czekać | : (czas.) doczekać | : (czas.) oczekiwać | : (czas.) odczekać | : (czas.) poczekać | : (czas.) podać | : (czas.) usługiwać | : (czas.) wyczekiwać | : (czas.) zaczekać | : (rzecz.) czat
waiter : waiter : (rzecz.) kelner | : (rzecz.) taca
waiting-room : waiting-room : (rzecz.) poczekalnia
waitress : waitress : (rzecz.) kelnerka
waive : waive : (czas.) odstąpić | : (czas.) odstępować | : (czas.) rezygnować | : (czas.) uchylić | : (czas.) zaniechać | : (czas.) zrezygnować | : (czas.) zrzekać
waiver : waiver : (rzecz.) odstąpienie | : (rzecz.) rezygnacja | : (rzecz.) uchylenie | : (rzecz.) zrzeczenie
wake : wake : (czas.) budzić | : (czas.) obudzić | : (czas.) zmartwychwstać
wakeful : wakeful : (przym.) czujny | : (przym.) czuwający
wakefulness : wakefulness : (rzecz.) bezsenność | : (rzecz.) czujność
waken : waken : (czas.) budzić | : (czas.) ożywiać | : (czas.) ożywić
wale : wale : (czas.) robić | : (rzecz.) oczep | : (rzecz.) pręga
waling : waling : (rzecz.) opinka
walk : walk : (czas.) chodzić | : (czas.) iść | : (czas.) kroczyć | : (czas.) pospacerować | : (czas.) przechodzić | : (czas.) spacerować | : (rzecz.) chód | : (rzecz.) deptak | : (rzecz.) droga | : (rzecz.) przechadzka | : (rzecz.) ścieżka | : (rzecz.) spacer | : (rzecz.) stęp | : (rzecz.) stępa | : (rzecz.) wycieczka | : (rzecz.) zawód
walk-out : walk-out : (rzecz.) strajk
walk-over : walk-over : (rzecz.) walkower
walkabout : walkabout : (rzecz.) wędrówka
walker : walker : (rzecz.) chodzik | : (rzecz.) piechur | : (rzecz.) spacerowicz | : (rzecz.) wycieczkowicz
walkers : walkers : (rzecz.) chodziarz
walkie-talkie : walkie-talkie : (rzecz.) radiotelefon
walking : walking : (rzecz.) chód | : (rzecz.) chodzenie | : (rzecz.) spacerowanie
walking-stick : walking-stick : (rzecz.) laska
walkman : walkman : (rzecz.) walkman
walkout : walkout : (rzecz.) strajk
walkover : walkover : (rzecz.) walkower
walkthrough : walkthrough : (rzecz.) przegląd
walkway : walkway : (rzecz.) chodnik | : (rzecz.) przejście
wall : wall : (czas.) omurować | : (rzecz.) mur | : (rzecz.) ściana | : (rzecz.) ścianka
wall-paper : wall-paper : (przym.) tapetowy | : (rzecz.) tapeta
wallet : wallet : (rzecz.) portfel | : (rzecz.) pugilares | : (rzecz.) teczka | : (rzecz.) torba
wallflower : wallflower : (rzecz.) strachajło
walling : walling : (rzecz.) mur | : (rzecz.) omurowanie
wallop : wallop : (czas.) bić | : (czas.) prać | : (czas.) walnąć
walloping : walloping : (czas.) dołożyć
wallow : wallow : (czas.) nurzać | : (czas.) tarzać | : (czas.) wytarzać | : (rzecz.) tarzanie
wallpaper : wallpaper : (czas.) tapetować | : (rzecz.) tapeta
wallpapering : wallpapering : (rzecz.) tapetowanie
walnut : walnut : (rzecz.) orzech
walrus : walrus : (rzecz.) mors
waltz : waltz : (rzecz.) walc
wan : wan : (przym.) blady | : (przym.) mizerny | : (przym.) nikły | : (przym.) słaby
wand : wand : (rzecz.) batuta | : (rzecz.) buława | : (rzecz.) różdżka
wander : wander : (czas.) błądzić | : (czas.) błąkać | : (czas.) przemierzać | : (czas.) tułać | : (czas.) wałęsać | : (czas.) wędrować | : (czas.) włóczyć
wanderer : wanderer : (rzecz.) tułacz | : (rzecz.) wędrowiec | : (rzecz.) wędrownik
wanderings : wanderings : (rzecz.) wędrówka
wane : wane : (czas.) słabnąć | : (czas.) zanikać | : (czas.) zmniejszać | : (rzecz.) oblina | : (rzecz.) ubycie | : (rzecz.) zanik | : (rzecz.) zmniejszanie
wangle : wangle : (czas.) kantować | : (czas.) wyłudzać | : (czas.) wyłudzić | : (czas.) wyszachrować
wanly : wanly : (przysł.) blado
want : want : (czas.) brakować | : (czas.) chcieć | : (czas.) potrzebować | : (czas.) pragnąć | : (czas.) zechcieć | : (rzecz.) bieda | : (rzecz.) brak | : (rzecz.) niedosyt | : (rzecz.) potrzeba | : (rzecz.) wanna
wanton : wanton : (przym.) grymaśny | : (przym.) nieokiełznany | : (przym.) niepotrzebny | : (przym.) psotny | : (przym.) swawolny | : (przym.) wesoły | : (przym.) złośliwy
wantonly : wantonly : (przysł.) figlarnie | : (przysł.) rozwiąźle | : (przysł.) swawolnie
war : war : (czas.) wojować | : (rzecz.) wojna
war-head : war-head : (rzecz.) głowica
warble : warble : (czas.) szczebiotać
ward : ward : (czas.) bronić | : (przym.) podopieczny | : (rzecz.) cela | : (rzecz.) dzielnica | : (rzecz.) nadzór | : (rzecz.) oddział | : (rzecz.) opieka | : (rzecz.) pupilek | : (rzecz.) sala | : (rzecz.) straż | : (rzecz.) wychowanek
warden : warden : (rzecz.) dyrektor | : (rzecz.) kurator | : (rzecz.) naczelnik | : (rzecz.) opiekun | : (rzecz.) strażnik | : (rzecz.) stróż
warder : warder : (rzecz.) dozorca | : (rzecz.) opiekun | : (rzecz.) stróż | : (rzecz.) wartownik
wardrobe : wardrobe : (rzecz.) garderoba | : (rzecz.) kostiumernia | : (rzecz.) szafa
ware : ware : (rzecz.) towar | : (rzecz.) wyrób
warehouse : warehouse : (czas.) magazynować | : (rzecz.) hurtownia | : (rzecz.) magazyn | : (rzecz.) magazynier | : (rzecz.) skład | : (rzecz.) składnica
warehouseman : warehouseman : (rzecz.) magazynier
warehousing : warehousing : (rzecz.) magazynowanie | : (rzecz.) składowanie
warfare : warfare : (rzecz.) walka | : (rzecz.) wojna | : (rzecz.) wojowanie
warhead : warhead : (rzecz.) głowica
warily : warily : (przysł.) ostrożnie | : (przysł.) przezornie
wariness : wariness : (rzecz.) nieufność | : (rzecz.) ostrożność
warlike : warlike : (przym.) bitny | : (przym.) bojowy | : (przym.) wojenny | : (przym.) wojowniczy
warlock : warlock : (rzecz.) czarownik
warm : warm : (czas.) grzać | : (czas.) nagrzewać | : (czas.) ocieplić | : (czas.) ogrzać | : (czas.) podgrzać | : (czas.) rozgrzewać | : (przym.) ciepły | : (przym.) gorliwy | : (przym.) serdeczny | : (przym.) żywy
warm-blooded : warm-blooded : (przym.) ciepłokrwisty | : (przym.) stałocieplny
warm-hearted : warm-hearted : (przym.) dobry | : (przym.) serdeczny | : (przym.) życzliwy
warm-up : warm-up : (rzecz.) rozgrzewka
warmed : warmed : (czas.) rozgrzewać
warmer : warmer : (rzecz.) ciepło
warmly : warmly : (przysł.) grubo | : (przysł.) serdecznie
warmth : warmth : (rzecz.) ciepło | : (rzecz.) gorliwość | : (rzecz.) serdeczność
warn : warn : (czas.) alarmować | : (czas.) ostrzegać | : (czas.) przezwyciężyć | : (czas.) upominać | : (czas.) uprzedzać
warned : warned : (czas.) uprzedzić
warning : warning : (rzecz.) ostrze | : (rzecz.) ostrzeganie | : (rzecz.) ostrzeżenie | : (rzecz.) przestroga | : (rzecz.) upomnienie | : (rzecz.) uprzedzenie
warningly : warningly : (przysł.) ostrzegawczo
warnings : warnings : (rzecz.) przestrzeganie
warp : warp : (czas.) marszczyć | : (czas.) paczyć | : (czas.) przekręcać | : (czas.) wyginać | : (czas.) wykręcać | : (czas.) wykrzywiać | : (czas.) wypaczać | : (rzecz.) hol | : (rzecz.) infrastruktura | : (rzecz.) nawój | : (rzecz.) osnowa | : (rzecz.) wypaczenie | : (rzecz.) zwichrowanie
warrant : warrant : (czas.) gwarantować | : (czas.) potwierdzać | : (czas.) potwierdzić | : (czas.) ręczyć | : (czas.) upewniać | : (czas.) upewnić | : (czas.) uprawniać | : (czas.) uprawnić | : (czas.) usprawiedliwiać | : (czas.) usprawiedliwić | : (czas.) zagwarantować | : (rzecz.) gwarant | : (rzecz.) nakaz | : (rzecz.) pełnomocnictwo | : (rzecz.) poręka | : (rzecz.) rękojmia | : (rzecz.) upoważnienie | : (rzecz.) uprawnienie | : (rzecz.) zabezpieczenie
warrantable : warrantable : (przym.) łowny
warrantee : warrantee : (rzecz.) poręczenie
warrantor : warrantor : (rzecz.) żyrant
warranty : warranty : (rzecz.) gwarancja | : (rzecz.) rękojmia
warren : warren : (rzecz.) królikarnia | : (rzecz.) mrowisko
warrior : warrior : (rzecz.) wojak | : (rzecz.) wojownik
warship : warship : (rzecz.) okręt
wart : wart : (rzecz.) brodawka | : (rzecz.) kurzajka | : (rzecz.) narośl
warty : warty : (przym.) brodawkowaty | : (przym.) brodawkowy
wary : wary : (przym.) czujny | : (przym.) nieufny | : (przym.) oględny | : (przym.) ostrożny | : (przym.) przezorny | : (przym.) rozważny
wash : wash : (czas.) doprać | : (czas.) myć | : (czas.) nawodnić | : (czas.) oblewać | : (czas.) obmyć | : (czas.) obmywać | : (czas.) płukać | : (czas.) pluskać | : (czas.) podmyć | : (czas.) prać | : (czas.) przemyć | : (czas.) przemywać | : (czas.) przeprać | : (czas.) umyć | : (czas.) umywać | : (czas.) uprać | : (czas.) wymyć | : (czas.) wyprać | : (czas.) zmyć | : (czas.) zmywać | : (rzecz.) myjnia | : (rzecz.) obmycie | : (rzecz.) płyn | : (rzecz.) pozłotka | : (rzecz.) przemywanie | : (rzecz.) zmywanie
wash-basin : wash-basin : (rzecz.) miednica | : (rzecz.) umywalka
wash-house : wash-house : (rzecz.) pralnia
wash-out : wash-out : (rzecz.) bankrut | : (rzecz.) klapa | : (rzecz.) pech | : (rzecz.) zmycie
wash-room : wash-room : (rzecz.) umywalnia
wash-stand : wash-stand : (rzecz.) umywalka | : (rzecz.) umywalnia
wash-tub : wash-tub : (rzecz.) balia
washable : washable : (przym.) zmywalny
washbasin : washbasin : (rzecz.) miednica | : (rzecz.) umywalka | : (rzecz.) umywalnia
washbowl : washbowl : (rzecz.) umywalka
washcloth : washcloth : (rzecz.) ścierka
washer : washer : (rzecz.) myjka | : (rzecz.) płuczka | : (rzecz.) podkładka | : (rzecz.) pomywacz | : (rzecz.) pralka | : (rzecz.) uszczelka | : (rzecz.) zmywarka
washerwoman : washerwoman : (rzecz.) praczka
washhouse : washhouse : (rzecz.) pralnia
washing : washing : (rzecz.) mycie | : (rzecz.) obmycie | : (rzecz.) obmywanie | : (rzecz.) opierunek | : (rzecz.) płukanie | : (rzecz.) pomycie | : (rzecz.) pranie | : (rzecz.) umycie | : (rzecz.) wymywanie
washing-glove : washing-glove : (rzecz.) myjka
washings : washings : (przym.) popłuczyny
washout : washout : (rzecz.) ablacja | : (rzecz.) bankrut | : (rzecz.) kasowanie | : (rzecz.) klapa | : (rzecz.) pech | : (rzecz.) podmycie | : (rzecz.) rozmycie | : (rzecz.) wymycie | : (rzecz.) wypłukanie | : (rzecz.) zmycie
washroom : washroom : (rzecz.) toaleta | : (rzecz.) umywalnia
washstand : washstand : (rzecz.) umywalka | : (rzecz.) umywalnia
washtub : washtub : (rzecz.) balia | : (rzecz.) wanna
wasp : wasp : (rzecz.) osa
waspish : waspish : (przym.) zjadliwy
wassail : wassail : (rzecz.) biesiada | : (rzecz.) toast | : (rzecz.) uczta
wastage : wastage : (rzecz.) brakoróbstwo | : (rzecz.) marnotrawstwo | : (rzecz.) marnowanie | : (rzecz.) strata | : (rzecz.) ubytek
waste : waste : (czas.) marnować | : (czas.) pustoszyć | : (czas.) roztrwonić | : (czas.) trwonić | : (czas.) wycieńczać | : (czas.) zmarnotrawić | : (czas.) zmarnować | : (przym.) bezwartościowy | : (przym.) niepotrzebny | : (przym.) odpadowy | : (przym.) pusty | : (rzecz.) bezludzie | : (rzecz.) marnotrawienie | : (rzecz.) marnotrawstwo | : (rzecz.) marnowanie | : (rzecz.) odpad | : (rzecz.) odpadek | : (rzecz.) zwietrzelina
waste-paper : waste-paper : (rzecz.) makulatura
wasteful : wasteful : (przym.) marnotrawny | : (przym.) nieekonomiczny | : (przym.) rozrzutny
wastefully : wastefully : (przysł.) marnotrawnie | : (przysł.) rozrzutnie
wastefulness : wastefulness : (rzecz.) marnotrawstwo | : (rzecz.) rozrzutność
wastepaper : wastepaper : (rzecz.) makulatura
waster : waster : (rzecz.) marnotrawca
wasting : wasting : (rzecz.) marnowanie | : (rzecz.) wychudzenie | : (rzecz.) wyniszczenie
wastrel : wastrel : (rzecz.) próżniak
watch : watch : (czas.) baczyć | : (czas.) czuwać | : (czas.) inwigilować | : (czas.) obserwować | : (czas.) oglądać | : (czas.) patrzeć | : (czas.) patrzyć | : (czas.) pilnować | : (czas.) popatrzeć | : (czas.) przyglądać | : (czas.) przypilnować | : (czas.) uważać | : (czas.) wyczekać | : (rzecz.) czatownik | : (rzecz.) czuwanie | : (rzecz.) obserwacja | : (rzecz.) obserwowanie | : (rzecz.) pilnowanie | : (rzecz.) straż | : (rzecz.) wachta | : (rzecz.) warta | : (rzecz.) zegarek
watch-chain : watch-chain : (rzecz.) dewizka
watch-maker : watch-maker : (rzecz.) zegarmistrz
watch-tower : watch-tower : (rzecz.) stanica | : (rzecz.) strażnica
watchdog : watchdog : (rzecz.) nadzór | : (rzecz.) sygnalizator
watcher : watcher : (rzecz.) obserwator | : (rzecz.) stróż
watchful : watchful : (przym.) czujny | : (przym.) uważny
watchfully : watchfully : (przysł.) czujnie
watchfulness : watchfulness : (rzecz.) czujność
watching : watching : (czas.) stróżować
watchmaker : watchmaker : (rzecz.) zegarmistrz
watchmaker's : watchmaker's : (rzecz.) zegarmistrz
watchman : watchman : (rzecz.) stróż
watchtower : watchtower : (rzecz.) stanica | : (rzecz.) strażnica
watchword : watchword : (rzecz.) dewiza | : (rzecz.) hasło
water : water : (czas.) napoić | : (czas.) podlewać | : (czas.) poić | : (czas.) polewać | : (rzecz.) nadtlenek | : (rzecz.) napój | : (rzecz.) ociekanie | : (rzecz.) podlewanie | : (rzecz.) tlenienie | : (rzecz.) woda | : (rzecz.) wóda | : (rzecz.) wodociąg
water-absorbing : water-absorbing : (przym.) wodochłonny
water-bearing : water-bearing : (przym.) wodonośny
water-bottle : water-bottle : (rzecz.) karafka | : (rzecz.) manierka
water-carrier : water-carrier : (rzecz.) nosiwoda | : (rzecz.) woziwoda
water-cart : water-cart : (rzecz.) beczkowóz
water-closet : water-closet : (rzecz.) toaleta | : (rzecz.) ubikacja
water-colour : water-colour : (rzecz.) akwarela
water-gate : water-gate : (rzecz.) śluza
water-gauge : water-gauge : (rzecz.) wodowskaz
water-hen : water-hen : (rzecz.) kokoszka
water-melon : water-melon : (rzecz.) kawon
water-meter : water-meter : (rzecz.) wodomierz
water-nymph : water-nymph : (rzecz.) rusałka
water-permeable : water-permeable : (przym.) przemakalny | : (przym.) przemakamy | : (przym.) wodoprzepuszczalny
water-repellent : water-repellent : (przym.) hydrofobowy | : (przym.) nieprzemakalny | : (przym.) wodoodporny
water-resistant : water-resistant : (przym.) wodoodporny
water-soluble : water-soluble : (przym.) rozpuszczalny
water-tight : water-tight : (przym.) wodoszczelny
watercolour : watercolour : (rzecz.) akwarela
watercolours : watercolours : (rzecz.) akwarela
watercourse : watercourse : (rzecz.) strumień
watered : watered : (czas.) podlewać
waterfall : waterfall : (rzecz.) kaskada | : (rzecz.) wodospad
waterfront : waterfront : (rzecz.) nadbrzeże
waterhole : waterhole : (rzecz.) wodopój
wateriness : wateriness : (rzecz.) wodnistość
watering-can : watering-can : (rzecz.) konewka | : (rzecz.) polewaczka
watering-place : watering-place : (rzecz.) kąpielisko | : (rzecz.) wodopój
waterless : waterless : (przym.) bezwodny
waterline : waterline : (rzecz.) waterlinia | : (rzecz.) wodnica
waterlogged : waterlogged : (przym.) namoknięty | : (przym.) podmokły
waterman : waterman : (rzecz.) przewoźnik
watermark : watermark : (rzecz.) filigran | : (rzecz.) wodowskaz
watermelon : watermelon : (rzecz.) arbuz | : (rzecz.) kawon
waterpower : waterpower : (rzecz.) hydroelektrownia
watershed : watershed : (rzecz.) wododział | : (rzecz.) zlewisko
waterside : waterside : (rzecz.) brzeg | : (rzecz.) nadbrzeże
waterspout : waterspout : (rzecz.) wodotrysk
watertight : watertight : (przym.) nieprzemakalny | : (przym.) wodoszczelny
waterworks : waterworks : (rzecz.) wodociąg | : (rzecz.) wodociągi
watery : watery : (przym.) wilgotny | : (przym.) wodnisty
watt : watt : (rzecz.) wat | : (rzecz.) wata
watt-hour : watt-hour : (rzecz.) watogodzina
watt-meter : watt-meter : (rzecz.) watomierz
watt-second : watt-second : (rzecz.) watosekunda
wattle : wattle : (rzecz.) gałązka | : (rzecz.) plecionka | : (rzecz.) pręt | : (rzecz.) wiklina
wattmeter : wattmeter : (rzecz.) watomierz
watts : watts : (rzecz.) wat
wave : wave : (czas.) falować | : (czas.) kiwać | : (czas.) machać | : (czas.) ondulować | : (czas.) pomachać | : (czas.) powiewać | : (czas.) wionąć | : (czas.) wymachiwać | : (czas.) zafalować | : (rzecz.) fala | : (rzecz.) falistość | : (rzecz.) falowanie | : (rzecz.) machanie | : (rzecz.) machnięcie | : (rzecz.) ondulacja | : (rzecz.) rzut | : (rzecz.) skinienie
wave-cut : wave-cut : (przym.) abrazyjny
wave-maker : wave-maker : (rzecz.) falownica
waveband : waveband : (rzecz.) zakres
waveform : waveform : (rzecz.) kształt
waveguide : waveguide : (rzecz.) falowód
waver : waver : (czas.) chwiać | : (czas.) wahać
waviness : waviness : (rzecz.) falistość
wavy : wavy : (przym.) falisty | : (przym.) wężykowaty | : (przym.) wężykowy
wax : wax : (czas.) nawoskować | : (czas.) pastować | : (czas.) powiększać | : (czas.) rosnąć | : (czas.) stawać | : (czas.) woskować | : (czas.) wywoskować | : (rzecz.) lak | : (rzecz.) wosk
wax-cloth : wax-cloth : (rzecz.) cerata
wax-wing : wax-wing : (rzecz.) jemiołuszka
waxen : waxen : (przym.) woskowy
waxwing : waxwing : (rzecz.) jemiołuszka
waxy : waxy : (przym.) woskowaty | : (przym.) woskowy
way : way : (rzecz.) droga | : (rzecz.) kierunek | : (rzecz.) przejście | : (rzecz.) sposób | : (rzecz.) trasa | : (rzecz.) właściwość | : (rzecz.) zwyczaj
waybill : waybill : (rzecz.) prowadnica
wayfarer : wayfarer : (rzecz.) wędrowiec
wayfaring : wayfaring : (przym.) wędrowny
waylaid : waylaid : (czas.) czaić
waylay : waylay : (czas.) czaić
wayward : wayward : (przym.) dziwaczny | : (przym.) kapryśny | : (przym.) krnąbrny | : (przym.) samowolny | : (przym.) wyrodny
weak : weak : (przym.) asteniczny | : (przym.) bezsilny | : (przym.) kiepski | : (przym.) niepełny | : (przym.) niesilny | : (przym.) niskoprocentowy | : (przym.) słaby | : (przym.) szmirowaty | : (przym.) wątły
weaken : weaken : (czas.) nadwątlić | : (czas.) osłabiać | : (czas.) osłabić | : (czas.) osłabnąć | : (czas.) rozwodnić | : (czas.) słabnąć
weakling : weakling : (rzecz.) cherlak | : (rzecz.) chuchro | : (rzecz.) mizerak | : (rzecz.) słabeusz | : (rzecz.) wymoczek | : (rzecz.) zdechlak
weakly : weakly : (przym.) słabowity
weakness : weakness : (rzecz.) cherlactwo | : (rzecz.) mazgajstwo | : (rzecz.) osłabienie | : (rzecz.) słabość | : (rzecz.) słabostka
weal : weal : (rzecz.) dobro | : (rzecz.) obrzęk | : (rzecz.) pomyślność | : (rzecz.) pręga
wealth : wealth : (rzecz.) bogactwo | : (rzecz.) dobrobyt | : (rzecz.) dostatek | : (rzecz.) obfitość | : (rzecz.) zamożność | : (rzecz.) zasobność
wealthy : wealthy : (przym.) bogaty | : (przym.) majętny | : (przym.) zamożny | : (przym.) zasobny
wean : wean : (czas.) oddalać | : (czas.) odsuwać | : (czas.) odzwyczajać
weanling : weanling : (rzecz.) dziecko
weapon : weapon : (rzecz.) broń | : (rzecz.) oręż | : (rzecz.) środek
weaponry : weaponry : (rzecz.) broń
wear : wear : (czas.) donosić | : (czas.) nieść | : (czas.) nosić | : (czas.) rozchodzić | : (czas.) ubierać | : (czas.) ubrać | : (czas.) wydeptać | : (czas.) zakładać | : (czas.) zużywać | : (rzecz.) noszenie | : (rzecz.) odzież | : (rzecz.) zużycie
weariness : weariness : (rzecz.) nuda | : (rzecz.) zmęczenie | : (rzecz.) znużenie
wearisome : wearisome : (przym.) męczący | : (przym.) nudny
wearisomely : wearisomely : (przysł.) nużąco
weary : weary : (czas.) męczyć | : (czas.) nudzić | : (czas.) nużyć | : (czas.) zatęsknić | : (czas.) znużyć
weasel : weasel : (rzecz.) łasica
weather : weather : (przym.) pogodowy | : (rzecz.) aura | : (rzecz.) pogoda | : (rzecz.) przeciwstawianie | : (rzecz.) przetrwanie | : (rzecz.) stawianie | : (rzecz.) wietrzenie | : (rzecz.) wytrzymanie
weather-chart : weather-chart : (rzecz.) mapa
weathercock : weathercock : (rzecz.) kurek | : (rzecz.) wiatrowskaz
weatherman : weatherman : (rzecz.) meteorolog | : (rzecz.) synoptyk
weatherproof : weatherproof : (przym.) wodoodporny
weave : weave : (czas.) kluczyć | : (czas.) knuć | : (czas.) pleść | : (czas.) tkać | : (czas.) wyplatać | : (czas.) wypłatać
weaver : weaver : (rzecz.) tkacz | : (rzecz.) wikłacz
web : web : (rzecz.) denko | : (rzecz.) internauta | : (rzecz.) pajęczyna | : (rzecz.) płetwa | : (rzecz.) siatka | : (rzecz.) sieć | : (rzecz.) splot | : (rzecz.) tkanina
web-footed : web-footed : (przym.) płetwonogi
webbed : webbed : (przym.) płetwonogi
webbing : webbing : (rzecz.) taśma
wed : wed : (czas.) pobierać | : (czas.) poślubiać | : (czas.) poślubić | : (czas.) zaślubić
wedding : wedding : (rzecz.) ślub | : (rzecz.) wesele | : (rzecz.) zaślubiny
wedding-ring : wedding-ring : (rzecz.) obrączka
wedge : wedge : (czas.) klinować | : (czas.) wcisnąć | : (czas.) zaklinować
wedge-shaped : wedge-shaped : (przym.) klinowaty | : (przym.) klinowy
wedlock : wedlock : (rzecz.) małżeństwo | : (rzecz.) związek
wee : wee : (przym.) drobny | : (rzecz.) chwila | : (rzecz.) chwilka | : (rzecz.) odrobina
weed : weed : (czas.) odchwaścić | : (czas.) pielić | : (czas.) pleć
weed-grown : weed-grown : (przym.) zachwaszczony
weedy : weedy : (przym.) cherlawy
week : week : (rzecz.) tydzień
week's : week's : (przym.) tygodniowy
weekend : weekend : (rzecz.) weekend
weekly : weekly : (rzecz.) tygodnik
weeks : weeks : (rzecz.) tydzień
weep : weep : (czas.) opłakiwać | : (czas.) płakać | : (czas.) szlochać | : (czas.) zapłakać
weepy : weepy : (przym.) płaczliwy
weevil : weevil : (rzecz.) ryjkowiec | : (rzecz.) słonik
weft : weft : (rzecz.) wątek
weigh : weigh : (czas.) ciążyć | : (czas.) odważyć | : (czas.) rozważać | : (czas.) ważyć | : (czas.) zważyć
weight : weight : (czas.) obciążyć | : (czas.) ważyć | : (rzecz.) brzemię | : (rzecz.) ciężar | : (rzecz.) ciężarek | : (rzecz.) gramatura | : (rzecz.) odważnik | : (rzecz.) szala | : (rzecz.) sztanga | : (rzecz.) waga
weight-lifter : weight-lifter : (rzecz.) ciężarowiec
weightiness : weightiness : (rzecz.) ciężar | : (rzecz.) doniosłość | : (rzecz.) znaczenie
weightless : weightless : (przym.) nieważki
weightlessness : weightlessness : (rzecz.) nieważkość
weightlifter : weightlifter : (rzecz.) ciężarowiec
weighty : weighty : (przym.) ciężarny | : (przym.) ciężki | : (przym.) przekonywający | : (przym.) ważny
weir : weir : (rzecz.) grobla | : (rzecz.) jaz | : (rzecz.) przelew | : (rzecz.) tama
weird : weird : (przym.) cudaczny | : (przym.) dziwaczny | : (przym.) dziwny | : (przym.) fatalny | : (przym.) niesamowity | : (przym.) przedziwny | : (przym.) upiorny
weirdly : weirdly : (przysł.) dziwacznie | : (przysł.) dziwnie
weirdness : weirdness : (rzecz.) niesamowitość
weirdo : weirdo : (rzecz.) cudak
welcome : welcome : (czas.) powitać | : (czas.) przywitać | : (czas.) witać | : (przym.) powitalny | : (rzecz.) powitanie | : (rzecz.) przywitanie
welcoming : welcoming : (przym.) powitalny
weld : weld : (czas.) łączyć | : (czas.) skuć | : (czas.) spajać | : (czas.) spawać | : (czas.) zespawać | : (czas.) zgrzewać
welded : welded : (czas.) spawać
welder : welder : (rzecz.) spawacz | : (rzecz.) spawarka | : (rzecz.) zgrzewacz | : (rzecz.) zgrzewarka
welfare : welfare : (rzecz.) dobro | : (rzecz.) dobrobyt | : (rzecz.) pomyślność | : (rzecz.) powodzenie
welkin : welkin : (rzecz.) firmament | : (rzecz.) niebo
well : well : (czas.) bić | : (czas.) tryskać | : (rzecz.) dostatecznie | : (rzecz.) studnia | : (rzecz.) studzienka | : (rzecz.) wir | : (rzecz.) źródło
well-balanced : well-balanced : (przym.) proporcjonalny
well-being : well-being : (rzecz.) dobrobyt | : (rzecz.) pomyślność | : (rzecz.) powodzenie
well-designed : well-designed : (przym.) ustawny
well-doing : well-doing : (rzecz.) prawość
well-judged : well-judged : (przym.) rozsądny | : (przym.) roztropny
well-known : well-known : (przym.) słynny
well-marked : well-marked : (przym.) wyraźny
well-nigh : well-nigh : (przysł.) nieomal | : (przysł.) prawie
well-off : well-off : (przym.) bogaty | : (przym.) zamożny
well-spring : well-spring : (rzecz.) źródło
wellbeing : wellbeing : (rzecz.) dobrobyt | : (rzecz.) pomyślność | : (rzecz.) powodzenie
welled : welled : (przym.) dobry
wellhead : wellhead : (rzecz.) źródło
wellspring : wellspring : (rzecz.) źródło
welsh : welsh : (rzecz.) walijski
welt : welt : (rzecz.) lamówka | : (rzecz.) obrzeże | : (rzecz.) ściągacz
welter : welter : (czas.) kotłować | : (czas.) pławić | : (czas.) przewalać | : (czas.) tarzać
wench : wench : (rzecz.) dziewka | : (rzecz.) dziewoja | : (rzecz.) dziewucha
wend : wend : (czas.) skierować
went : went : (czas.) pójść
wept : wept : (czas.) płakać
were : were : (czas.) być | : (przym.) były
werewolf : werewolf : (rzecz.) wilkołak
west : west : (przym.) zachodni | : (rzecz.) zachód
west-northwest : west-northwest : (przym.) zachodnio-północny
westerly : westerly : (przym.) zachodni
western : western : (przym.) zachodni | : (rzecz.) western
westward : westward : (przym.) zachodni
wet : wet : (czas.) moczyć | : (czas.) namoczyć | : (czas.) polać | : (czas.) pomoczyć | : (czas.) rozmoczyć | : (czas.) zamoczyć | : (czas.) zmoczyć | : (czas.) zwilżać | : (czas.) zwilżyć | : (przym.) deszczowy | : (przym.) dżdżysty | : (przym.) mokry | : (przym.) wilgotny
wet-nurse : wet-nurse : (rzecz.) mamka
wetly : wetly : (przysł.) mokro
wetness : wetness : (rzecz.) wilgotność
wetted : wetted : (przym.) deszczowy
wettest : wettest : (przym.) deszczowy | : (przym.) mokry
whack : whack : (czas.) bić | : (czas.) chlastać | : (czas.) grzmocić | : (czas.) kuć | : (czas.) palnąć | : (czas.) rąbać | : (czas.) walić | : (czas.) walnąć
whale : whale : (czas.) chłostać | : (czas.) zbić | : (rzecz.) wieloryb
whalebone : whalebone : (rzecz.) fiszbin
whaler : whaler : (rzecz.) wielorybnik
whaling : whaling : (przym.) wielorybniczy | : (rzecz.) wielorybnictwo
wharf : wharf : (rzecz.) brzegowe | : (rzecz.) estakada | : (rzecz.) nabrzeże | : (rzecz.) nadbrzeże | : (rzecz.) przystań | : (rzecz.) stocznia
what : what : (przym.) jaki
wheal : wheal : (rzecz.) bąbel | : (rzecz.) krostka
wheat : wheat : (rzecz.) pszenica
wheaten : wheaten : (przym.) pszeniczny | : (przym.) pszenny
wheedle : wheedle : (czas.) namawiać | : (czas.) namówić | : (czas.) przypochlebiać | : (czas.) wyjednać
wheel : wheel : (czas.) kręcić | : (czas.) przejeżdżać | : (czas.) toczyć | : (czas.) wozić | : (rzecz.) kierownica | : (rzecz.) koło | : (rzecz.) ster
wheelbarrow : wheelbarrow : (rzecz.) taczka | : (rzecz.) taczki
wheelchair : wheelchair : (rzecz.) wózek
wheeler : wheeler : (rzecz.) kołodziej
wheelhouse : wheelhouse : (rzecz.) sterówka | : (rzecz.) sterownia
wheelhouses : wheelhouses : (rzecz.) sterówka
wheelman : wheelman : (rzecz.) sternik
wheelwright : wheelwright : (rzecz.) kołodziej
wheeze : wheeze : (czas.) charczeć | : (czas.) dyszeć | : (czas.) parskać | : (czas.) rzęzić | : (czas.) sapać
wheezy : wheezy : (przym.) genialny
whelk : whelk : (rzecz.) obrzęk | : (rzecz.) pryszcz
whelm : whelm : (czas.) ogarniać | : (czas.) pochłaniać
whelp : whelp : (czas.) oszczenić
when : when : (przysł.) kiedy | : (przysł.) odkąd | : (przysł.) wtedy
whence : whence : (przysł.) skąd | : (przysł.) stamtąd
whenever : whenever : (przysł.) kiedykolwiek | : (przysł.) zawsze
where : where : (przysł.) dokąd | : (przysł.) gdzie | : (przysł.) gdziekolwiek | : (przysł.) gdzież | : (przysł.) kiedy | : (przysł.) skąd | : (przysł.) stosownie | : (przysł.) tam
whereas : whereas : (spójnik) natomiast
wherefore : wherefore : (przysł.) dlaczego | : (przysł.) dlatego
wherever : wherever : (przysł.) dokądkolwiek | : (przysł.) gdzie | : (przysł.) gdziekolwiek
whet : whet : (czas.) ostrzyć | : (czas.) podniecać | : (czas.) toczyć
whether : whether : (spójnik) czy
whetstone : whetstone : (rzecz.) osełka
whey : whey : (rzecz.) serwatka
which : which : (przym.) jaki
whichever : whichever : (przym.) którykolwiek
whiff : whiff : (rzecz.) dmuchnięcie | : (rzecz.) podmuch | : (rzecz.) powiew
whiffletree : whiffletree : (rzecz.) orczyk
while : while : (przysł.) ile | : (przysł.) wprawdzie
whilom : whilom : (przym.) były
whim : whim : (rzecz.) chętka | : (rzecz.) fanaberia | : (rzecz.) grymas | : (rzecz.) kaprys | : (rzecz.) wybryk | : (rzecz.) zachcianka
whimper : whimper : (czas.) biadolić | : (czas.) grymasić | : (czas.) jęczeć | : (czas.) kwilić | : (czas.) łkać | : (czas.) skomleć
whims : whims : (rzecz.) fanaberia
whimsical : whimsical : (przym.) cudaczny | : (przym.) dziwaczny | : (przym.) kapryśny | : (przym.) żartobliwy
whimsicality : whimsicality : (rzecz.) cudaczność | : (rzecz.) kapryśność
whimsically : whimsically : (przysł.) kapryśnie
whimsy : whimsy : (rzecz.) kaprys | : (rzecz.) urojenie
whine : whine : (czas.) biadolić | : (czas.) gwizdać | : (czas.) jęczeć | : (czas.) kwilić | : (czas.) lamentować | : (czas.) skamlać | : (czas.) skomleć | : (czas.) skowyczeć
whiner : whiner : (rzecz.) malkontent
whinny : whinny : (czas.) parskać | : (czas.) rżeć
whip : whip : (czas.) batożyć | : (czas.) bić | : (czas.) biczować | : (czas.) chłostać | : (czas.) czmychać | : (czas.) smagać | : (czas.) ubijać | : (czas.) wychłostać | : (czas.) wydrzeć | : (czas.) zacinać | : (rzecz.) bat | : (rzecz.) batog | : (rzecz.) bicie | : (rzecz.) bicz | : (rzecz.) bykowiec | : (rzecz.) nahaj | : (rzecz.) pejcz | : (rzecz.) poganiacz | : (rzecz.) woźnica
whip-round : whip-round : (rzecz.) zbiórka | : (rzecz.) zrzutka
whiplash : whiplash : (rzecz.) bicz
whippersnapper : whippersnapper : (rzecz.) impertynent | : (rzecz.) zarozumialec
whippet : whippet : (rzecz.) tankietka
whippy : whippy : (przym.) elastyczny
whir : whir : (czas.) brzęczeć
whirl : whirl : (czas.) kręcić | : (czas.) wiercić | : (czas.) wirować | : (czas.) zawirować
whirling : whirling : (czas.) zaburzyć
whirlpool : whirlpool : (rzecz.) topiel | : (rzecz.) wir
whirlwind : whirlwind : (rzecz.) wicher | : (rzecz.) wichura
whirr : whirr : (czas.) brzęczeć
whish : whish : (czas.) szeleścić | : (rzecz.) szelest
whisk : whisk : (czas.) machać | : (czas.) ubijać | : (czas.) zmiatać
whisker : whisker : (rzecz.) wąs | : (rzecz.) włos
whiskers : whiskers : (rzecz.) bokobrody | : (rzecz.) wąsy
whisky : whisky : (rzecz.) gorzałka | : (rzecz.) whisky | : (rzecz.) wódka
whisper : whisper : (czas.) szeleścić | : (czas.) szeptać | : (czas.) wyszeptać | : (czas.) zaszeptać | : (rzecz.) plotka | : (rzecz.) poszept | : (rzecz.) szepnięcie | : (rzecz.) szept | : (rzecz.) szeptanie
whist : whist : (rzecz.) wist
whistle : whistle : (czas.) gwizdać | : (czas.) pogwizdywać | : (czas.) świstać | : (czas.) świszczeć
whistleblower : whistleblower : (rzecz.) donosiciel
whistler : whistler : (rzecz.) świstak
whit : whit : (rzecz.) odrobina
white : white : (przym.) biały | : (przym.) blady | : (rzecz.) białko | : (rzecz.) białkówka | : (rzecz.) biel | : (rzecz.) pokrzewka
white-collar : white-collar : (przym.) biurowy | : (przym.) umysłowy
white-livered : white-livered : (przym.) bojaźliwy | : (przym.) tchórzliwy
white-throat : white-throat : (rzecz.) gajówka
whitely : whitely : (przysł.) biało
whiten : whiten : (czas.) bieleć | : (czas.) bielić | : (czas.) wybielać | : (czas.) wybieleć | : (czas.) wybielić | : (czas.) zbieleć
whiteness : whiteness : (rzecz.) białość | : (rzecz.) biel
whiteout : whiteout : (czas.) sadzać | : (czas.) sadzić
whitesmith : whitesmith : (rzecz.) blacharz | : (rzecz.) pobielacz
whitethroat : whitethroat : (rzecz.) gajówka
whitewash : whitewash : (czas.) bielić | : (czas.) obielić | : (czas.) pobielić | : (czas.) wapnować | : (czas.) wybielać
whitey : whitey : (rzecz.) blondyn
whither : whither : (przysł.) dokąd
whithersoever : whithersoever : (przysł.) dokądkolwiek
whiting : whiting : (rzecz.) bielenie | : (rzecz.) bielidło
whitish : whitish : (przym.) białawy
whitleather : whitleather : (rzecz.) ircha
whitlow : whitlow : (rzecz.) zanokcica
whittle : whittle : (czas.) ostrzyć | : (czas.) strugać
whiz : whiz : (czas.) brzęczeć | : (czas.) świszczeć | : (czas.) zaświstać
whodunit : whodunit : (rzecz.) kryminał | : (rzecz.) opowiadanie
whole : whole : (przym.) całkowity | : (przym.) cały | : (rzecz.) całokształt | : (rzecz.) całość
whole-hearted : whole-hearted : (przym.) serdeczny
whole-meal : whole-meal : (przym.) razowy
wholehearted : wholehearted : (przym.) całkowity | : (przym.) energiczny | : (przym.) serdeczny
wholeness : wholeness : (rzecz.) całkowitość | : (rzecz.) zupełność
wholesale : wholesale : (przym.) hurtowy | : (rzecz.) hurt | : (rzecz.) hurtownia
wholesaler : wholesaler : (rzecz.) hurtownia | : (rzecz.) hurtownik
wholesalers : wholesalers : (rzecz.) hurtownia
wholesome : wholesome : (przym.) zdrowotny | : (przym.) zdrowy
wholesomeness : wholesomeness : (rzecz.) pożywność
wholly : wholly : (przysł.) całkowicie | : (przysł.) interaktywnie | : (przysł.) zupełnie
whoop : whoop : (czas.) kaszlać | : (czas.) krzyczeć | : (czas.) wykrzykiwać
whooper : whooper : (przym.) ogromny
whooping-cough : whooping-cough : (rzecz.) koklusz
whoosh : whoosh : (rzecz.) świst
whop : whop : (czas.) ciskać | : (czas.) lać | : (czas.) prać | : (czas.) spaść | : (czas.) zakasować
whopper : whopper : (rzecz.) kolos | : (rzecz.) olbrzym
whore : whore : (rzecz.) dziewka | : (rzecz.) dziwka | : (rzecz.) jędza | : (rzecz.) ladacznica | : (rzecz.) prostytutka
whorl : whorl : (rzecz.) baldaszek | : (rzecz.) skręt | : (rzecz.) zwój
whortleberry : whortleberry : (rzecz.) borowina | : (rzecz.) czernica
wick : wick : (rzecz.) knot
wicked : wicked : (przym.) bezbożny | : (przym.) bezecny | : (przym.) haniebny | : (przym.) niedobry | : (przym.) niegodziwy | : (przym.) niepoczciwy | : (przym.) nikczemny | : (przym.) podły | : (przym.) występny | : (przym.) zły
wickedness : wickedness : (rzecz.) niegodziwość | : (rzecz.) perfidia | : (rzecz.) zdrożność
wicker : wicker : (przym.) koszykowy | : (przym.) plecionkowy | : (przym.) wikliniarski | : (przym.) wiklinowy | : (rzecz.) wiklinawicker
wicker-work : wicker-work : (rzecz.) koszykarstwo
wickerwork : wickerwork : (rzecz.) wiklina
wicket : wicket : (rzecz.) bramka | : (rzecz.) furta | : (rzecz.) furtka
wide : wide : (przym.) obszerny | : (przym.) ogólnokrajowy | : (przym.) rozległy | : (przym.) szeroki
wide-angle : wide-angle : (przym.) szerokokątny
wide-eyed : wide-eyed : (przym.) łatwowierny | : (przym.) naiwny
widely : widely : (przysł.) szeroko | : (przysł.) znacznie
widen : widen : (czas.) poszerzać | : (czas.) poszerzyć | : (czas.) rozszerzać | : (czas.) rozszerzyć
wider : wider : (przym.) szeroki
widescreen : widescreen : (przym.) panoramiczny | : (przym.) szerokoekranowy
widespread : widespread : (przym.) rozległy | : (przym.) rozpowszechniony
widget : widget : (rzecz.) wiercipięta
widow : widow : (rzecz.) wdowa | : (rzecz.) wdówka
widow-bird : widow-bird : (rzecz.) tkacz
widower : widower : (rzecz.) wdowiec
widowhood : widowhood : (rzecz.) wdowieństwo
width : width : (rzecz.) rozpiętość | : (rzecz.) rozstęp | : (rzecz.) szerokość
wield : wield : (czas.) dzierżyć | : (czas.) władać
wiener : wiener : (rzecz.) kiełbaska | : (rzecz.) parówka
wife : wife : (rzecz.) kobiecina | : (rzecz.) kumoszka | : (rzecz.) żona
wifely : wifely : (przym.) małżeński
wig : wig : (rzecz.) peruka
wigging : wigging : (rzecz.) bura
wiggly : wiggly : (przym.) falisty
wigwag : wigwag : (czas.) sygnalizować
wigwam : wigwam : (rzecz.) szałas
wild : wild : (przym.) burzliwy | : (przym.) dziki | : (przym.) fantastyczny | : (przym.) gwałtowny | : (przym.) pustynny | : (przym.) straszny | : (rzecz.) dzik | : (rzecz.) dzikie | : (rzecz.) poziomka | : (rzecz.) pustkowie | : (rzecz.) puszcza | : (rzecz.) wyobraźnia
wild-cat : wild-cat : (przym.) fantastyczny
wild-goose : wild-goose : (przym.) ryzykowny
wildcard : wildcard : (przym.) wieloznaczny | : (rzecz.) wieloznacznik
wildcat : wildcat : (przym.) dziki
wilderness : wilderness : (rzecz.) bezludzie | : (rzecz.) dzicz | : (rzecz.) odludzie | : (rzecz.) pustkowie | : (rzecz.) pustynia | : (rzecz.) puszcza
wildfire : wildfire : (czas.) rozprzestrzeniać
wilding : wilding : (rzecz.) dziczka
wildlife : wildlife : (rzecz.) przyroda
wildly : wildly : (przysł.) burzliwie | : (przysł.) dziko | : (przysł.) ogromnie | : (przysł.) szalenie
wildness : wildness : (rzecz.) dzikość | : (rzecz.) płochliwość | : (rzecz.) rozwydrzenie | : (rzecz.) szał | : (rzecz.) zdziczenie
wile : wile : (rzecz.) fortel | : (rzecz.) podstęp | : (rzecz.) szelmostwo
wilful : wilful : (przym.) celowy | : (przym.) rozmyślny | : (przym.) samowolny | : (przym.) świadomy | : (przym.) umyślny | : (przym.) uparty
wilfulness : wilfulness : (rzecz.) samowolność
wiliness : wiliness : (rzecz.) chytrość | : (rzecz.) podstępność
will : will : (czas.) być | : (czas.) chcieć | : (rzecz.) chęć | : (rzecz.) przyzwyczajenie | : (rzecz.) wola | : (rzecz.) życzenie
willingly : willingly : (przysł.) chętnie | : (przysł.) ochoczo | : (przysł.) skwapliwie
willingness : willingness : (rzecz.) chęć | : (rzecz.) gotowość | : (rzecz.) ochota | : (rzecz.) zgoda
willow : willow : (rzecz.) kleparka | : (rzecz.) wierzba
willowy : willowy : (przym.) giętki | : (przym.) smukły | : (przym.) wierzbowaty | : (przym.) wierzbowy
wilt : wilt : (czas.) oklapnąć | : (czas.) więdnąć | : (czas.) zmarnieć | : (czas.) zmizernieć
wily : wily : (przym.) chytry | : (przym.) podstępny
wimble : wimble : (rzecz.) świder
wimp : wimp : (rzecz.) mięczak | : (rzecz.) nudziarz | : (rzecz.) sztywniak
wimple : wimple : (rzecz.) zakręt
win : win : (czas.) dosięgać | : (czas.) hołubić | : (czas.) ograć | : (czas.) urabiać | : (czas.) wygrać | : (czas.) wygrywać | : (czas.) wywalczyć | : (czas.) zarabiać | : (czas.) zaskarbić | : (czas.) zdobywać | : (czas.) zjednywać | : (czas.) zwyciężać | : (czas.) zwyciężyć | : (rzecz.) wygrana | : (rzecz.) wygranie | : (rzecz.) wygrywanie | : (rzecz.) zwycięstwo
wince : wince : (czas.) cofać | : (czas.) drgać | : (czas.) upadać
wind : wind : (czas.) nakręcać | : (czas.) nakręcić | : (czas.) namotać | : (czas.) nawijać | : (czas.) obwijać | : (czas.) oplatać | : (czas.) zwietrzyć | : (rzecz.) dech | : (rzecz.) dmuch | : (rzecz.) wiatr | : (rzecz.) wicher
wind-gauge : wind-gauge : (rzecz.) anemometr | : (rzecz.) wiatromierz
wind-stick : wind-stick : (rzecz.) śmigło
windbag : windbag : (rzecz.) gaduła
windbreak : windbreak : (rzecz.) wiatrochron
windbreaker : windbreaker : (rzecz.) wiatrochron
windcheater : windcheater : (rzecz.) wiatrówka
winder : winder : (rzecz.) nawijacz | : (rzecz.) nawijarka | : (rzecz.) przewijarka | : (rzecz.) zwijarka
windfall : windfall : (rzecz.) fuks | : (rzecz.) gratka | : (rzecz.) spad
windings : windings : (rzecz.) meander
windlass : windlass : (rzecz.) kołowrót | : (rzecz.) korba
windless : windless : (przym.) bezwietrzny
windmill : windmill : (rzecz.) wiatrak
window : window : (rzecz.) okienko | : (rzecz.) okno | : (rzecz.) szyba | : (rzecz.) windowanie | : (rzecz.) witryna | : (rzecz.) wziernik
window-blind : window-blind : (rzecz.) roleta | : (rzecz.) żaluzja
window-pane : window-pane : (rzecz.) szyba
windowing : windowing : (rzecz.) okienkowanie | : (rzecz.) polegając
windowpane : windowpane : (rzecz.) szyba
windowsill : windowsill : (rzecz.) parapet | : (rzecz.) podokiennik
windpipe : windpipe : (rzecz.) tchawica
windrow : windrow : (rzecz.) pokos
windscreen : windscreen : (rzecz.) wiatrochron
windshield : windshield : (rzecz.) wiatrochron
windstorm : windstorm : (rzecz.) wicher | : (rzecz.) wichura
windsurfing : windsurfing : (rzecz.) windsurfing
windswept : windswept : (przym.) wietrzny
windy : windy : (przym.) gadatliwy | : (przym.) niepoważny | : (przym.) wietrzny
wine : wine : (rzecz.) wina | : (rzecz.) winiarnia | : (rzecz.) winiarstwo | : (rzecz.) wino
wine-glass : wine-glass : (rzecz.) kieliszek
wine-making : wine-making : (rzecz.) winiarstwo
wine-shop : wine-shop : (rzecz.) winiarnia
wineglass : wineglass : (rzecz.) kieliszek
winemaking : winemaking : (rzecz.) winiarstwo
winery : winery : (rzecz.) winiarnia | : (rzecz.) winnica
wing : wing : (rzecz.) błotnik | : (rzecz.) skrzydełko | : (rzecz.) skrzydło
wingless : wingless : (przym.) bezskrzydły
wink : wink : (czas.) migać | : (czas.) mrugać | : (czas.) skinąć | : (czas.) zamigotać
winkle : winkle : (czas.) usuwać | : (czas.) wyrzucać
winner : winner : (rzecz.) laureat | : (rzecz.) zdobywca | : (rzecz.) zdobywczyni | : (rzecz.) zwycięzca | : (rzecz.) zwyciężczyni
winningly : winningly : (przysł.) zwycięsko
winnings : winnings : (rzecz.) wygrana
winnow : winnow : (czas.) przebierać | : (czas.) przesiewać | : (czas.) przewiać | : (czas.) wiać
winnower : winnower : (rzecz.) młynek | : (rzecz.) wialnia
wino : wino : (rzecz.) oliwa
winsome : winsome : (przym.) uroczy
winter : winter : (czas.) przezimować | : (czas.) zimować | : (rzecz.) zima | : (rzecz.) zimowanie
winterizing : winterizing : (rzecz.) wymrażanie
wintry : wintry : (przym.) lodowaty | : (przym.) zimny | : (przym.) zimowy
winy : winy : (przym.) winny
wipe : wipe : (czas.) obcierać | : (czas.) obetrzeć | : (czas.) ocierać | : (czas.) podcierać | : (czas.) pościerać | : (czas.) ścierać | : (czas.) uderzyć | : (czas.) wycierać | : (czas.) wytrzeć | : (czas.) zetrzeć
wipe-out : wipe-out : (rzecz.) zagłuszanie
wiper : wiper : (rzecz.) ścierka | : (rzecz.) wycieraczka
wipers : wipers : (rzecz.) wycieraczki
wire : wire : (czas.) drutować | : (czas.) telegrafować | : (czas.) zadepeszować | : (czas.) zadrutować | : (czas.) zatelegrafować | : (rzecz.) depesza | : (rzecz.) drut | : (rzecz.) kabel | : (rzecz.) przewód
wire-haired : wire-haired : (przym.) ostrowłosy | : (przym.) szorstkowłosy
wire-rope : wire-rope : (rzecz.) kabel
wired-in : wired-in : (przym.) układowy
wiredrawer : wiredrawer : (rzecz.) druciarz
wirehaired : wirehaired : (przym.) ostrowłosy | : (przym.) szorstkowłosy
wireless : wireless : (przym.) bezdrutowy | : (przym.) bezprzewodowy | : (przym.) radiowy
wireman : wireman : (rzecz.) elektromonter | : (rzecz.) monter-instalator
wiretap : wiretap : (czas.) podsłuchiwać | : (rzecz.) podsłuch
wiretapping : wiretapping : (rzecz.) podpięcie | : (rzecz.) podsłuch
wiry : wiry : (przym.) druciany | : (przym.) muskularny | : (przym.) silny | : (przym.) żylasty
wisdom : wisdom : (rzecz.) mądrość | : (rzecz.) sens
wise : wise : (przym.) mądry | : (przym.) roztropny | : (przym.) rozumny | : (rzecz.) sposób
wiseacre : wiseacre : (rzecz.) mądrala | : (rzecz.) mędrek
wisely : wisely : (przysł.) mądrze | : (przysł.) przezornie
wish : wish : (czas.) chcieć | : (czas.) pragnąć | : (czas.) zachcieć | : (czas.) żałować | : (czas.) życzyć | : (rzecz.) chęć | : (rzecz.) pragnienie | : (rzecz.) szkoda | : (rzecz.) życzenie
wish-wash : wish-wash : (rzecz.) lura
wisher : wisher : (rzecz.) sympatyk
wishful : wishful : (przym.) życzeniowy
wishy-washy : wishy-washy : (przym.) chwiejny | : (przym.) niejasny | : (przym.) wodnisty
wisp : wisp : (rzecz.) kosmyk | : (rzecz.) miotełka | : (rzecz.) powrósło | : (rzecz.) wiązka | : (rzecz.) wiecheć | : (rzecz.) wstęga
wispy : wispy : (przym.) cienki | : (przym.) drobny | : (przym.) wątły
wistful : wistful : (przym.) poważny | : (przym.) rzewny | : (przym.) smutny | : (przym.) tęskniący | : (przym.) tęskny | : (przym.) zadumany
wistfulness : wistfulness : (rzecz.) zaduma
wit : wit : (rzecz.) dowcip | : (rzecz.) dowcipniś | : (rzecz.) inteligencja | : (rzecz.) rozum
witch : witch : (rzecz.) czarownica | : (rzecz.) jędza | : (rzecz.) wiedźma
witchcraft : witchcraft : (rzecz.) czar | : (rzecz.) czary
witchdoctor : witchdoctor : (rzecz.) czarownik | : (rzecz.) znachor
witchery : witchery : (rzecz.) czar
with : with : (przyim.) mimo | : (przyim.) przy | : (przyim.) u | : (przyim.) z | : (przyim.) ze
withdraw : withdraw : (czas.) odsuwać | : (czas.) odwoływać | : (czas.) usuwać | : (czas.) wycofać | : (czas.) wycofywać
withdrawal : withdrawal : (rzecz.) cofnięcie | : (rzecz.) odwołanie | : (rzecz.) odwrót | : (rzecz.) podjęcie | : (rzecz.) wycofanie | : (rzecz.) wycofywanie | : (rzecz.) wypłacenie
wither : wither : (czas.) suszyć | : (czas.) usychać | : (czas.) uwiędnąć | : (czas.) więdnąć | : (czas.) zamierać | : (czas.) zwiędnąć
withers : withers : (rzecz.) uschnięcie
withhold : withhold : (czas.) odmówić | : (czas.) wstrzymać | : (czas.) wstrzymywać | : (czas.) zatrzymać
within : within : (przyim.) w | : (przysł.) wewnątrz
without : without : (przysł.) nie | : (przysł.) śmiało
withstand : withstand : (czas.) opierać | : (czas.) oponować | : (czas.) powstrzymywać | : (czas.) przeciwstawiać | : (czas.) wytrzymać | : (czas.) wytrzymywać
withstood : withstood : (czas.) opierać
withy : withy : (rzecz.) łoza | : (rzecz.) łozina
witlessly : witlessly : (przysł.) nierozsądnie
witling : witling : (rzecz.) dowcipniś
witness : witness : (czas.) świadczyć | : (rzecz.) poświadczenie | : (rzecz.) świadectwo | : (rzecz.) świadek | : (rzecz.) zeznanie
wits : wits : (rzecz.) zdolności
witticism : witticism : (rzecz.) dowcip
wittily : wittily : (przysł.) dowcipnie | : (przysł.) sprytnie
witty : witty : (przym.) błyskotliwy | : (przym.) bystry | : (przym.) dowcipny
wiz : wiz : (rzecz.) znawca
wizard : wizard : (rzecz.) cudotwórca | : (rzecz.) czarnoksiężnik | : (rzecz.) czarodziej | : (rzecz.) guślarz | : (rzecz.) kreator | : (rzecz.) zaklinacz
wobble : wobble : (czas.) chwiać | : (czas.) chybotać | : (czas.) kiwać | : (czas.) trząść
woe : woe : (rzecz.) biadanie | : (rzecz.) cierpienie | : (rzecz.) nieszczęście | : (rzecz.) żałość
woebegone : woebegone : (przym.) boleściwy
woeful : woeful : (przym.) smutny
woefully : woefully : (przysł.) przygnębiająco
woks : woks : (przym.) woskowy
wolf : wolf : (rzecz.) kobieciarz | : (rzecz.) wilk
wolf's : wolf's : (przym.) wilczy
wolfish : wolfish : (przym.) wilczy
wolfram : wolfram : (rzecz.) wolfram
wolverine : wolverine : (rzecz.) rosomak
woman : woman : (rzecz.) baba | : (rzecz.) białogłowa | : (rzecz.) jejmość | : (rzecz.) kobiecina | : (rzecz.) kobieta | : (rzecz.) niewiasta
woman's : woman's : (przym.) babski
woman-hater : woman-hater : (rzecz.) antyfeminista
womanhood : womanhood : (rzecz.) dojrzałość | : (rzecz.) kobiecość | : (rzecz.) kobiety
womaniser : womaniser : (rzecz.) bawidamek
womanish : womanish : (przym.) kobiecy | : (przym.) zniewieściały
womanizer : womanizer : (rzecz.) babiarz | : (rzecz.) kobieciarz
womankind : womankind : (rzecz.) kobiety
womanliness : womanliness : (rzecz.) kobiecość
womanly : womanly : (przym.) babski | : (przym.) kobiecy | : (przym.) niewieści
womb : womb : (rzecz.) łono | : (rzecz.) macica | : (rzecz.) żywot
women : women : (rzecz.) kobieta
womenfolk : womenfolk : (rzecz.) kobiety
wonder : wonder : (czas.) dziwić | : (czas.) zastanawiać | : (czas.) zastanowić
wonderful : wonderful : (przym.) cudowny | : (przym.) wspaniały
wonderfully : wonderfully : (przysł.) cudownie | : (przysł.) niezwykle
wonderment : wonderment : (rzecz.) zdumienie | : (rzecz.) zdziwienie
wondrous : wondrous : (przym.) cudowny | : (przym.) niezwykły
wont : wont : (rzecz.) przyzwyczajenie | : (rzecz.) zwyczaj
wonted : wonted : (przym.) przyzwyczajony | : (przym.) zwyczajny | : (przym.) zwyczajowy
woo : woo : (czas.) pozyskiwać | : (czas.) starać | : (czas.) uwodzić | : (czas.) zalecać
wood : wood : (rzecz.) drewno | : (rzecz.) drzewo | : (rzecz.) drzeworytnik | : (rzecz.) las | : (rzecz.) lasek | : (rzecz.) opał | : (rzecz.) zagajnik
wood-carving : wood-carving : (rzecz.) drzeworytnictwo
wood-engraving : wood-engraving : (rzecz.) drzeworytnictwo
wood-shed : wood-shed : (rzecz.) drewutnia | : (rzecz.) drwalnia
wood-worker : wood-worker : (rzecz.) cieśla
woodbine : woodbine : (rzecz.) wiciokrzew
woodcarving : woodcarving : (rzecz.) drzeworytnictwo
woodchuck : woodchuck : (rzecz.) świstak
woodcock : woodcock : (rzecz.) bekas
woodcraftsman : woodcraftsman : (rzecz.) traper
woodcut : woodcut : (rzecz.) drzeworyt
woodcutter : woodcutter : (rzecz.) drwal | : (rzecz.) drzeworytnik
wooded : wooded : (przym.) lesisty
wooden : wooden : (przym.) drewniany | : (przym.) tępy
woodenly : woodenly : (przym.) drewniany | : (przysł.) sztywno
woodland : woodland : (rzecz.) lasy
woodlice : woodlice : (rzecz.) stonoga
woodman : woodman : (rzecz.) drwal | : (rzecz.) leśnik
woodpecker : woodpecker : (rzecz.) dzięcioł
woodsman : woodsman : (rzecz.) leśnik
woodsy : woodsy : (przym.) leśny
woodwork : woodwork : (rzecz.) część | : (rzecz.) stolarka
woodworker : woodworker : (rzecz.) cieśla
woodworking : woodworking : (przym.) stolarski | : (rzecz.) drewno | : (rzecz.) stolarka | : (rzecz.) stolarstwo
woodworm : woodworm : (rzecz.) czerw | : (rzecz.) kornik
woody : woody : (przym.) drewniany | : (przym.) drzewiasty | : (przym.) drzewny | : (przym.) lesisty | : (przym.) leśny
wooer : wooer : (rzecz.) zalotnik
woof : woof : (rzecz.) wątek
wool : wool : (rzecz.) dywan | : (rzecz.) wełna
wool-gathering : wool-gathering : (rzecz.) gapiostwo | : (rzecz.) marzycielstwo | : (rzecz.) rozmarzenie | : (rzecz.) zamyślenie
wool-like : wool-like : (przym.) wełnopodobny
woollen : woollen : (przym.) wełniany
woolliness : woolliness : (rzecz.) wełnistość
woolly : woolly : (przym.) kędzierzawy | : (przym.) mętny | : (przym.) wełnisty
word : word : (czas.) wysławiać | : (czas.) wysłowić | : (rzecz.) rozkaz | : (rzecz.) słówko | : (rzecz.) słowo | : (rzecz.) słowotwórstwo | : (rzecz.) twierdzenie | : (rzecz.) wiadomość | : (rzecz.) wyraz
wordily : wordily : (przysł.) rozwlekle
wordiness : wordiness : (rzecz.) gadatliwość | : (rzecz.) wielosłowie | : (rzecz.) wodolejstwo
wordless : wordless : (przym.) bezsłowny | : (przym.) cichy | : (przym.) niemy
wordlessly : wordlessly : (przysł.) bezsłownie
wordy : wordy : (przym.) słowny | : (przym.) wielosłowny
work : work : (rzecz.) koszykarstwo | : (czas.) działać | : (czas.) obrabiać | : (czas.) obrobić | : (czas.) obsługiwać | : (czas.) prać | : (czas.) pracować | : (czas.) robić | : (czas.) współpracować | : (rzecz.) dzieło | : (rzecz.) godzenie | : (rzecz.) praca | : (rzecz.) twórczość | : (rzecz.) utwór | : (rzecz.) zajęcie
work-around : work-around : (rzecz.) obejście
workability : workability : (rzecz.) obrabialność
workable : workable : (przym.) obrabialny | : (przym.) rentowny | : (przym.) urabialny | : (przym.) wykonalny | : (przym.) wykonywalny
workaday : workaday : (przym.) codzienny | : (przym.) roboczy
workaholic : workaholic : (rzecz.) pracoholik
workaround : workaround : (czas.) obejść | : (rzecz.) obejście
workbench : workbench : (rzecz.) stół
workbook : workbook : (rzecz.) dziennik | : (rzecz.) skoroszyt | : (rzecz.) zeszyt
worked : worked : (czas.) przepracować
worker : worker : (rzecz.) hutnik | : (rzecz.) pracownik | : (rzecz.) robotnik
workers' : workers' : (przym.) pracowniczy
workgroup : workgroup : (rzecz.) zespół
workhouse : workhouse : (rzecz.) przytułek | : (rzecz.) warsztat
workingman : workingman : (rzecz.) robotnik
workload : workload : (rzecz.) obciążenie
workman : workman : (rzecz.) pracownik | : (rzecz.) robotnik | : (rzecz.) wyrobnik
workmanship : workmanship : (rzecz.) dzieło | : (rzecz.) fachowość | : (rzecz.) sztuka | : (rzecz.) wykonanie | : (rzecz.) wyrób | : (rzecz.) zręczność
workmate : workmate : (rzecz.) kolega
workout : workout : (rzecz.) zaprawa
workroom : workroom : (rzecz.) pracownia
workshop : workshop : (rzecz.) hala | : (rzecz.) manufaktura | : (rzecz.) pracownia | : (rzecz.) warsztat | : (rzecz.) zakład
workstation : workstation : (rzecz.) terminal
workwoman : workwoman : (rzecz.) pracownica | : (rzecz.) robotnica
world : world : (rzecz.) świat | : (rzecz.) światek | : (rzecz.) wiata | : (rzecz.) ziemia
world-wide : world-wide : (przym.) ogólnoświatowy | : (przym.) światowy
worldliness : worldliness : (rzecz.) światowość | : (rzecz.) ziemskość
worldly : worldly : (przym.) doczesny | : (przym.) światowy | : (przym.) świecki | : (przym.) ziemski
worldwide : worldwide : (przym.) ogólnoświatowy | : (przym.) światowy
worm : worm : (rzecz.) czerw | : (rzecz.) robak | : (rzecz.) ślimak | : (rzecz.) wirus
worm-eaten : worm-eaten : (przym.) robaczywy
wormwood : wormwood : (rzecz.) piołun | : (rzecz.) przykrość
wormy : wormy : (przym.) robaczywy
worn : worn : (przym.) wytarty
worrier : worrier : (przym.) dokuczliwy | : (rzecz.) zmartwienie
worrisome : worrisome : (przym.) kłopotliwy
worry : worry : (czas.) doskwierać | : (czas.) dręczyć | : (czas.) gnębić | : (czas.) kłopotać | : (czas.) martwić | : (czas.) niepokoić | : (czas.) troskać | : (czas.) zaniepokoić | : (czas.) zmartwić | : (rzecz.) frasunek | : (rzecz.) niepokój | : (rzecz.) strapienie | : (rzecz.) troska | : (rzecz.) zgryzota | : (rzecz.) zmartwienie
worse : worse : (rzecz.) zły
worsen : worsen : (czas.) pogarszać | : (czas.) pogorszyć
worship : worship : (czas.) czcić | : (czas.) ubóstwiać | : (czas.) uwielbiać | : (czas.) wielbić
worshipful : worshipful : (przym.) czcigodny
worshipfulness : worshipfulness : (rzecz.) uwielbienie
worshiping : worshiping : (rzecz.) czczenie
worshipper : worshipper : (rzecz.) czciciel
worth : worth : (rzecz.) cena | : (rzecz.) warta | : (rzecz.) wartość
worthily : worthily : (przysł.) godnie
worthiness : worthiness : (rzecz.) wartość
worthless : worthless : (przym.) bezwartościowy | : (przym.) kiczowaty | : (przym.) niewart
worthlessness : worthlessness : (rzecz.) bezwartościowość
worthwhile : worthwhile : (przym.) wartościowy
worthy : worthy : (przym.) czcigodny | : (przym.) godny | : (przym.) godzien | : (przym.) przezacny | : (przym.) wartościowy | : (przym.) zbożny
would-be : would-be : (przym.) potencjalny | : (przym.) przyszły | : (przym.) rzekomy
wound : wound : (czas.) podstrzelić | : (czas.) ranić | : (czas.) zranić | : (rzecz.) okaleczenie | : (rzecz.) postrzał | : (rzecz.) rana
woundwort : woundwort : (rzecz.) przelot
woven : woven : (czas.) pleść
wow : wow : (rzecz.) kołysanie | : (rzecz.) podziw
wrack : wrack : (rzecz.) rozbicie | : (rzecz.) ruina | : (rzecz.) wrak
wraith : wraith : (rzecz.) zjawa
wrangle : wrangle : (czas.) pokłócić | : (czas.) spierać | : (czas.) sprzeczać | : (czas.) użerać
wrangler : wrangler : (rzecz.) awanturnik | : (rzecz.) kowboj
wrap : wrap : (czas.) obłożyć | : (czas.) okręcać | : (czas.) omotać | : (czas.) opakować | : (czas.) owijać | : (czas.) owinąć | : (czas.) pakować | : (czas.) zamotać | : (czas.) zapakować | : (czas.) zawijać
wrap-around : wrap-around : (rzecz.) zawijanie
wraparound : wraparound : (rzecz.) zawijanie
wrapper : wrapper : (rzecz.) banderola | : (rzecz.) chusta | : (rzecz.) futerał | : (rzecz.) narzutka | : (rzecz.) obwoluta | : (rzecz.) opakowanie | : (rzecz.) osłona | : (rzecz.) owijacz | : (rzecz.) szlafrok | : (rzecz.) zawinięcie
wrasse : wrasse : (rzecz.) wargacz
wrath : wrath : (rzecz.) gniew | : (rzecz.) oburzenie | : (rzecz.) zapalczywość
wrathful : wrathful : (przym.) gniewny
wreak : wreak : (czas.) pomścić | : (czas.) wyładowywać
wreaking : wreaking : (rzecz.) wyładowywanie
wreath : wreath : (rzecz.) girlanda | : (rzecz.) wianek | : (rzecz.) wieniec | : (rzecz.) zwój
wreathe : wreathe : (czas.) kłębić | : (czas.) pleść | : (czas.) zwijać
wreck : wreck : (czas.) kończyć | : (czas.) niszczyć | : (czas.) niweczyć | : (czas.) rozbić | : (czas.) rozbijać | : (czas.) rujnować | : (czas.) zniszczyć | : (czas.) zrujnować
wreckage : wreckage : (rzecz.) rozbicie | : (rzecz.) szczątki | : (rzecz.) wrak
wrecker : wrecker : (rzecz.) burzyciel | : (rzecz.) niszczyciel | : (rzecz.) ten
wren : wren : (rzecz.) strzyżyk
wrest : wrest : (czas.) skręcać | : (czas.) skręcić | : (czas.) wyrwać | : (czas.) wyrywać
wrestle : wrestle : (czas.) borykać | : (czas.) mocować | : (czas.) walczyć | : (czas.) wydzierać | : (czas.) wyrywać | : (czas.) zmagać
wrestler : wrestler : (rzecz.) zapaśnik
wrestling : wrestling : (rzecz.) zapaśnictwo | : (rzecz.) zapasy
wretch : wretch : (rzecz.) bydlak | : (rzecz.) łajdak | : (rzecz.) łotr | : (rzecz.) nędznik | : (rzecz.) niegodziwiec | : (rzecz.) nieszczęśliwiec | : (rzecz.) nieszczęśnik | : (rzecz.) nikczemnik
wretched : wretched : (przym.) biedny | : (przym.) lichy | : (przym.) nędzny | : (przym.) nieszczęśliwy | : (przym.) nieszczęsny | : (przym.) paskudny | : (przym.) wstrętny
wretchedly : wretchedly : (przysł.) wrednie
wretchedness : wretchedness : (rzecz.) marność | : (rzecz.) perfidia
wrick : wrick : (czas.) nadwerężyć
wriggle : wriggle : (czas.) kręcić | : (czas.) skręcać | : (czas.) skręcić | : (czas.) wić | : (czas.) wyginać | : (czas.) wywijać | : (czas.) wyżymać | : (czas.) zwijać
wriggler : wriggler : (rzecz.) krętacz
wring : wring : (czas.) ściskać | : (czas.) ukręcić | : (czas.) wykręcać | : (czas.) wykręcić | : (czas.) wyżąć | : (czas.) wyżymać
wringer : wringer : (rzecz.) wyżymaczka
wrinkle : wrinkle : (czas.) marszczyć | : (czas.) pomarszczyć | : (rzecz.) fałd | : (rzecz.) zmarszczka
wrist : wrist : (rzecz.) mankiet | : (rzecz.) nadgarstek | : (rzecz.) napięstek | : (rzecz.) przegub
wristband : wristband : (rzecz.) bransoleta | : (rzecz.) bransoletka | : (rzecz.) mankiet
wristwatch : wristwatch : (rzecz.) zegarek
writ : writ : (rzecz.) nakaz | : (rzecz.) pismo | : (rzecz.) pozew | : (rzecz.) rozporządzenie
write : write : (czas.) napisać | : (czas.) pisać | : (czas.) pisywać | : (czas.) spisać | : (czas.) wypisywać | : (czas.) zapisać | : (czas.) zredagować
writer : writer : (rzecz.) autor | : (rzecz.) literat | : (rzecz.) pisarz | : (rzecz.) twórca
writers : writers : (rzecz.) pisarek
writhe : writhe : (czas.) cierpieć | : (czas.) skręcać | : (czas.) wić | : (czas.) zwijać
writing-desk : writing-desk : (rzecz.) biurko
wrong : wrong : (czas.) pokrzywdzić | : (czas.) szkodzić | : (przym.) błędny | : (przym.) fałszywy | : (przym.) mylny | : (przym.) niedobry | : (przym.) nieodpowiedni | : (przym.) niesłuszny | : (przym.) niewłaściwy | : (przym.) opaczny | : (przym.) zły | : (przysł.) błędnie | : (przysł.) niedobrze | : (przysł.) źle
wrong-doer : wrong-doer : (rzecz.) krzywdziciel | : (rzecz.) szkodnik | : (rzecz.) złoczyńca
wrong-doing : wrong-doing : (rzecz.) grzech | : (rzecz.) krzywda | : (rzecz.) przestępstwo | : (rzecz.) zło
wrong-headed : wrong-headed : (przym.) przekorny | : (przym.) przewrotny | : (przym.) uporczywy
wrongdoer : wrongdoer : (rzecz.) grzesznik | : (rzecz.) przestępca | : (rzecz.) szkodnik | : (rzecz.) winowajca | : (rzecz.) złoczyńca
wrongdoing : wrongdoing : (rzecz.) grzech | : (rzecz.) krzywda | : (rzecz.) nadużycie | : (rzecz.) przestępstwo | : (rzecz.) wykroczenie | : (rzecz.) zło
wrongful : wrongful : (przym.) bezprawny | : (przym.) krzywdzący | : (przym.) niesprawiedliwy | : (przym.) szkodliwy | : (przym.) zły
wrongfully : wrongfully : (przysł.) bezprawnie
wrongheaded : wrongheaded : (przym.) przekorny | : (przym.) przewrotny | : (przym.) uporczywy
wrongly : wrongly : (przysł.) niewłaściwie | : (przysł.) źle
wroth : wroth : (przym.) gniewny | : (przym.) zły
wry : wry : (przym.) krzywy | : (przym.) skręcony
wryneck : wryneck : (rzecz.) krętogłów
wulfenite : wulfenite : (rzecz.) wulfenit
