reich : Reich : (rzecz.) rzesza
richard : Richard : (rzecz.) Ryszard
rob : Rob : (rzecz.) Robert
robbie : Robbie : (rzecz.) Robert
romanist : Romanist : (rzecz.) romanista
rudolph : Rudolph : (rzecz.) Rudolf
r cabman : r cabman : (rzecz.) dorożkarz | : (rzecz.) fiakier
rabbet : rabbet : (rzecz.) felc | : (rzecz.) wpust | : (rzecz.) wręg
rabbi : rabbi : (rzecz.) rabin
rabbinate : rabbinate : (rzecz.) rabinat
rabbinic : rabbinic : (przym.) rabiniczny
rabbit : rabbit : (rzecz.) królik | : (rzecz.) zając
rabbit's : rabbit's : (przym.) króliczy
rabble : rabble : (rzecz.) gawiedź | : (rzecz.) hołota | : (rzecz.) motłoch
rabid : rabid : (przym.) fanatyczny | : (przym.) szalony | : (przym.) wściekły
rabidity : rabidity : (rzecz.) zacietrzewienie
rabies : rabies : (rzecz.) wodowstręt | : (rzecz.) wścieklizna
raccoon : raccoon : (rzecz.) szop | : (rzecz.) szopa
race : race : (czas.) gonić | : (czas.) ścigać | : (rzecz.) bieg | : (rzecz.) rasa | : (rzecz.) wyścig
racecourse : racecourse : (rzecz.) bieżnia
racehorse : racehorse : (rzecz.) wyścigowiec
racer : racer : (rzecz.) biegacz | : (rzecz.) obrotnica | : (rzecz.) wyścigowiec | : (rzecz.) wyścigówka
races : races : (rzecz.) regaty
racetrack : racetrack : (rzecz.) bieżnia
raceway : raceway : (rzecz.) bieżnia
rachitic : rachitic : (przym.) krzywiczny | : (przym.) rachityczny
racial : racial : (przym.) plemienny | : (przym.) rasowy
racialism : racialism : (rzecz.) rasizm
racialist : racialist : (rzecz.) rasista
racially : racially : (przysł.) rasowo
raciness : raciness : (rzecz.) swojskość
racism : racism : (rzecz.) rasizm
racist : racist : (rzecz.) rasista
rack : rack : (czas.) podpierać | : (czas.) torturować | : (czas.) wyciągać | : (rzecz.) półka | : (rzecz.) statyw | : (rzecz.) stojak | : (rzecz.) wieszak | : (rzecz.) zębatka
racket : racket : (rzecz.) awantura | : (rzecz.) geszeft | : (rzecz.) hałas | : (rzecz.) harmider | : (rzecz.) huk | : (rzecz.) łoskot | : (rzecz.) rakieta | : (rzecz.) rakietka
racketeer : racketeer : (rzecz.) aferzysta | : (rzecz.) kanciarz | : (rzecz.) oszust | : (rzecz.) szantażysta | : (rzecz.) szuler
racketeering : racketeering : (rzecz.) gangsterstwo | : (rzecz.) kanciarstwo
rackety : rackety : (przym.) awanturniczy | : (przym.) hulaszczy
raconteur : raconteur : (rzecz.) gawędziarz
racquet : racquet : (rzecz.) rakieta
racy : racy : (przym.) charakterystyczny | : (przym.) pikantny | : (przym.) rasowy | : (przym.) siarczysty | : (przym.) typowy
radar : radar : (rzecz.) radar | : (rzecz.) radiolokator
radial : radial : (przym.) gwiaździsty | : (przym.) promieniowy | : (przym.) promienisty | : (przym.) radialny
radian : radian : (rzecz.) rad | : (rzecz.) radian
radiance : radiance : (rzecz.) blask | : (rzecz.) jasność | : (rzecz.) luminancja | : (rzecz.) promieniowanie | : (rzecz.) promienność
radiant : radiant : (przym.) promienisty | : (przym.) promienny
radiantly : radiantly : (przysł.) promiennie
radiate : radiate : (czas.) promieniować
radiation : radiation : (rzecz.) promieniowanie | : (rzecz.) radiacja
radiator : radiator : (rzecz.) chłodnica | : (rzecz.) grzejnik | : (rzecz.) kaloryfer
radical : radical : (przym.) doszczętny | : (przym.) korzonkowy | : (przym.) pierwiastkowy | : (przym.) radykalny | : (przym.) skrajny | : (przym.) zasadniczy | : (rzecz.) pierwiastek | : (rzecz.) radykał | : (rzecz.) radykalista | : (rzecz.) rodnik
radicalism : radicalism : (rzecz.) radykalizm
radicalization : radicalization : (rzecz.) radykalizacja
radicalize : radicalize : (czas.) zradykalizować
radically : radically : (przysł.) radykalnie
radio : radio : (rzecz.) radio | : (rzecz.) radiofonia | : (rzecz.) radiotechnika
radio-range : radio-range : (rzecz.) radiolatarnia
radio-telegram : radio-telegram : (rzecz.) radiogram
radio-telephone : radio-telephone : (rzecz.) radiotelefon
radio-telephony : radio-telephony : (rzecz.) radiotelefonia
radioactive : radioactive : (przym.) promieniotwórczy | : (przym.) radioaktywny
radioactively : radioactively : (przysł.) radioaktywnie
radioactivity : radioactivity : (rzecz.) promieniotwórczość | : (rzecz.) radioaktywność
radiobiology : radiobiology : (rzecz.) radiobiologia
radiocarbon : radiocarbon : (rzecz.) radiowęgiel
radiochemical : radiochemical : (przym.) radiochemiczny
radiochemistry : radiochemistry : (rzecz.) radiochemia
radioecology : radioecology : (rzecz.) radioekologia
radioed : radioed : (rzecz.) odbiornik
radioelement : radioelement : (rzecz.) radio-pierwiastek
radiogram : radiogram : (rzecz.) radiogram
radiograph : radiograph : (rzecz.) prześwietlenie | : (rzecz.) radiogram | : (rzecz.) rentgenogram
radiographer : radiographer : (rzecz.) radiolog | : (rzecz.) rentgenolog
radiographic : radiographic : (przym.) radiograficzny
radiography : radiography : (rzecz.) radiografia | : (rzecz.) rentgenografia
radioisotope : radioisotope : (rzecz.) radioizotop
radiolocation : radiolocation : (rzecz.) radar | : (rzecz.) radiolokacja | : (rzecz.) radiolokator
radiological : radiological : (przym.) radiologiczny | : (przym.) rentgenologiczny
radiologist : radiologist : (rzecz.) rentgenolog
radiology : radiology : (rzecz.) radiologia | : (rzecz.) rentgenologia
radiolysis : radiolysis : (rzecz.) radioliza
radiometer : radiometer : (rzecz.) radiometr
radiometric : radiometric : (przym.) radiometryczny
radiometry : radiometry : (rzecz.) radiometria
radionuclide : radionuclide : (rzecz.) radionuklid
radioscopy : radioscopy : (rzecz.) radioskopia
radiotelegraph : radiotelegraph : (rzecz.) radiotelefonia | : (rzecz.) radiotelegraf
radiotelegraphic : radiotelegraphic : (przym.) radiotelegraficzny
radiotelegraphy : radiotelegraphy : (rzecz.) radiotelegrafia
radiotelephone : radiotelephone : (przym.) radiotelefoniczny | : (rzecz.) radiotelefon
radiotelephony : radiotelephony : (rzecz.) radiotelefonia
radiotherapist : radiotherapist : (rzecz.) radioterapeuta
radiotherapy : radiotherapy : (rzecz.) promieniolecznictwo | : (rzecz.) radioterapia
radish : radish : (rzecz.) rzodkiew | : (rzecz.) rzodkiewka
radishes : radishes : (rzecz.) rzodkiew | : (rzecz.) rzodkiewka
radium : radium : (rzecz.) rad
radius : radius : (rzecz.) półprosta | : (rzecz.) promień
radix : radix : (rzecz.) korzeń | : (rzecz.) nasada | : (rzecz.) pierwiastek | : (rzecz.) podstawa | : (rzecz.) racja
radon : radon : (rzecz.) radon
radon-220 : radon-220 : (rzecz.) toron
raffia : raffia : (rzecz.) rafia
raffish : raffish : (przym.) ordynarny
raffle : raffle : (rzecz.) loteria | : (rzecz.) męt | : (rzecz.) wenta
raft : raft : (czas.) spławiać | : (rzecz.) spław | : (rzecz.) tratwa
rafter : rafter : (rzecz.) flisak | : (rzecz.) krokiew | : (rzecz.) tratwiarz
rafting : rafting : (rzecz.) flisactwo | : (rzecz.) przeprawianie | : (rzecz.) spływ
rag : rag : (czas.) hałasować | : (czas.) skrzyczeć | : (czas.) śmieć | : (czas.) zbesztać | : (rzecz.) brukowiec | : (rzecz.) gałgan | : (rzecz.) gałganek | : (rzecz.) łach | : (rzecz.) łachman | : (rzecz.) rejwach | : (rzecz.) szmata | : (rzecz.) szmatka | : (rzecz.) szmatławiec
rag-and-bone : rag-and-bone : (rzecz.) szmaciarz
rag-tag : rag-tag : (rzecz.) hołota | : (rzecz.) łajdactwo | : (rzecz.) tłuszcza
ragamuffin : ragamuffin : (rzecz.) łachmaniarz | : (rzecz.) oberwaniec | : (rzecz.) obszarpaniec
rage : rage : (czas.) pieklić | : (czas.) piorunować | : (czas.) rozszaleć | : (czas.) srożyć | : (czas.) szaleć | : (czas.) wściekać | : (czas.) zabalować | : (rzecz.) gniew | : (rzecz.) mania | : (rzecz.) szał | : (rzecz.) szaleństwo | : (rzecz.) wściekłość
ragged : ragged : (przym.) chropowaty | : (przym.) nędzny | : (przym.) nierówny | : (przym.) niestaranny | : (przym.) obszarpany | : (przym.) szorstki | : (przym.) wyboisty
raggedly : raggedly : (przysł.) chropowato
raggedness : raggedness : (rzecz.) łachman
ragman : ragman : (rzecz.) gałganiarz
ragout : ragout : (rzecz.) potrawka
ragweed : ragweed : (rzecz.) ambrozja
raid : raid : (czas.) bombardować | : (czas.) najechać | : (czas.) najeżdżać | : (czas.) napadać | : (czas.) zbombardować | : (rzecz.) atak | : (rzecz.) bombardowanie | : (rzecz.) łapanka | : (rzecz.) najazd | : (rzecz.) nalot | : (rzecz.) napad | : (rzecz.) obława
raider : raider : (rzecz.) komandos | : (rzecz.) najeźdźca | : (rzecz.) napastnik | : (rzecz.) włamywacz
rail : rail : (czas.) szydzić | : (czas.) złorzeczyć | : (rzecz.) barierka | : (rzecz.) kolej | : (rzecz.) poręcz | : (rzecz.) prowadnica | : (rzecz.) rygiel | : (rzecz.) szyna
rail-car : rail-car : (rzecz.) wagon
railing : railing : (rzecz.) balustrada | : (rzecz.) ogrodzenie | : (rzecz.) okratowanie | : (rzecz.) płot | : (rzecz.) poręcz | : (rzecz.) reling
raillery : raillery : (rzecz.) kpiny | : (rzecz.) naciąganie
railroad : railroad : (czas.) przeforsować | : (rzecz.) kolej
rails : rails : (rzecz.) ogrodzenie
railway : railway : (rzecz.) kolej
railwayman : railwayman : (rzecz.) kolejarz
railways : railways : (rzecz.) kolejnictwo
raiment : raiment : (rzecz.) strój
rain : rain : (czas.) padać | : (czas.) upadać | : (rzecz.) deszcz | : (rzecz.) dżdżystość | : (rzecz.) ulewa
rain-gauge : rain-gauge : (rzecz.) deszczomierz
rain-water : rain-water : (rzecz.) deszczówka
rainbow : rainbow : (rzecz.) tęcza
raincoat : raincoat : (rzecz.) deszczowiec | : (rzecz.) peleryna | : (rzecz.) prochowiec
raindrop : raindrop : (rzecz.) kropla
rainfall : rainfall : (rzecz.) deszcz | : (rzecz.) opad
rainless : rainless : (przym.) bezdeszczowy
rainproof : rainproof : (przym.) deszczoodporny | : (przym.) nieprzemakalny
rainstorm : rainstorm : (rzecz.) ulewa
rainwater : rainwater : (rzecz.) deszczówka
rainy : rainy : (przym.) deszczowy | : (przym.) dżdżysty | : (przym.) słotny | : (przym.) ulewny
raise : raise : (czas.) budować | : (czas.) budzić | : (czas.) dźwigać | : (czas.) hodować | : (czas.) mobilizować | : (czas.) najeżyć | : (czas.) ożywiać | : (czas.) podnieść | : (czas.) podnosić | : (czas.) podwyższać | : (czas.) poruszać | : (czas.) pozyskiwać | : (czas.) rodzić | : (czas.) rozbudzić | : (czas.) uchylać | : (czas.) werbować | : (czas.) wnosić | : (czas.) wschodzić | : (czas.) wychować | : (czas.) wychowywać | : (czas.) wywoływać | : (czas.) wznosić | : (czas.) zaciągać | : (rzecz.) wzrost
raiser : raiser : (rzecz.) hodowca | : (rzecz.) przednóżek | : (rzecz.) sztangista
raisin : raisin : (rzecz.) rodzynek | : (rzecz.) rodzynka
raisins : raisins : (rzecz.) rodzynek | : (rzecz.) rodzynki
raja : raja : (rzecz.) radża
rajah : rajah : (rzecz.) radża
rake : rake : (czas.) grabić | : (czas.) grzebać | : (czas.) odchylać | : (czas.) ogarniać | : (czas.) ograbić | : (czas.) ostrzeliwać | : (czas.) przeczesywać | : (czas.) szperać | : (czas.) zgrabić | : (rzecz.) birbant | : (rzecz.) dziwkarz | : (rzecz.) grabie | : (rzecz.) grabienie | : (rzecz.) hulaka | : (rzecz.) łajdak | : (rzecz.) pochylenie | : (rzecz.) pogrzebacz | : (rzecz.) świntuch
rake-off : rake-off : (rzecz.) dola | : (rzecz.) prowizja | : (rzecz.) udział
rakes : rakes : (rzecz.) grabki
rakish : rakish : (przym.) hulaszczy | : (przym.) rozpustny | : (przym.) zawadiacki
rally : rally : (czas.) gromadzić | : (czas.) naigrawać | : (czas.) oprzytomnieć | : (czas.) ożyć | : (czas.) szydzić | : (czas.) żartować | : (czas.) zbiegać | : (czas.) zbierać | : (rzecz.) masówka | : (rzecz.) poprawa | : (rzecz.) rajd | : (rzecz.) wiec | : (rzecz.) zbiórka | : (rzecz.) zjazd | : (rzecz.) zlot
ram : ram : (czas.) rozbijać | : (czas.) taranować | : (czas.) wbijać | : (rzecz.) baran | : (rzecz.) bijak | : (rzecz.) dźwig | : (rzecz.) nurnik | : (rzecz.) taran | : (rzecz.) tryk
ram-wing : ram-wing : (rzecz.) ekranoplan
ramble : ramble : (czas.) piąć | : (czas.) przeskakiwać | : (czas.) wałęsać | : (czas.) wędrować | : (czas.) wić | : (czas.) włóczyć | : (czas.) wywędrować | : (czas.) zbaczać | : (rzecz.) przechadzka | : (rzecz.) wędrówka
rambler : rambler : (rzecz.) wędrowiec | : (rzecz.) włóczęga | : (rzecz.) wycieczkowicz
rambling : rambling : (przym.) chaotyczny | : (przym.) wędrowniczy | : (przym.) wędrowny
rambunctious : rambunctious : (przym.) hałaśliwy | : (przym.) niesforny
ramie : ramie : (rzecz.) ramia
ramification : ramification : (rzecz.) rozgałęzienie | : (rzecz.) rozwidlenie
ramify : ramify : (czas.) rozgałęziać
rammer : rammer : (rzecz.) ubijacz | : (rzecz.) ubijak
ramose : ramose : (przym.) gałęzisty | : (przym.) rozgałęziony
ramous : ramous : (przym.) gałęzisty
ramp : ramp : (czas.) piąć | : (rzecz.) pochylnia | : (rzecz.) pochyłość | : (rzecz.) podjazd | : (rzecz.) rampa
rampage : rampage : (czas.) miotać | : (czas.) rzucać | : (czas.) szaleć
rampant : rampant : (przym.) bujny | : (przym.) gwałtowny | : (przym.) nieokiełznany
rampart : rampart : (rzecz.) bastion | : (rzecz.) obwałowanie | : (rzecz.) ochrona | : (rzecz.) przedmurze | : (rzecz.) wał
ramrod : ramrod : (rzecz.) wycior
ramshackle : ramshackle : (przym.) rozpadający
ranch : ranch : (rzecz.) farma | : (rzecz.) gospodarstwo | : (rzecz.) ranczo
rancher : rancher : (rzecz.) pomocnik | : (rzecz.) ranczer
ranchero : ranchero : (rzecz.) ranczer
ranching : ranching : (rzecz.) hodowanie
rancid : rancid : (przym.) jełki | : (przym.) nieświeży | : (przym.) zjełczały
rancidity : rancidity : (rzecz.) jełczenie | : (rzecz.) zjełczałość
rancorous : rancorous : (przym.) rozgoryczony | : (przym.) zły
rancour : rancour : (rzecz.) uraza | : (rzecz.) żal | : (rzecz.) złość
rand : rand : (rzecz.) pogórze
random : random : (przym.) doraźny | : (przym.) losowy | : (przym.) przypadkowy | : (przym.) swobodny | : (przym.) wyrywkowy | : (rzecz.) przypadek
randomisation : randomisation : (rzecz.) randomizacja
randomization : randomization : (rzecz.) losowość | : (rzecz.) randomizacja
randomize : randomize : (czas.) losować
randomized : randomized : (przym.) losowy | : (rzecz.) losowość
randomly : randomly : (przysł.) losowo | : (przysł.) przypadkowo
randomness : randomness : (rzecz.) losowość | : (rzecz.) przypadkowość
randy : randy : (przym.) hałaśliwy | : (przym.) kłótliwy | : (przym.) krzykliwy
range : range : (czas.) sięgać | : (rzecz.) asortyment | : (rzecz.) donośność | : (rzecz.) gama | : (rzecz.) krąg | : (rzecz.) łańcuch | : (rzecz.) paleta | : (rzecz.) pałętanie | : (rzecz.) pasmo | : (rzecz.) płyta | : (rzecz.) pozycja | : (rzecz.) rozległość | : (rzecz.) rozpiętość | : (rzecz.) rząd | : (rzecz.) sfera | : (rzecz.) skala | : (rzecz.) sortyment | : (rzecz.) spektrum | : (rzecz.) szereg | : (rzecz.) uroczysko | : (rzecz.) wachlarz | : (rzecz.) wędrówka | : (rzecz.) wielorakość | : (rzecz.) zakres | : (rzecz.) zasięg
range-finder : range-finder : (rzecz.) dalmierz | : (rzecz.) odległościomierz
rangefinder : rangefinder : (rzecz.) dalekomierz | : (rzecz.) dalmierz | : (rzecz.) odległościomierz
ranger : ranger : (rzecz.) desantowiec | : (rzecz.) leśniczy | : (rzecz.) obieżyświat | : (rzecz.) policjant | : (rzecz.) włóczęga
rangy : rangy : (przym.) smukły
rank : rank : (czas.) zaliczać | : (przym.) bezwstydny | : (przym.) bujny | : (przym.) istny | : (przym.) mocny | : (przym.) słuszny | : (przym.) smrodliwy | : (przym.) wierutny | : (rzecz.) arystokracja | : (rzecz.) kategoria | : (rzecz.) pasmo | : (rzecz.) poczet | : (rzecz.) pozycjonowanie | : (rzecz.) ranga | : (rzecz.) ranking | : (rzecz.) rząd | : (rzecz.) stopień | : (rzecz.) szarża | : (rzecz.) szereg
ranker : ranker : (rzecz.) żołnierz
ranking : ranking : (rzecz.) ustalanie | : (rzecz.) ustawianie | : (rzecz.) zaliczanie
rankle : rankle : (czas.) dręczyć | : (czas.) jątrzyć | : (czas.) ropieć | : (czas.) rozgrzebywać | : (czas.) rozjątrzać | : (czas.) zżerać
rankness : rankness : (rzecz.) bezczelność | : (rzecz.) ordynarność | : (rzecz.) wybujałość
ransack : ransack : (czas.) buszować | : (czas.) obszukać | : (czas.) plądrować | : (czas.) przeszukać | : (czas.) przeszukiwać
ransom : ransom : (czas.) okupić | : (czas.) wykupić | : (czas.) wykupywać | : (rzecz.) okup | : (rzecz.) wykup
rant : rant : (czas.) krzyczeć | : (rzecz.) krzyk | : (rzecz.) tyrada
rap : rap : (czas.) pomstować | : (czas.) porwać | : (czas.) porywać | : (czas.) pukać | : (czas.) stukać | : (czas.) zastukać | : (rzecz.) pukanie | : (rzecz.) rap | : (rzecz.) stukanie | : (rzecz.) szturchaniec | : (rzecz.) zapukanie
rapacious : rapacious : (przym.) chciwy | : (przym.) drapieżny | : (przym.) łupieżczy | : (przym.) zachłanny
rapacity : rapacity : (rzecz.) drapieżność | : (rzecz.) zaborczość
rape : rape : (czas.) gwałcić | : (czas.) rabować | : (czas.) uwodzić | : (czas.) zgwałcić | : (rzecz.) gwałt | : (rzecz.) rabunek | : (rzecz.) rzepa | : (rzecz.) rzepak | : (rzecz.) zabór | : (rzecz.) zgwałcenie | : (rzecz.) zniewolenie
rapeseed : rapeseed : (przym.) rzepakowy | : (rzecz.) rzepak
rapid : rapid : (przym.) błyskawiczny | : (przym.) bystry | : (przym.) prędki | : (przym.) rwący | : (przym.) stromy | : (przym.) szybki | : (przym.) wartki
rapidity : rapidity : (rzecz.) gwałtowność | : (rzecz.) pospieszność | : (rzecz.) prędkość | : (rzecz.) szybkość | : (rzecz.) wartkość
rapidly : rapidly : (przysł.) gwałtownie | : (przysł.) szybko
rapids : rapids : (rzecz.) wodospad
rapier : rapier : (rzecz.) rapier
rapine : rapine : (rzecz.) rabunek
rapist : rapist : (rzecz.) gwałciciel
rapper : rapper : (rzecz.) kołatka
rapport : rapport : (rzecz.) harmonia | : (rzecz.) porozumienie
rapprochement : rapprochement : (rzecz.) zbliżenie
rapscallion : rapscallion : (rzecz.) hultaj | : (rzecz.) łobuz
rapt : rapt : (przym.) zaabsorbowany | : (przym.) zachwycony
raptorial : raptorial : (przym.) drapieżny
rapture : rapture : (rzecz.) uniesienie | : (rzecz.) upojenie | : (rzecz.) zachwyt
rapturous : rapturous : (przym.) entuzjastyczny | : (przym.) gromki
rare : rare : (przym.) krwisty | : (przym.) nieczęsty | : (przym.) niezwykły | : (przym.) rzadki
rarefaction : rarefaction : (rzecz.) rozrzedzanie | : (rzecz.) rozrzedzenie
rarefy : rarefy : (czas.) rafinować | : (czas.) rozrzedzać | : (czas.) rozrzedzić | : (czas.) zrzednąć
rarely : rarely : (przysł.) niespotykanie | : (przysł.) rzadko | : (przysł.) sporadycznie
rareness : rareness : (rzecz.) niezwykłość | : (rzecz.) rzadkość
raring : raring : (przym.) niecierpliwy
rarity : rarity : (rzecz.) rarytas | : (rzecz.) rzadkość | : (rzecz.) unikat
rascal : rascal : (rzecz.) ananas | : (rzecz.) drab | : (rzecz.) hultaj | : (rzecz.) łajdak | : (rzecz.) łobuz | : (rzecz.) łotr | : (rzecz.) szubrawiec | : (rzecz.) urwis | : (rzecz.) wisus
rascality : rascality : (rzecz.) łobuzerstwo
rascally : rascally : (przym.) hultajski | : (przym.) łobuzerski
rash : rash : (przym.) junacki | : (przym.) nieostrożny | : (przym.) nieprzemyślany | : (przym.) pochopny | : (przym.) pospieszny | : (przym.) pośpieszny | : (rzecz.) wysypka
rasher : rasher : (rzecz.) plasterek
rashly : rashly : (przysł.) nierozważnie | : (przysł.) pochopnie
rashness : rashness : (rzecz.) punktualność | : (rzecz.) wysypka
rasp : rasp : (czas.) drażnić | : (czas.) rzępolić | : (czas.) skrobać | : (czas.) zeskrobywać | : (czas.) zgrzytać | : (rzecz.) pilnik | : (rzecz.) raszpla | : (rzecz.) tarka | : (rzecz.) tarnik | : (rzecz.) zgrzyt | : (rzecz.) zgrzytanie
raspberry : raspberry : (rzecz.) malina | : (rzecz.) maliniak
raster : raster : (rzecz.) raster
rat : rat : (rzecz.) sprzedawczyk | : (rzecz.) szczur | : (rzecz.) szuja
rat-tat : rat-tat : (rzecz.) stukot
ratchet : ratchet : (rzecz.) zapadka
rate : rate : (czas.) karcić | : (czas.) łajać | : (czas.) nagadać | : (czas.) ocenić | : (czas.) skarcić | : (czas.) skrzyczeć | : (czas.) wyłajać | : (czas.) złajać | : (czas.) zwymyślać | : (rzecz.) cena | : (rzecz.) klasa | : (rzecz.) norma | : (rzecz.) proporcja | : (rzecz.) pysznie | : (rzecz.) stawka | : (rzecz.) stopa | : (rzecz.) światłoczułość | : (rzecz.) szybkość | : (rzecz.) taksa | : (rzecz.) taryfa | : (rzecz.) wielkość | : (rzecz.) wskaźnik | : (rzecz.) współczynnik
rate-payer : rate-payer : (rzecz.) płatnik | : (rzecz.) podatnik
ratepayer : ratepayer : (rzecz.) płatnik | : (rzecz.) podatnik
ratfink : ratfink : (rzecz.) szpicel
rather : rather : (przysł.) dość | : (przysł.) oczywiście | : (przysł.) właściwie
ratification : ratification : (rzecz.) ratyfikacja | : (rzecz.) ratyfikowanie
ratified : ratified : (czas.) ratyfikować
ratify : ratify : (czas.) ratyfikować
rating : rating : (rzecz.) kalibracja | : (rzecz.) nota | : (rzecz.) notowanie | : (rzecz.) ocena | : (rzecz.) ofuknięcie | : (rzecz.) oszacowanie | : (rzecz.) skalowanie | : (rzecz.) szacowanie | : (rzecz.) wskazanie | : (rzecz.) wskaźnik | : (rzecz.) wzorcowanie | : (rzecz.) znamiona
ratio : ratio : (rzecz.) proporcja | : (rzecz.) stosunek
ratiocinate : ratiocinate : (czas.) wnioskować
ratiocination : ratiocination : (rzecz.) rozumowanie | : (rzecz.) wnioskowanie
ration : ration : (czas.) przydzielać | : (czas.) racjonować | : (czas.) wydzielać | : (rzecz.) porcja | : (rzecz.) przydział | : (rzecz.) racja
rational : rational : (przym.) całościowy | : (przym.) racjonalny | : (przym.) rozumny | : (przym.) rozumowy | : (przym.) wymierny
rationale : rationale : (rzecz.) racja
rationalise : rationalise : (czas.) usprawniać
rationalism : rationalism : (rzecz.) racjonalizm
rationalist : rationalist : (rzecz.) racjonalista
rationalistic : rationalistic : (przym.) racjonalistyczny
rationality : rationality : (rzecz.) racjonalność
rationalization : rationalization : (rzecz.) poprawienie | : (rzecz.) racjonalizacja
rationalize : rationalize : (czas.) racjonalizować | : (czas.) zracjonalizować
rationally : rationally : (przysł.) racjonalnie | : (przysł.) rozumnie | : (przysł.) rozumowo
rationing : rationing : (rzecz.) racjonowanie | : (rzecz.) reglamentacja
ratline : ratline : (rzecz.) węźlica | : (rzecz.) wyblinka
rattan : rattan : (rzecz.) ratan | : (rzecz.) rotang
ratter : ratter : (rzecz.) ratler | : (rzecz.) ratlerek | : (rzecz.) szczurołap
rattle : rattle : (czas.) dostukać | : (czas.) grzechotać | : (czas.) hałasować | : (czas.) paplać | : (czas.) postukiwać | : (czas.) stukać | : (czas.) szczękać | : (czas.) terkotać | : (czas.) turkotać | : (czas.) załomotać | : (rzecz.) bębnienie | : (rzecz.) brzęk | : (rzecz.) gruchot | : (rzecz.) grzechot | : (rzecz.) grzechotka | : (rzecz.) klekot | : (rzecz.) łoskot | : (rzecz.) papla | : (rzecz.) stukanie | : (rzecz.) stukot | : (rzecz.) terkot | : (rzecz.) terkotanie | : (rzecz.) tętent | : (rzecz.) turkot
rattler : rattler : (rzecz.) grzechotka | : (rzecz.) hałasowanie | : (rzecz.) okaz | : (rzecz.) papla
rattlesnake : rattlesnake : (rzecz.) grzechotnik
rattletrap : rattletrap : (rzecz.) gruchot | : (rzecz.) jadaczka
rattling : rattling : (przym.) terkotliwy
ratty : ratty : (przym.) szczurzy
raucous : raucous : (przym.) hałaśliwy
raunchy : raunchy : (przym.) lubieżny | : (przym.) sprośny
ravage : ravage : (czas.) dewastować | : (czas.) niszczyć | : (czas.) opustoszyć | : (czas.) plądrować | : (czas.) pustoszyć | : (czas.) zniszczyć | : (rzecz.) dewastacja | : (rzecz.) pustoszenie | : (rzecz.) rabunek | : (rzecz.) spustoszenie | : (rzecz.) zniszczenie
rave : rave : (czas.) bredzić | : (czas.) fiksować | : (czas.) majaczyć | : (czas.) poszaleć | : (czas.) przepadać | : (czas.) szaleć | : (czas.) unosić | : (czas.) wściekać | : (przym.) entuzjastyczny
ravel : ravel : (czas.) plątać | : (czas.) rozwikłać | : (czas.) wikłać | : (czas.) wystrzępić | : (czas.) zawikłać | : (rzecz.) plątanina | : (rzecz.) węzeł
raven : raven : (czas.) żerować | : (przym.) kruczy | : (rzecz.) kruk | : (rzecz.) zdobycz
raven-black : raven-black : (przym.) kruczy
ravening : ravening : (przym.) wściekły | : (przym.) żarłoczny
ravenous : ravenous : (przym.) drapieżny | : (przym.) wilczy | : (przym.) zachłanny | : (przym.) żarłoczny
ravenously : ravenously : (przysł.) zachłannie
ravine : ravine : (rzecz.) parów | : (rzecz.) porów | : (rzecz.) wąwóz
raving : raving : (przym.) zwariowany
ravioli : ravioli : (rzecz.) uszko
ravish : ravish : (czas.) gwałcić | : (czas.) oczarowywać | : (czas.) porwać | : (czas.) porywać | : (czas.) rabować | : (czas.) uwodzić | : (czas.) zachwycać | : (czas.) zachwycić
ravishment : ravishment : (rzecz.) pochwycenie | : (rzecz.) uprowadzenie
raw : raw : (przym.) niewyrobiony | : (przym.) srogi | : (przym.) surowy
rawness : rawness : (rzecz.) surowizna | : (rzecz.) surowość
ray : ray : (czas.) promieniować | : (rzecz.) płaszczka | : (rzecz.) półprosta | : (rzecz.) promień | : (rzecz.) promyk
rayon : rayon : (rzecz.) regał | : (rzecz.) rejon
rays : rays : (rzecz.) promienie
raze : raze : (czas.) burzyć | : (czas.) ścierać | : (czas.) zetrzeć | : (czas.) zniszczyć
razor : razor : (rzecz.) brzytwa | : (rzecz.) golarka | : (rzecz.) żyletka
razzle-dazzle : razzle-dazzle : (rzecz.) hulanka | : (rzecz.) zabawa
re : re : (rzecz.) przeprogramowanie | : (rzecz.) reintegracja
re-collect : re-collect : (czas.) zbierać
re-echo : re-echo : (czas.) powtarzać
re-edify : re-edify : (czas.) przebudować
re-educate : re-educate : (czas.) reedukować
re-education : re-education : (rzecz.) reedukacja
re-election : re-election : (rzecz.) reelekcja
re-establish : re-establish : (czas.) przywracać | : (czas.) zrekonstruować
re-form : re-form : (czas.) przekształcać
re-installation : re-installation : (rzecz.) przeinstalowanie
reabsorb : reabsorb : (czas.) resorbować
reach : reach : (czas.) dobrnąć | : (czas.) dochodzić | : (czas.) docierać | : (czas.) dogonić | : (czas.) dojechać | : (czas.) dojeżdżać | : (czas.) dojść | : (czas.) dolecieć | : (czas.) dosięgać | : (czas.) dosięgnąć | : (czas.) dotrzeć | : (czas.) dotykać | : (czas.) kontaktować | : (czas.) osiągać | : (czas.) rozciągać | : (czas.) sięgać | : (czas.) sięgnąć | : (czas.) wyciągać | : (rzecz.) gać
reachable : reachable : (przym.) osiągalny | : (przym.) uchwytny
reaches : reaches : (rzecz.) dosięganie
react : react : (czas.) reagować | : (czas.) zareagować
reactance : reactance : (rzecz.) reaktancja
reaction : reaction : (rzecz.) odczyn | : (rzecz.) reakcja
reactionary : reactionary : (przym.) reakcyjny | : (przym.) wsteczny | : (rzecz.) reakcjonista | : (rzecz.) wstecznik
reactivate : reactivate : (czas.) reaktywować
reactivated : reactivated : (czas.) reaktywować
reactivates : reactivates : (czas.) reaktywować
reactivating : reactivating : (czas.) reaktywować | : (rzecz.) reaktywowanie
reactivation : reactivation : (rzecz.) reaktywacja | : (rzecz.) reaktywowanie
reactive : reactive : (przym.) reakcyjny | : (przym.) reaktywny
reactively : reactively : (przysł.) reaktywnie
reactivity : reactivity : (rzecz.) reakcyjność | : (rzecz.) reaktywność
reactor : reactor : (rzecz.) dławik | : (rzecz.) reaktor
read : read : (czas.) brzmieć | : (czas.) czytać | : (czas.) doszukiwać | : (czas.) interpretować | : (czas.) odczytać | : (czas.) odczytywać | : (czas.) poczytać | : (czas.) przeczytać | : (czas.) przesylabizować | : (czas.) referować | : (czas.) rozumieć | : (czas.) wróżyć | : (czas.) wyczytać | : (czas.) wyglądać | : (czas.) zaznajomić
readability : readability : (rzecz.) czytelność
readable : readable : (przym.) czytelny
readdress : readdress : (czas.) przeadresować
readdressing : readdressing : (rzecz.) przeadresowywanie
reader : reader : (rzecz.) czytanka | : (rzecz.) czytelnik | : (rzecz.) czytnik | : (rzecz.) lektor | : (rzecz.) recenzent | : (rzecz.) wykładowca
readership : readership : (rzecz.) docentura
readied : readied : (przym.) gotowy
readily : readily : (przysł.) chętnie | : (przysł.) łatwo | : (przysł.) ochoczo | : (przysł.) skwapliwie | : (przysł.) szybko
readiness : readiness : (rzecz.) gotowość | : (rzecz.) ochoczość | : (rzecz.) ochota
reading : reading : (rzecz.) czytanie | : (rzecz.) czytelnictwo | : (rzecz.) lektura | : (rzecz.) literatura | : (rzecz.) oczytanie | : (rzecz.) odczytanie | : (rzecz.) odczytywanie
reading-room : reading-room : (rzecz.) czytelnia
readjust : readjust : (czas.) dopasowywać | : (czas.) dostosować | : (czas.) porządkować | : (czas.) przeregulować | : (czas.) przystosować
readout : readout : (rzecz.) odczyt | : (rzecz.) odzyskiwanie
ready : ready : (przym.) gotów | : (przym.) gotowy | : (przym.) ochoczy | : (przym.) skwapliwy | : (przym.) szybki
ready-made : ready-made : (przym.) gotowy | : (przym.) konfekcyjny
readymade : readymade : (przym.) gotowy | : (przym.) skłonny
reaffirm : reaffirm : (czas.) potwierdzać | : (czas.) potwierdzić
reaffirmation : reaffirmation : (rzecz.) potwierdzenie
reagent : reagent : (rzecz.) odczynnik
real : real : (przym.) faktyczny | : (przym.) istny | : (przym.) konkretny | : (przym.) naturalny | : (przym.) prawdziwy | : (przym.) realny | : (przym.) rzeczowy | : (przym.) rzeczywisty | : (przysł.) realnie
realign : realign : (czas.) przeorganizować | : (czas.) przeorganizowywać | : (czas.) reorganizować
realignment : realignment : (rzecz.) przestawienie | : (rzecz.) zmiana
realisation : realisation : (rzecz.) likwidacja | : (rzecz.) realizacja | : (rzecz.) upłynnienie | : (rzecz.) urzeczywistnienie | : (rzecz.) wykonanie | : (rzecz.) wyprzedaż
realism : realism : (rzecz.) realizm
realist : realist : (rzecz.) realista
realistic : realistic : (przym.) realistyczny | : (przym.) życiowy
realistically : realistically : (przysł.) realistycznie
realities : realities : (rzecz.) realia
reality : reality : (rzecz.) jawa | : (rzecz.) przedmiotowość | : (rzecz.) realia | : (rzecz.) realizm | : (rzecz.) realność | : (rzecz.) rzeczywistość
realizable : realizable : (przym.) realny | : (przym.) wykonalny
realizably : realizably : (przysł.) wykonalnie
realization : realization : (rzecz.) realizacja | : (rzecz.) spieniężanie | : (rzecz.) urzeczywistnienie | : (rzecz.) uświadomienie | : (rzecz.) wykonanie | : (rzecz.) ziszczenie
realize : realize : (czas.) realizować | : (czas.) spieniężać | : (czas.) spieniężyć | : (czas.) urzeczywistniać | : (czas.) uświadamiać | : (czas.) wyobrażać
reallocate : reallocate : (czas.) rozdzielać
really : really : (przysł.) doprawdy | : (przysł.) iście | : (przysł.) realnie | : (przysł.) rzeczywiście
realm : realm : (rzecz.) domena | : (rzecz.) dziedzina | : (rzecz.) królestwo | : (rzecz.) niwa | : (rzecz.) państwo
realty : realty : (rzecz.) nieruchomość
ream : ream : (rzecz.) ryza
reamer : reamer : (rzecz.) rozwiertak
reaming : reaming : (rzecz.) rozwiercanie
reanimate : reanimate : (czas.) ożywiać | : (czas.) ożywić | : (czas.) reanimować
reanimation : reanimation : (rzecz.) reanimacja
reap : reap : (czas.) kosić | : (czas.) żąć | : (czas.) zbierać
reaper : reaper : (rzecz.) żeniec | : (rzecz.) żniwiarz
reaping : reaping : (rzecz.) czerpanie | : (rzecz.) żęcie
reaping-hook : reaping-hook : (rzecz.) sierp
reappear : reappear : (czas.) pojawiać | : (czas.) ukazywać
rear : rear : (czas.) hodować | : (czas.) wychowywać | : (czas.) wykarmić | : (czas.) wznosić | : (rzecz.) tył
rear-admiral : rear-admiral : (rzecz.) kontradmirał
rearguard : rearguard : (rzecz.) ariergarda
rearm : rearm : (czas.) dozbrajać | : (czas.) przezbrajać
rearmament : rearmament : (rzecz.) dozbrajanie | : (rzecz.) dozbrojenie | : (rzecz.) remilitaryzacja
rearmost : rearmost : (przym.) końcowy | : (przym.) ostatni
rearrange : rearrange : (czas.) poprawić | : (czas.) przegrupować | : (czas.) przekładać | : (czas.) przemeblować | : (czas.) przestawiać | : (czas.) przestawić | : (czas.) reorganizować | : (czas.) uporządkować | : (czas.) zmieniać
rearrangement : rearrangement : (rzecz.) kombinacja | : (rzecz.) przegrupowanie | : (rzecz.) przeorganizowanie | : (rzecz.) przestawienie | : (rzecz.) reorganizacja
rearward : rearward : (przym.) tylny
reason : reason : (czas.) przekonywać | : (czas.) rozumować | : (czas.) stwierdzać | : (czas.) stwierdzić | : (czas.) wyperswadować | : (rzecz.) opamiętanie | : (rzecz.) powód | : (rzecz.) przyczyna | : (rzecz.) racja | : (rzecz.) rozsądek | : (rzecz.) rozum | : (rzecz.) rozwaga | : (rzecz.) uzasadnienie
reasonable : reasonable : (przym.) dorzeczny | : (przym.) rozsądny | : (przym.) rozumny | : (przym.) sensowny | : (przym.) umiarkowany
reasonableness : reasonableness : (rzecz.) rozsądek | : (rzecz.) sensowność
reasonably : reasonably : (przysł.) dość | : (przysł.) racjonalnie | : (przysł.) rozsądnie | : (przysł.) rozumnie | : (przysł.) sensownie
reasoning : reasoning : (rzecz.) argumentacja | : (rzecz.) rozumowanie | : (rzecz.) wnioskowanie | : (rzecz.) wywód
reasonless : reasonless : (przym.) nierozumny
reassembly : reassembly : (rzecz.) montaż | : (rzecz.) składanie
reassert : reassert : (czas.) powtórzyć | : (czas.) wzmacniać
reassess : reassess : (czas.) przeszacować
reassessment : reassessment : (rzecz.) rewidowanie | : (rzecz.) rewizja
reassume : reassume : (czas.) podsumować
reassurance : reassurance : (rzecz.) otucha | : (rzecz.) wsparcie | : (rzecz.) zapewnienie
reassure : reassure : (czas.) pocieszać | : (czas.) pokrzepiać | : (czas.) uspokajać | : (czas.) uspokoić | : (czas.) utwierdzać | : (czas.) utwierdzić | : (czas.) wspomagać | : (czas.) zapewniać | : (czas.) zapewnić
reassuringly : reassuringly : (przysł.) uspokajająco
rebalance : rebalance : (czas.) wyrównać
rebate : rebate : (czas.) zmniejszyć | : (rzecz.) opust | : (rzecz.) rabat
rebel : rebel : (czas.) buntować | : (rzecz.) buntownik | : (rzecz.) rebeliant
rebellion : rebellion : (rzecz.) bunt | : (rzecz.) rebelia | : (rzecz.) rokosz
rebellious : rebellious : (przym.) buntowniczy | : (przym.) rebeliancki
rebelliously : rebelliously : (przysł.) buntowniczo
rebelliousness : rebelliousness : (rzecz.) buntowniczość
rebirth : rebirth : (rzecz.) odradzanie | : (rzecz.) odrodzenie
reboot : reboot : (czas.) przeładować | : (czas.) restartować | : (czas.) wznawiać | : (czas.) wznowić | : (rzecz.) przeładowanie
rebooting : rebooting : (rzecz.) restartowanie
rebound : rebound : (czas.) mścić | : (czas.) obracać | : (czas.) odbić | : (czas.) odbijać | : (czas.) odskakiwać | : (czas.) odzwierciedlać | : (czas.) powracać | : (czas.) rykoszetować | : (rzecz.) odbicie | : (rzecz.) odskok | : (rzecz.) rykoszet
rebroadcast : rebroadcast : (czas.) retransmitować | : (rzecz.) retransmisja
rebroadcasts : rebroadcasts : (czas.) retransmitować
rebuff : rebuff : (czas.) odeprzeć | : (czas.) odmawiać | : (czas.) odmówić | : (czas.) odrzucać | : (czas.) odtrącać | : (rzecz.) odepchnięcie | : (rzecz.) odmowa | : (rzecz.) odrzucenie
rebuild : rebuild : (czas.) odbudować | : (czas.) odbudowywać | : (czas.) przebudować
rebuilt : rebuilt : (czas.) odbudować
rebuke : rebuke : (czas.) karcić | : (czas.) napominać | : (czas.) skarcić | : (czas.) strofować | : (czas.) upominać | : (czas.) wymawiać | : (rzecz.) nagana | : (rzecz.) wymówka | : (rzecz.) zarzut
rebus : rebus : (rzecz.) rebus
rebut : rebut : (czas.) obalać | : (czas.) odeprzeć | : (czas.) odpierać
rebuttal : rebuttal : (rzecz.) odparcie | : (rzecz.) replika
recalcitrance : recalcitrance : (rzecz.) krnąbrność | : (rzecz.) nieposłuszeństwo | : (rzecz.) niesubordynacja | : (rzecz.) upór
recalcitrant : recalcitrant : (przym.) krnąbrny | : (przym.) oporny
recalculate : recalculate : (czas.) przekalkulować | : (czas.) przeliczać
recall : recall : (czas.) budzić | : (czas.) odwoływać | : (czas.) ożywiać | : (czas.) przypominać | : (czas.) przypomnieć | : (czas.) przywołać | : (czas.) wspominać | : (rzecz.) odwołanie | : (rzecz.) pamięć | : (rzecz.) przypominanie | : (rzecz.) przywołanie | : (rzecz.) przywoływanie | : (rzecz.) rewokacja
recant : recant : (czas.) kajać | : (czas.) odwołać | : (czas.) odwoływać | : (czas.) wyprzeć | : (czas.) wyrzekać
recap : recap : (czas.) reasumować | : (czas.) streszczać | : (rzecz.) streszczenie
recapitalize : recapitalize : (czas.) odnawiać
recapitulate : recapitulate : (czas.) podsumować | : (czas.) reasumować | : (czas.) rekapitulować | : (czas.) streszczać | : (czas.) zrekapitulować
recapitulation : recapitulation : (rzecz.) podsumowanie | : (rzecz.) rekapitulacja | : (rzecz.) streszczenie
recapture : recapture : (czas.) odbić | : (czas.) odbijać | : (czas.) odzyskać | : (czas.) odzyskiwać | : (rzecz.) odzyskanie
recast : recast : (czas.) odrzucać | : (czas.) odrzucić | : (czas.) przekształcać | : (czas.) przekształcić | : (czas.) przerabiać | : (czas.) przeredagować | : (czas.) przerobić | : (czas.) przetapiać | : (rzecz.) przeróbka
recede : recede : (czas.) cofać | : (czas.) cofnąć | : (czas.) oddalać | : (czas.) odstąpić | : (czas.) odstępować | : (czas.) zrezygnować
receipt : receipt : (czas.) kwitować | : (czas.) pokwitować | : (rzecz.) kwit | : (rzecz.) kwitariusz | : (rzecz.) kwitek | : (rzecz.) odbiór | : (rzecz.) otrzymanie | : (rzecz.) paragon | : (rzecz.) pokwitowanie | : (rzecz.) potwierdzenie | : (rzecz.) przepis | : (rzecz.) recepis | : (rzecz.) rewers
receipt-book : receipt-book : (rzecz.) kwitariusz
receipts : receipts : (rzecz.) przychód
receivable : receivable : (przym.) należny
receive : receive : (czas.) brać | : (czas.) odbierać | : (czas.) odwołać | : (czas.) otrzymać | : (czas.) otrzymywać | : (czas.) pobierać | : (czas.) przyjmować | : (czas.) uznawać | : (czas.) zawierać
receiver : receiver : (rzecz.) odbieralnik | : (rzecz.) odbiorca | : (rzecz.) odbiornik | : (rzecz.) poborca | : (rzecz.) słuchawka
receivership : receivership : (rzecz.) powiernictwo
recent : recent : (przym.) niedawny | : (przym.) nowy | : (przym.) ostatni | : (przym.) świeży
recently : recently : (przysł.) niedawno | : (przysł.) ostatnio
receptacle : receptacle : (rzecz.) gniazdo | : (rzecz.) naczynie | : (rzecz.) odbieralnik | : (rzecz.) pojemnik | : (rzecz.) schowek | : (rzecz.) zbiornik
reception : reception : (rzecz.) odbiór | : (rzecz.) odebranie | : (rzecz.) portiernia | : (rzecz.) powitanie | : (rzecz.) przyjęcie | : (rzecz.) przyjmowanie | : (rzecz.) recepcja
receptionist : receptionist : (rzecz.) portier | : (rzecz.) recepcjonista
receptive : receptive : (przym.) chłonny | : (przym.) podatny | : (przym.) recepcyjny | : (przym.) receptywny
receptivity : receptivity : (rzecz.) chłonność | : (rzecz.) podatność
receptor : receptor : (rzecz.) chwytnik | : (rzecz.) receptor
recess : recess : (rzecz.) alkowa | : (rzecz.) ferie | : (rzecz.) framuga | : (rzecz.) izolacja | : (rzecz.) izolatka | : (rzecz.) kryjówka | : (rzecz.) nisza | : (rzecz.) odejście | : (rzecz.) odwrót | : (rzecz.) przerwa | : (rzecz.) schowanko | : (rzecz.) wgłębienie | : (rzecz.) wnęka | : (rzecz.) wybranie | : (rzecz.) wykrój | : (rzecz.) zakamarek | : (rzecz.) zatoka
recession : recession : (rzecz.) cofanie | : (rzecz.) recesja | : (rzecz.) zastój
recessionary : recessionary : (przym.) recesyjny
recessive : recessive : (przym.) recesyjny | : (przym.) recesywny
recharge : recharge : (czas.) dopełniać | : (czas.) dopełnić
rechargeable : rechargeable : (przym.) ładowalny
rechristen : rechristen : (czas.) przechrzcić
recidivism : recidivism : (rzecz.) recydywa
recidivist : recidivist : (rzecz.) recydywista
recipe : recipe : (rzecz.) pokwitowanie | : (rzecz.) przepis | : (rzecz.) recepta | : (rzecz.) receptura
recipient : recipient : (przym.) odbiorczy | : (rzecz.) biorca | : (rzecz.) odbiorca | : (rzecz.) usługobiorca
reciprocal : reciprocal : (przym.) obopólny | : (przym.) obustronny | : (przym.) odwrotny | : (przym.) wzajemny | : (rzecz.) odwrotność
reciprocally : reciprocally : (przysł.) obopólnie | : (przysł.) wzajemnie
reciprocate : reciprocate : (czas.) odpłacać | : (czas.) odwzajemniać | : (czas.) rewanżować | : (czas.) wymieniać
reciprocation : reciprocation : (rzecz.) odwzajemnienie | : (rzecz.) wzajemność
reciprocity : reciprocity : (rzecz.) odwzajemnienie | : (rzecz.) wyszczególnienie | : (rzecz.) wzajemność
recirculation : recirculation : (rzecz.) recyrkulacja
recital : recital : (rzecz.) opowiadanie | : (rzecz.) recital | : (rzecz.) recytowanie
recitals : recitals : (rzecz.) opowiadanie | : (rzecz.) preambuła
recitation : recitation : (rzecz.) deklamacja | : (rzecz.) recytacja
recitative : recitative : (przym.) deklamacyjny | : (rzecz.) recytatyw
recite : recite : (czas.) deklamować | : (czas.) recytować | : (czas.) relacjonować
reckless : reckless : (przym.) beztroski | : (przym.) lekkomyślny | : (przym.) niedbały | : (przym.) nieopatrzny | : (przym.) nieostrożny | : (przym.) nierozważny | : (przym.) ruchliwy | : (przym.) ryzykancki
recklessly : recklessly : (przysł.) beztrosko | : (przysł.) lekkomyślnie | : (przysł.) nieostrożnie | : (przysł.) nierozważnie | : (przysł.) pochopnie
recklessness : recklessness : (rzecz.) brawura | : (rzecz.) junactwo | : (rzecz.) lekkomyślność | : (rzecz.) nierozwaga | : (rzecz.) ryzykanctwo
reckon : reckon : (czas.) cyrklować | : (czas.) kalkulować | : (czas.) liczyć | : (czas.) myśleć | : (czas.) obliczać | : (czas.) policzyć | : (czas.) przypuszczać | : (czas.) rachować | : (czas.) sądzić | : (czas.) uważać | : (czas.) wnioskować
reckoning : reckoning : (rzecz.) porachunek | : (rzecz.) rachunek | : (rzecz.) rozliczenie | : (rzecz.) rozrachunek | : (rzecz.) sąd | : (rzecz.) wniosek | : (rzecz.) zaliczanie
reclaim : reclaim : (czas.) meliorować | : (czas.) nawracać | : (czas.) odbierać | : (czas.) odzyskać | : (czas.) odzyskiwać | : (czas.) poprawiać | : (czas.) regenerować | : (czas.) reklamować | : (czas.) resocjalizować | : (czas.) wycofać | : (czas.) wycofywać
reclamation : reclamation : (rzecz.) melioracja | : (rzecz.) nawracanie | : (rzecz.) odzyskiwanie | : (rzecz.) regeneracja | : (rzecz.) reklamacja | : (rzecz.) rekultywacja | : (rzecz.) zażalenie
recline : recline : (czas.) odpoczywać | : (czas.) pochylać | : (czas.) spoczywać | : (czas.) zajmować
recliner : recliner : (rzecz.) fotel | : (rzecz.) leżanka
recluse : recluse : (przym.) pustelniczy | : (przym.) samotny | : (rzecz.) odludek | : (rzecz.) pustelnik | : (rzecz.) samotnik
reclusive : reclusive : (przym.) samotniczy
recode : recode : (czas.) przekodować | : (czas.) przekodowywać
recoding : recoding : (rzecz.) przekodowywanie
recognisable : recognisable : (przym.) rozpoznawalny
recognise : recognise : (czas.) rozpoznać
recognition : recognition : (rzecz.) identyfikacja | : (rzecz.) przyznanie | : (rzecz.) rozpoznanie | : (rzecz.) rozpoznawalność | : (rzecz.) rozpoznawanie | : (rzecz.) ujmowanie | : (rzecz.) uznanie | : (rzecz.) uznawanie
recognizable : recognizable : (przym.) rozpoznawalny
recognizably : recognizably : (przysł.) wyraźnie
recognizance : recognizance : (rzecz.) kaucja
recognize : recognize : (czas.) honorować | : (czas.) poznać | : (czas.) poznawać | : (czas.) rozpoznać | : (czas.) rozpoznawać | : (czas.) uznać | : (czas.) uznawać
recoil : recoil : (czas.) cofać | : (czas.) odskakiwać | : (czas.) odskoczyć | : (czas.) wzdragać | : (rzecz.) odrzut | : (rzecz.) odskok | : (rzecz.) pchnięcie
recoilless : recoilless : (przym.) bezodrzutowy
recollect : recollect : (czas.) przypominać | : (czas.) wspominać | : (czas.) wzmiankować | : (czas.) zbierać
recollection : recollection : (rzecz.) anamneza | : (rzecz.) pamięć | : (rzecz.) przypomnienie | : (rzecz.) wspomnienie
recombination : recombination : (rzecz.) rekombinacja
recombine : recombine : (czas.) mieszać | : (czas.) zmieszać
recommence : recommence : (czas.) wznawiać | : (czas.) wznowić
recommencement : recommencement : (rzecz.) rozpoczęcie
recommend : recommend : (czas.) polecać | : (czas.) polecić | : (czas.) rekomendować | : (czas.) zalecać | : (czas.) zalecić | : (czas.) zarekomendować
recommendation : recommendation : (rzecz.) polecanie | : (rzecz.) polecenie | : (rzecz.) rekomendacja | : (rzecz.) zalecenie
recommit : recommit : (czas.) odsyłać | : (czas.) powierzać
recompense : recompense : (czas.) nagradzać | : (czas.) rekompensować | : (czas.) wynagradzać | : (rzecz.) rekompensata | : (rzecz.) wynagrodzenie
recompose : recompose : (czas.) dekomponować
reconcile : reconcile : (czas.) godzić | : (czas.) pojednać | : (czas.) uzgadniać | : (czas.) uzgodnić | : (czas.) wyrównać | : (czas.) zgadzać
reconcilement : reconcilement : (rzecz.) pogodzenie | : (rzecz.) pojednanie | : (rzecz.) zgoda
reconciliation : reconciliation : (rzecz.) pogodzenie | : (rzecz.) pojednanie | : (rzecz.) uzgodnienie | : (rzecz.) zgoda
recondite : recondite : (przym.) tajemny
recondition : recondition : (czas.) odnawiać | : (czas.) odnowić
reconfiguration : reconfiguration : (rzecz.) rekonfiguracja
reconfigurations : reconfigurations : (rzecz.) rekonfiguracja
reconfigure : reconfigure : (czas.) przekształcać | : (czas.) rekonfigurować
reconnaissance : reconnaissance : (rzecz.) rekonesans | : (rzecz.) rozpoznanie | : (rzecz.) zwiad
reconnoitre : reconnoitre : (czas.) badać | : (czas.) rozpoznawać | : (czas.) zbadać
reconsider : reconsider : (czas.) przemyśleć
reconsideration : reconsideration : (rzecz.) rewizja | : (rzecz.) zrewidowanie
reconstruct : reconstruct : (czas.) odbudować | : (czas.) odbudowywać | : (czas.) odtwarzać | : (czas.) odtworzyć | : (czas.) przebudować | : (czas.) rekonstruować | : (czas.) zrekonstruować
reconstruction : reconstruction : (rzecz.) odbudowa | : (rzecz.) odbudowanie | : (rzecz.) przebudowa | : (rzecz.) rekonstrukcja
reconstructive : reconstructive : (przym.) rekonstrukcyjny
record : record : (czas.) doliczać | : (czas.) ewidencjonować | : (czas.) nagrać | : (czas.) nagrywać | : (czas.) notować | : (czas.) odnotować | : (czas.) odnotowywać | : (czas.) protokołować | : (czas.) protokółować | : (czas.) rejestrować | : (czas.) spisywać | : (czas.) uwieczniać | : (czas.) zanotować | : (czas.) zapisać | : (czas.) zapisywać | : (rzecz.) akta | : (rzecz.) dowód | : (rzecz.) ewidencja | : (rzecz.) nagranie | : (rzecz.) nagrywanie | : (rzecz.) notatka | : (rzecz.) płyta | : (rzecz.) protokół | : (rzecz.) rejestr | : (rzecz.) rekord | : (rzecz.) rekordzista | : (rzecz.) spis | : (rzecz.) świadectwo | : (rzecz.) tekst | : (rzecz.) zapis | : (rzecz.) zapisanie
record-holder : record-holder : (rzecz.) rekordzista
record-player : record-player : (rzecz.) adapter | : (rzecz.) gramofon
recorder : recorder : (rzecz.) dyktafon | : (rzecz.) flet | : (rzecz.) kronikarz | : (rzecz.) protokolant | : (rzecz.) protokólant | : (rzecz.) rejestrator | : (rzecz.) samopis
recording : recording : (przym.) zapisowy | : (rzecz.) nagranie | : (rzecz.) nagrywanie | : (rzecz.) rejestrowanie | : (rzecz.) utrwalanie | : (rzecz.) zapis | : (rzecz.) zapisanie | : (rzecz.) zapisywanie
recount : recount : (czas.) opowiadać | : (czas.) zrelacjonować
recoup : recoup : (czas.) potrącać | : (czas.) potrącić
recourse : recourse : (rzecz.) regres | : (rzecz.) ucieczka | : (rzecz.) uciekanie | : (rzecz.) zwrócenie
recover : recover : (czas.) ochłonąć | : (czas.) odzyskać | : (czas.) odzyskiwać | : (czas.) windykować | : (czas.) wyzdrowieć | : (czas.) zdrowieć
recovered : recovered : (przym.) zdrów
recovery : recovery : (rzecz.) nawrót | : (rzecz.) odtwarzanie | : (rzecz.) odzysk | : (rzecz.) odzyskanie | : (rzecz.) odzyskiwanie | : (rzecz.) ożywienie | : (rzecz.) podźwignięcie | : (rzecz.) poprawa | : (rzecz.) powrót | : (rzecz.) regeneracja | : (rzecz.) rekompensata | : (rzecz.) windykacja | : (rzecz.) wyzdrowienie | : (rzecz.) zdrowienie | : (rzecz.) zwrot
recreant : recreant : (przym.) małoduszny | : (przym.) tchórzliwy
recreate : recreate : (czas.) bawić | : (czas.) odtwarzać | : (czas.) odtworzyć | : (czas.) rozerwać | : (czas.) rozrywać
recreation : recreation : (rzecz.) odpoczynek | : (rzecz.) przerwa | : (rzecz.) rekreacja | : (rzecz.) rozrywka | : (rzecz.) zabawa
recreational : recreational : (przym.) rekreacyjny
recrimination : recrimination : (rzecz.) rekryminacja
recrudesce : recrudesce : (czas.) powracać | : (czas.) powrócić
recruit : recruit : (czas.) rekrutować | : (czas.) werbować | : (rzecz.) rekrut
recruitment : recruitment : (rzecz.) branka | : (rzecz.) nabór | : (rzecz.) pobór | : (rzecz.) rekrutacja | : (rzecz.) werbowanie | : (rzecz.) werbownik | : (rzecz.) werbunek | : (rzecz.) zaciąg
recta : recta : (przym.) odbytnicowy
rectal : rectal : (przym.) odbytniczy | : (przym.) stolcowy
rectangle : rectangle : (rzecz.) prostokąt
rectangular : rectangular : (przym.) prostokątny
rectifiable : rectifiable : (przym.) prostowalny
rectification : rectification : (rzecz.) poprawka | : (rzecz.) prostowanie | : (rzecz.) rektyfikacja | : (rzecz.) sprostowanie
rectifier : rectifier : (rzecz.) prostownica | : (rzecz.) prostownik | : (rzecz.) rektyfikator
rectify : rectify : (czas.) naprawiać | : (czas.) naprawić | : (czas.) oczyszczać | : (czas.) poprawiać | : (czas.) prostować | : (czas.) rektyfikować | : (czas.) skorygować | : (czas.) sprostować
rectilinear : rectilinear : (przym.) prostolinijny | : (przym.) prostoliniowy
rectitude : rectitude : (rzecz.) prawość | : (rzecz.) prostota | : (rzecz.) uczciwość
rector : rector : (rzecz.) proboszcz | : (rzecz.) rektor
rectory : rectory : (rzecz.) probostwo
rectum : rectum : (rzecz.) odbytnica | : (rzecz.) prostnica
recumbent : recumbent : (przym.) bezczynny | : (przym.) leżący
recuperate : recuperate : (czas.) odzyskiwać | : (czas.) wyleczyć | : (czas.) wyzdrowieć
recuperation : recuperation : (rzecz.) odzyskiwanie | : (rzecz.) rekonwalescencja | : (rzecz.) rekuperacja
recur : recur : (czas.) nawracać | : (czas.) powracać | : (czas.) powrócić | : (czas.) powtarzać | : (czas.) uciekać | : (czas.) wracać
recurrence : recurrence : (rzecz.) częstotliwość | : (rzecz.) nawracanie | : (rzecz.) nawrót | : (rzecz.) powrót | : (rzecz.) powtarzanie | : (rzecz.) recydywa | : (rzecz.) rekurencja
recurrent : recurrent : (przym.) niejednokrotny | : (przym.) okresowy | : (przym.) powrotny | : (przym.) rekurencyjny
recurrently : recurrently : (przysł.) powtarzalnie
recurring : recurring : (czas.) nawracać
recursion : recursion : (rzecz.) rekurencja | : (rzecz.) samookreślenie
recursive : recursive : (przym.) rekurencyjny | : (przym.) rekursywny
recursively : recursively : (przysł.) wielokrotnie
recycle : recycle : (czas.) przerabiać | : (czas.) przetwarzać | : (czas.) przetworzyć
red : red : (przym.) czerwony | : (przym.) krwawy | : (przym.) rewolucyjny | : (przym.) rudy | : (rzecz.) czerwień | : (rzecz.) komunista | : (rzecz.) minia
red-haired : red-haired : (przym.) rudy | : (przym.) ryży
redact : redact : (czas.) zredagować
redden : redden : (czas.) czerwienić | : (czas.) poczerwienieć | : (czas.) zaczerwienić
reddening : reddening : (rzecz.) zaczerwienienie
reddish : reddish : (przym.) czerwonawy | : (przym.) rudawy
redecorate : redecorate : (czas.) odmalować | : (czas.) odnawiać | : (czas.) remontować | : (czas.) wyremontować
redecoration : redecoration : (rzecz.) odnowienie | : (rzecz.) remont
redeem : redeem : (czas.) odkupić | : (czas.) odkupywać | : (czas.) umarzać | : (czas.) uratować | : (czas.) uwalniać | : (czas.) uwolnić | : (czas.) wybawiać | : (czas.) zbawiać | : (czas.) zbawić | : (czas.) zrehabilitować
redeemable : redeemable : (przym.) odkupny | : (przym.) umarzalny
redeemer : redeemer : (rzecz.) odkupiciel | : (rzecz.) wybawca
redefine : redefine : (czas.) przedefiniować
redefinition : redefinition : (rzecz.) przedefiniowanie
redemption : redemption : (rzecz.) amortyzacja | : (rzecz.) odkupienie | : (rzecz.) odzyskanie | : (rzecz.) uwolnienie | : (rzecz.) wykup | : (rzecz.) zbawienie
redemptive : redemptive : (przym.) odkupicielski
redenomination : redenomination : (rzecz.) denominacja
redeploy : redeploy : (czas.) przebazować
redeployment : redeployment : (rzecz.) przebazowanie | : (rzecz.) przegrupowanie | : (rzecz.) przerzut
redesign : redesign : (czas.) przekonstruować | : (czas.) przeprojektować
redesigning : redesigning : (rzecz.) przybliżanie
redevelop : redevelop : (czas.) odbudować
redevelopment : redevelopment : (rzecz.) przebudowa
redfish : redfish : (rzecz.) karmazyn
redhead : redhead : (rzecz.) rudowłosa | : (rzecz.) rudzielec
redheaded : redheaded : (przym.) rudowłosy
redid : redid : (czas.) poprawić | : (czas.) przerabiać | : (czas.) przerobić | : (czas.) zmieniać | : (czas.) zmienić
redirect : redirect : (czas.) przeadresować
redirected : redirected : (czas.) przeadresować
redirecting : redirecting : (czas.) przeadresować
redirection : redirection : (rzecz.) przeadresowanie
redirector : redirector : (rzecz.) zwrotnica
rediscount : rediscount : (rzecz.) redyskonto
redisplay : redisplay : (czas.) wyświetlać
redistribute : redistribute : (czas.) redystrybuować
redistributed : redistributed : (czas.) redystrybuować
redistributes : redistributes : (czas.) redystrybuować
redistributing : redistributing : (czas.) redystrybuować
redistribution : redistribution : (rzecz.) redystrybucja
redline : redline : (rzecz.) redlina | : (rzecz.) wyróżnienie
redlining : redlining : (rzecz.) wyróżnianie
redness : redness : (rzecz.) czerwoność | : (rzecz.) rudość | : (rzecz.) rumień | : (rzecz.) zaczerwienienie
redo : redo : (czas.) ponawiać | : (czas.) ponowić | : (czas.) powtórzyć | : (czas.) przerabiać
redolent : redolent : (przym.) aromatyczny | : (przym.) wonny | : (przym.) zalatujący
redone : redone : (czas.) przerabiać | : (czas.) przerobić
redouble : redouble : (czas.) dublować | : (czas.) mnożyć | : (czas.) podwajać | : (czas.) podwoić | : (czas.) rekontrować
redoubt : redoubt : (rzecz.) reduta
redoubtable : redoubtable : (przym.) śmiały | : (przym.) straszny
redpoll : redpoll : (rzecz.) czeczotka
redraw : redraw : (czas.) przerysować
redrawing : redrawing : (rzecz.) przerysowywanie | : (rzecz.) przetłaczanie
redress : redress : (czas.) naprawiać | : (czas.) naprawić | : (czas.) wyrównać | : (czas.) wyrównywać | : (rzecz.) rekompensata
redstart : redstart : (rzecz.) pleszka
reduce : reduce : (czas.) doprowadzać | : (czas.) obniżać | : (czas.) ograniczać | : (czas.) pokonać | : (czas.) pomniejszać | : (czas.) redukować | : (czas.) schudnąć | : (czas.) skracać | : (czas.) sprowadzać | : (czas.) uszczuplać | : (czas.) zmniejszać | : (czas.) zredukować
reduced : reduced : (przym.) ulgowy | : (przym.) zniżkowy
reducer : reducer : (rzecz.) osłabiacz | : (rzecz.) reduktor | : (rzecz.) rozcieńczalnik
reducibility : reducibility : (rzecz.) redukowalność | : (rzecz.) sprowadzalność
reduction : reduction : (rzecz.) bonifikata | : (rzecz.) doprowadzenie | : (rzecz.) obniżenie | : (rzecz.) obniżka | : (rzecz.) odtlenianie | : (rzecz.) odtlenienie | : (rzecz.) podbój | : (rzecz.) redukcja | : (rzecz.) spowodowanie | : (rzecz.) zmniejszanie | : (rzecz.) zmniejszenie
reductive : reductive : (przym.) redukcyjny
redundancy : redundancy : (rzecz.) nadkomplet | : (rzecz.) nadmiar | : (rzecz.) nadmiarowość | : (rzecz.) nadmierność | : (rzecz.) niepotrzebność | : (rzecz.) redukcja | : (rzecz.) redundancja | : (rzecz.) rezerwowanie | : (rzecz.) rozwlekłość | : (rzecz.) zależność | : (rzecz.) zbędność | : (rzecz.) zwielokrotnienie
redundant : redundant : (przym.) nadliczbowy | : (przym.) nadmiarowy | : (przym.) nadmierny | : (przym.) niepotrzebny | : (przym.) redundancyjny | : (przym.) rezerwowy | : (przym.) rozwlekły | : (przym.) wielomówny | : (przym.) zbędny | : (przym.) zbyteczny
redundantly : redundantly : (przysł.) nadmiernie
reduplication : reduplication : (rzecz.) reduplikacja
redwood : redwood : (rzecz.) sekwoja
reed : reed : (rzecz.) piszczałka | : (rzecz.) płocha | : (rzecz.) stroik | : (rzecz.) szuwar | : (rzecz.) trzcina | : (rzecz.) trzcinka
reediest : reediest : (przym.) beznasienny
reedit : reedit : (czas.) remontować
reedy : reedy : (przym.) cienki | : (przym.) piskliwy | : (przym.) trzcinowy
reef : reef : (czas.) refować
reefer : reefer : (rzecz.) chłodniowiec | : (rzecz.) kurtka | : (rzecz.) lodówka
reek : reek : (czas.) cuchnąć | : (czas.) dymić | : (czas.) kopcić | : (czas.) kurzyć | : (czas.) palić | : (czas.) śmierdzieć | : (czas.) smrodzić | : (rzecz.) dym | : (rzecz.) para | : (rzecz.) smród | : (rzecz.) wyziew | : (rzecz.) wyziewanie
reel : reel : (czas.) kręcić | : (czas.) motać | : (czas.) nawijać | : (czas.) zakołysać | : (czas.) zataczać | : (rzecz.) cewka | : (rzecz.) kołowrotek | : (rzecz.) motowidło | : (rzecz.) szpula | : (rzecz.) szpulka | : (rzecz.) zataczanie | : (rzecz.) zwój
reeve : reeve : (rzecz.) trzcina
refection : refection : (rzecz.) posiłek
refectory : refectory : (rzecz.) refektarz
refer : refer : (czas.) dotyczyć | : (czas.) nawiązać | : (czas.) nawiązywać | : (czas.) odnieść | : (czas.) odnosić | : (czas.) odsyłać | : (czas.) odwołać | : (czas.) odwoływać | : (czas.) powoływać | : (czas.) skierować | : (czas.) tyczyć | : (czas.) zajrzeć | : (czas.) zwracać
referee : referee : (czas.) sędziować | : (rzecz.) arbiter | : (rzecz.) rozjemca | : (rzecz.) sędzia
reference : reference : (rzecz.) nawiązanie | : (rzecz.) odesłanie | : (rzecz.) odniesienie | : (rzecz.) odnośnik | : (rzecz.) odsyłacz | : (rzecz.) odwołanie | : (rzecz.) powołanie | : (rzecz.) powoływanie | : (rzecz.) przypis | : (rzecz.) referencja | : (rzecz.) sygnatura | : (rzecz.) wymienienie | : (rzecz.) wzmianka
referendum : referendum : (rzecz.) referendum
referent : referent : (rzecz.) referent
referential : referential : (przym.) odnośny
referral : referral : (rzecz.) odesłanie | : (rzecz.) odniesienie | : (rzecz.) przekazywanie | : (rzecz.) skierowanie
refill : refill : (czas.) dolać | : (czas.) napełniać | : (rzecz.) wkład
refillable : refillable : (przym.) wielorazowy
refinance : refinance : (czas.) refinansować | : (czas.) zrefinansować | : (rzecz.) refinansowanie
refinancing : refinancing : (rzecz.) dofinansowanie | : (rzecz.) refinansowanie
refine : refine : (czas.) dopracować | : (czas.) doskonalić | : (czas.) oczyszczać | : (czas.) rafinować | : (czas.) uściślić | : (czas.) uszlachetniać
refined : refined : (przym.) dystyngowany | : (przym.) nobliwy | : (przym.) wytworny
refinement : refinement : (rzecz.) dystynkcja | : (rzecz.) elegancja | : (rzecz.) obycie | : (rzecz.) oczyszczanie | : (rzecz.) ogłada | : (rzecz.) polor | : (rzecz.) rafinacja | : (rzecz.) rafinowanie | : (rzecz.) uściślenie | : (rzecz.) wykwintność | : (rzecz.) wyrafinowanie | : (rzecz.) wytworność | : (rzecz.) zagęszczenie
refiner : refiner : (rzecz.) rafinator | : (rzecz.) rafiner
refinery : refinery : (rzecz.) rafineria
refit : refit : (czas.) naprawiać | : (rzecz.) remont
reflect : reflect : (czas.) namyślać | : (czas.) odbijać | : (czas.) odzwierciedlać | : (czas.) odzwierciedlić | : (czas.) rozmyślać | : (czas.) rozważać | : (czas.) zastanawiać
reflection : reflection : (rzecz.) namysł | : (rzecz.) namyślanie | : (rzecz.) odbicie | : (rzecz.) odblask | : (rzecz.) odzwierciedlenie | : (rzecz.) opamiętanie | : (rzecz.) refleksja | : (rzecz.) rozmyślanie | : (rzecz.) uwaga | : (rzecz.) zaduma | : (rzecz.) zastanowienie
reflections : reflections : (rzecz.) refleksja
reflective : reflective : (przym.) myślący | : (przym.) odbijający | : (przym.) odblaskowy | : (przym.) refleksyjny | : (przym.) zwrotny
reflectively : reflectively : (przysł.) refleksyjnie
reflector : reflector : (rzecz.) odbłyśnik | : (rzecz.) reflektor
reflex : reflex : (przym.) refleksowy | : (rzecz.) odbicie | : (rzecz.) odruch | : (rzecz.) reakcja | : (rzecz.) refleks
reflexes : reflexes : (rzecz.) refleks
reflexive : reflexive : (przym.) odruchowy | : (przym.) zwrotny
reflexively : reflexively : (przysł.) refleksyjnie | : (przysł.) zwrotnie
reflexivity : reflexivity : (rzecz.) refleksywność | : (rzecz.) zwrotność
reflux : reflux : (rzecz.) flegma | : (rzecz.) odpływ | : (rzecz.) orosienie
reforestation : reforestation : (rzecz.) zalesianie
reform : reform : (czas.) poprawiać | : (czas.) przekształcać | : (czas.) reformować | : (czas.) zreformować | : (rzecz.) poprawa | : (rzecz.) reforma | : (rzecz.) reformy
reformation : reformation : (rzecz.) nawrócenie | : (rzecz.) poprawa | : (rzecz.) reforma | : (rzecz.) reformacja
reformative : reformative : (przym.) poprawczy | : (przym.) reformatorski
reformatory : reformatory : (przym.) poprawczy | : (przym.) reformatorski | : (rzecz.) poprawczak
reformatting : reformatting : (rzecz.) przeformatowywanie
reformer : reformer : (rzecz.) reformator
reformism : reformism : (rzecz.) reformizm
reformist : reformist : (rzecz.) reformator | : (rzecz.) reformista
reformulate : reformulate : (czas.) przeformułować | : (czas.) przeformułowywać
reformulated : reformulated : (czas.) przeformułować
reformulating : reformulating : (rzecz.) przeformułowywanie
refract : refract : (czas.) łamać | : (czas.) załamywać
refraction : refraction : (rzecz.) refrakcja | : (rzecz.) załamanie
refractive : refractive : (przym.) refrakcyjny
refractor : refractor : (rzecz.) refraktor
refractoriness : refractoriness : (rzecz.) ogniotrwałość
refractory : refractory : (przym.) buntowniczy | : (przym.) nieposłuszny | : (przym.) ogniotrwały | : (przym.) oporny | : (przym.) refrakcyjny | : (przym.) uparty
refrain : refrain : (czas.) powstrzymać | : (czas.) powstrzymywać | : (czas.) wstrzymać | : (czas.) wystrzegać | : (rzecz.) refren
refresh : refresh : (czas.) chłodzić | : (czas.) krzepić | : (czas.) odświeżać | : (czas.) odświeżyć | : (czas.) orzeźwiać | : (czas.) pokrzepiać | : (czas.) pokrzepić | : (czas.) posilać | : (czas.) rzeźwić
refresher : refresher : (rzecz.) orzeźwienie | : (rzecz.) utrwalenie
refreshingly : refreshingly : (przysł.) odświeżająco
refreshment : refreshment : (rzecz.) ochłoda | : (rzecz.) odpoczynek | : (rzecz.) odświeżenie | : (rzecz.) orzeźwienie | : (rzecz.) pokrzepienie | : (rzecz.) przekąska | : (rzecz.) wypoczynek | : (rzecz.) zakąska
refreshments : refreshments : (rzecz.) poczęstunek
refrigerate : refrigerate : (czas.) chłodzić | : (czas.) ochładzać | : (czas.) ochłodzić | : (czas.) zamrażać
refrigeration : refrigeration : (rzecz.) chłodnictwo | : (rzecz.) chłodzenie | : (rzecz.) ochładzanie | : (rzecz.) oziębianie | : (rzecz.) oziębienie | : (rzecz.) zamrażanie
refrigerator : refrigerator : (rzecz.) chłodnia | : (rzecz.) chłodziarka | : (rzecz.) lodówka | : (rzecz.) mrożnia
refuel : refuel : (czas.) tankować | : (czas.) zatankować
refuge : refuge : (rzecz.) ostoja | : (rzecz.) przytułek | : (rzecz.) schronienie | : (rzecz.) zacisze
refugee : refugee : (rzecz.) uchodźca | : (rzecz.) uciekinier | : (rzecz.) zbieg
refugees : refugees : (rzecz.) prawnik
refulgence : refulgence : (rzecz.) blask | : (rzecz.) jasność
refulgent : refulgent : (przym.) promienny
refund : refund : (czas.) refundować | : (czas.) spłatać | : (czas.) zwracać | : (rzecz.) refundacja | : (rzecz.) zwrot
refurbish : refurbish : (czas.) odnawiać
refurbishment : refurbishment : (rzecz.) odnawianie | : (rzecz.) odnowienie | : (rzecz.) odświeżenie | : (rzecz.) renowacja
refurnish : refurnish : (czas.) przemeblować
refusal : refusal : (rzecz.) odmowa
refuse : refuse : (czas.) odmawiać | : (czas.) odmówić | : (czas.) odrzucać | : (czas.) odrzucić | : (czas.) wzbraniać | : (rzecz.) odpad | : (rzecz.) odpadki
refused : refused : (czas.) odmawiać | : (czas.) odmówić
refutation : refutation : (rzecz.) obalenie | : (rzecz.) sprostowanie | : (rzecz.) zaprzeczenie | : (rzecz.) zbicie
refute : refute : (czas.) obalać | : (czas.) obalić | : (czas.) odpierać | : (czas.) sprostować | : (czas.) zaprzeczyć
regain : regain : (czas.) odzyskać
regained : regained : (czas.) odzyskiwać | : (czas.) powracać
regal : regal : (przym.) królewski
regale : regale : (czas.) gościć | : (czas.) raczyć | : (czas.) uraczyć | : (rzecz.) uczta
regalia : regalia : (rzecz.) insygnia
regard : regard : (czas.) dotyczyć | : (rzecz.) odniesienie | : (rzecz.) poważanie | : (rzecz.) szacunek | : (rzecz.) troska | : (rzecz.) ukłon | : (rzecz.) uwaga | : (rzecz.) wzgląd
regardful : regardful : (przym.) staranny
regardless : regardless : (przym.) niebaczny | : (przym.) nieuważny
regatta : regatta : (rzecz.) regaty
regattas : regattas : (rzecz.) regaty
regency : regency : (rzecz.) regencja
regenerate : regenerate : (czas.) odnawiać | : (czas.) odraczać | : (czas.) odradzać | : (czas.) odrodzić | : (czas.) odtwarzać | : (czas.) regenerować | : (czas.) zregenerować
regeneration : regeneration : (rzecz.) odradzanie | : (rzecz.) odrodzenie | : (rzecz.) regeneracja | : (rzecz.) rekuperacja | : (rzecz.) rewaloryzacja | : (rzecz.) rewitalizacja
regenerative : regenerative : (przym.) regeneracyjny
regenerator : regenerator : (rzecz.) regenerator
regent : regent : (rzecz.) regent
reggae : reggae : (rzecz.) reggae
regicide : regicide : (rzecz.) królobójca | : (rzecz.) królobójstwo
regime : regime : (rzecz.) reżim | : (rzecz.) reżym | : (rzecz.) ustrój
regimen : regimen : (rzecz.) regulamin | : (rzecz.) reżim
regiment : regiment : (rzecz.) hufiec | : (rzecz.) pułk | : (rzecz.) rząd
regimental : regimental : (przym.) pułkowy | : (przym.) regimentowy
regimentation : regimentation : (rzecz.) zdyscyplinowanie | : (rzecz.) zorganizowanie
region : region : (rzecz.) kraina | : (rzecz.) obszar | : (rzecz.) okolica | : (rzecz.) połać | : (rzecz.) region | : (rzecz.) rejon | : (rzecz.) strefa | : (rzecz.) zakres
regional : regional : (przym.) okręgowy | : (przym.) regionalny
regionalism : regionalism : (rzecz.) regionalizm
regionalization : regionalization : (rzecz.) rejonizacja
regionally : regionally : (przysł.) regionalnie
register : register : (czas.) ewidencjonować | : (czas.) meldować | : (czas.) rejestrować | : (czas.) wstrzelać | : (czas.) zameldować | : (czas.) zarejestrować | : (rzecz.) dziennik | : (rzecz.) księga | : (rzecz.) lista | : (rzecz.) notowanie | : (rzecz.) polecanie | : (rzecz.) rejestr | : (rzecz.) rejestrowanie | : (rzecz.) spis | : (rzecz.) wykazanie | : (rzecz.) zarejestrowanie
registered : registered : (czas.) akredytować
registrar : registrar : (rzecz.) archiwariusz | : (rzecz.) archiwista | : (rzecz.) sekretarz | : (rzecz.) urzędnik
registration : registration : (rzecz.) rejestracja | : (rzecz.) wpis | : (rzecz.) zameldowanie | : (rzecz.) zapis | : (rzecz.) zgłoszenie
registry : registry : (rzecz.) registratura | : (rzecz.) rejestr
regress : regress : (czas.) cofać
regression : regression : (rzecz.) cofanie | : (rzecz.) regres | : (rzecz.) regresja
regressive : regressive : (przym.) powrotny | : (przym.) regresyjny | : (przym.) regresywny | : (przym.) wsteczny
regret : regret : (czas.) żałować | : (rzecz.) ubolewanie | : (rzecz.) żal
regretful : regretful : (przym.) skruszony
regrettable : regrettable : (przym.) opłakany | : (przym.) żałosny
regrettably : regrettably : (przysł.) niestety
regroup : regroup : (czas.) przegrupować | : (czas.) przegrupowywać
regrouping : regrouping : (rzecz.) przegrupowanie
regroupings : regroupings : (rzecz.) przegrupowanie
regular : regular : (przym.) foremny | : (przym.) istny | : (przym.) miarowy | : (przym.) normalny | : (przym.) prawidłowy | : (przym.) przepisowy | : (przym.) regularny | : (przym.) systematyczny
regularities : regularities : (rzecz.) regularności
regularity : regularity : (rzecz.) miarowość | : (rzecz.) prawidłowość | : (rzecz.) regularność | : (rzecz.) systematyczność
regularization : regularization : (rzecz.) regulowanie | : (rzecz.) uporządkowanie
regularize : regularize : (czas.) regulować | : (czas.) uporządkować | : (czas.) uporządkowywać | : (czas.) uregulować
regularly : regularly : (przysł.) regularnie | : (przysł.) systematycznie
regulate : regulate : (czas.) doregulować | : (czas.) kierować | : (czas.) naregulować | : (czas.) reglamentować | : (czas.) regulować | : (czas.) uregulować
regulation : regulation : (rzecz.) przepis | : (rzecz.) reglamentacja | : (rzecz.) regulacja | : (rzecz.) regulamin | : (rzecz.) regulowanie | : (rzecz.) rozporządzenie | : (rzecz.) ujednostajnianie | : (rzecz.) ujednostajnienie | : (rzecz.) uregulowanie | : (rzecz.) zarządzanie | : (rzecz.) zarządzenie
regulations : regulations : (rzecz.) regulamin
regulator : regulator : (rzecz.) regulator
regulatory : regulatory : (przym.) regulacyjny | : (przym.) regulaminowy | : (przym.) wykonawczy
regurgitate : regurgitate : (czas.) cofać | : (czas.) zwracać
regurgitation : regurgitation : (rzecz.) zwracanie
rehab : rehab : (rzecz.) rehabilitacja
rehabilitate : rehabilitate : (czas.) rehabilitować
rehabilitation : rehabilitation : (rzecz.) rehabilitacja | : (rzecz.) resocjalizacja | : (rzecz.) rewalidacja
rehash : rehash : (rzecz.) przeróbka
rehear : rehear : (czas.) przesłuchać | : (czas.) przesłuchiwać
rehearsal : rehearsal : (rzecz.) kontrola | : (rzecz.) korepetycja | : (rzecz.) powtórka | : (rzecz.) próba | : (rzecz.) występ
rehearse : rehearse : (czas.) ćwiczyć | : (czas.) powtarzać | : (czas.) próbować
reheat : reheat : (czas.) odgrzać
reification : reification : (rzecz.) reifikacja | : (rzecz.) uprzedmiotowienie | : (rzecz.) urzeczowienie | : (rzecz.) uściślanie
reify : reify : (czas.) konkretyzować
reign : reign : (czas.) królować | : (czas.) panować | : (czas.) rządzić | : (czas.) władać | : (rzecz.) panowanie | : (rzecz.) władanie | : (rzecz.) władza
reimburse : reimburse : (czas.) zrefundować | : (czas.) zwracać
reimbursement : reimbursement : (rzecz.) refundacja | : (rzecz.) zwrot
rein : rein : (czas.) kontrolować | : (czas.) powstrzymywać | : (rzecz.) cugle | : (rzecz.) lędźwie | : (rzecz.) lejce | : (rzecz.) nóżka | : (rzecz.) wspora
reincarnation : reincarnation : (rzecz.) reinkarnacja
reindeer : reindeer : (rzecz.) ren | : (rzecz.) renifer
reinforce : reinforce : (czas.) podeprzeć | : (czas.) umacniać | : (czas.) umocnić | : (czas.) wzmacniać | : (czas.) wzmocnić | : (czas.) zbroić
reinforcement : reinforcement : (rzecz.) armatura | : (rzecz.) posiłek | : (rzecz.) wzmocnienie | : (rzecz.) zbrojenie
reins : reins : (rzecz.) cugle | : (rzecz.) lędźwie | : (rzecz.) lejce | : (rzecz.) nerki | : (rzecz.) szranki
reinstallation : reinstallation : (rzecz.) przeinstalowanie
reinstalling : reinstalling : (rzecz.) przeinstalowanie
reinstate : reinstate : (czas.) przywracać
reinstatement : reinstatement : (rzecz.) przywrócenie
reinsurance : reinsurance : (rzecz.) reasekuracja
reinsure : reinsure : (czas.) reasekurować
reintegration : reintegration : (rzecz.) reintegracja
reinterpretation : reinterpretation : (rzecz.) reinterpretacja
reinvent : reinvent : (czas.) przerabiać
reinvest : reinvest : (czas.) reinwestować
reinvigorate : reinvigorate : (czas.) zdynamizować
reissue : reissue : (czas.) wznawiać | : (rzecz.) ponowienie | : (rzecz.) wznowienie
reiterate : reiterate : (czas.) kopiować | : (czas.) powtarzać
reject : reject : (czas.) brakować | : (czas.) odrzucać | : (czas.) odrzucić | : (rzecz.) brak | : (rzecz.) odrzut | : (rzecz.) przebierka
rejected : rejected : (czas.) oddalić
rejection : rejection : (rzecz.) brakowanie | : (rzecz.) eliminacja | : (rzecz.) odmowa | : (rzecz.) odrzucenie | : (rzecz.) wybrakowanie
rejoice : rejoice : (czas.) cieszyć | : (czas.) radować
rejoicing : rejoicing : (rzecz.) radość | : (rzecz.) świętowanie | : (rzecz.) uradowanie
rejoin : rejoin : (czas.) odpowiadać | : (czas.) połączyć
rejoinder : rejoinder : (rzecz.) odpowiadanie | : (rzecz.) odpowiedź | : (rzecz.) replika
rejuvenate : rejuvenate : (czas.) odmładzać | : (czas.) odmłodnieć
rejuvenation : rejuvenation : (rzecz.) krajobrazu | : (rzecz.) odmładzanie | : (rzecz.) odmłodzenie
rekindle : rekindle : (czas.) ożywiać | : (czas.) rozpalać | : (czas.) wzniecać
relapse : relapse : (rzecz.) nawrót | : (rzecz.) recydywa
relate : relate : (czas.) łączyć | : (czas.) odnosić | : (czas.) opowiadać | : (czas.) relacjonować | : (czas.) wiązać | : (czas.) wykazać | : (czas.) wykazywać | : (czas.) zreferować
related : related : (przym.) bliski | : (przym.) odnośny | : (przym.) odpowiedzialny | : (przym.) pobratymczy | : (przym.) pokrewny | : (przym.) powiązany | : (przym.) powinowaty
relatedness : relatedness : (rzecz.) pokrewieństwo | : (rzecz.) spokrewnienie | : (rzecz.) związek
relation : relation : (rzecz.) opowiadanie | : (rzecz.) pokrewieństwo | : (rzecz.) powinowactwo | : (rzecz.) relacja | : (rzecz.) relacjonowanie | : (rzecz.) stosunek | : (rzecz.) związek
relational : relational : (przym.) pokrewny | : (przym.) relacyjny
relationship : relationship : (rzecz.) parantela | : (rzecz.) pokrewieństwo | : (rzecz.) powiązanie | : (rzecz.) relacja | : (rzecz.) zależność | : (rzecz.) związek
relative : relative : (przym.) dotyczący | : (przym.) krewny | : (przym.) odnośny | : (przym.) powinowaty | : (przym.) relatywny | : (przym.) stosunkowy | : (przym.) względny | : (rzecz.) krewna | : (rzecz.) krewniak | : (rzecz.) powinowata | : (rzecz.) względność
relatively : relatively : (przysł.) relatywnie | : (przysł.) stosunkowo | : (przysł.) względnie
relatives : relatives : (rzecz.) krewni
relativism : relativism : (rzecz.) relatywizm
relativistic : relativistic : (przym.) relatywistyczny
relativity : relativity : (rzecz.) relatywność | : (rzecz.) względność
relax : relax : (czas.) odprężać | : (czas.) osłabiać | : (czas.) osłabić | : (czas.) rozluźniać | : (czas.) rozluźnić | : (czas.) zmniejszyć | : (czas.) zrelaksować | : (czas.) zwalniać | : (czas.) zwolnić
relaxant : relaxant : (przym.) rozkurczowy
relaxation : relaxation : (rzecz.) luz | : (rzecz.) odprężenie | : (rzecz.) osłabienie | : (rzecz.) relaks | : (rzecz.) relaksacja | : (rzecz.) rozluźnianie | : (rzecz.) rozluźnienie | : (rzecz.) złagodzenie | : (rzecz.) zluźnienie | : (rzecz.) zwolnienie
relaxed : relaxed : (przym.) luźny | : (przym.) wypoczęty
relaxing : relaxing : (przym.) odprężający | : (przym.) relaksacyjny | : (przym.) relaksowy | : (przym.) relaksujący
relay : relay : (czas.) luzować | : (czas.) przekazywać | : (czas.) retransmitować | : (czas.) zluzować | : (czas.) zmieniać | : (rzecz.) przekaźnik | : (rzecz.) retransmisja | : (rzecz.) sztafeta | : (rzecz.) zmiana
relayed : relayed : (czas.) przekazywać | : (czas.) transmitować
release : release : (czas.) puścić | : (czas.) rozładować | : (czas.) rozpowszechniać | : (czas.) uwalniać | : (czas.) uwolnić | : (czas.) wyasygnować | : (czas.) wydać | : (czas.) wypuścić | : (czas.) wypuszczać | : (czas.) wyzwalać | : (czas.) wyzwolić | : (czas.) zezwalać | : (czas.) zezwolić | : (czas.) zwalniać | : (czas.) zwolnić | : (rzecz.) dopuszczenie | : (rzecz.) emisja | : (rzecz.) oswobodzenie | : (rzecz.) publikacja | : (rzecz.) puszczenie | : (rzecz.) spust | : (rzecz.) spuszczenie | : (rzecz.) udostępnienie | : (rzecz.) uwolnienie | : (rzecz.) wersja | : (rzecz.) wydanie | : (rzecz.) wypuszczanie | : (rzecz.) wypuszczenie | : (rzecz.) wyzwalacz | : (rzecz.) wyzwolenie | : (rzecz.) zwalnianie | : (rzecz.) zwolnienie
relegate : relegate : (czas.) oddalać | : (czas.) relegować | : (czas.) wydalać | : (czas.) zdegradować
relegation : relegation : (rzecz.) degradacja | : (rzecz.) przeniesienie | : (rzecz.) relegacja | : (rzecz.) zdegradowanie | : (rzecz.) zesłanie
relent : relent : (czas.) łagodnieć | : (czas.) mięknąć | : (czas.) ustąpić | : (czas.) ustępować
relentless : relentless : (przym.) bezustanny | : (przym.) bezwzględny | : (przym.) nieugięty
relentlessly : relentlessly : (przysł.) bezwzględnie | : (przysł.) niemiłosiernie | : (przysł.) zawzięcie
relentlessness : relentlessness : (rzecz.) zawziętość
relevance : relevance : (rzecz.) doniosłość | : (rzecz.) relewancja | : (rzecz.) trafność | : (rzecz.) ważność | : (rzecz.) związek
relevant : relevant : (przym.) celny | : (przym.) istotny | : (przym.) miejscowy | : (przym.) odnośny | : (przym.) odpowiedni | : (przym.) relewantny | : (przym.) stosowny | : (przym.) trafny
reliability : reliability : (rzecz.) miarodajność | : (rzecz.) niezawodność | : (rzecz.) pewność | : (rzecz.) rzetelność | : (rzecz.) solidność | : (rzecz.) wiarogodność | : (rzecz.) zawodność
reliable : reliable : (przym.) bezawaryjny | : (przym.) miarodajny | : (przym.) niezawodny | : (przym.) odpowiedzialny | : (przym.) pewny | : (przym.) rzetelny | : (przym.) solidny | : (przym.) wiarogodny | : (przym.) wiarygodny
reliably : reliably : (przysł.) niezawodnie | : (przysł.) solidnie | : (przysł.) wiarygodnie
reliance : reliance : (rzecz.) oparcie | : (rzecz.) zaufanie
reliant : reliant : (przym.) ufny | : (przym.) zależny
relic : relic : (rzecz.) pamiątka | : (rzecz.) pozostałość | : (rzecz.) przeżytek | : (rzecz.) relikt | : (rzecz.) relikwia | : (rzecz.) zabytek
relict : relict : (rzecz.) przeżytek | : (rzecz.) relikt
relief : relief : (rzecz.) odsiecz | : (rzecz.) płaskorzeźba | : (rzecz.) podcięcie | : (rzecz.) relief | : (rzecz.) ukojenie | : (rzecz.) ulga | : (rzecz.) wsparcie | : (rzecz.) wybranie | : (rzecz.) zapomoga | : (rzecz.) złagodzenie | : (rzecz.) zmiana
relieve : relieve : (czas.) luzować | : (czas.) ulżyć | : (czas.) uśmierzać | : (czas.) zastąpić | : (czas.) zastępować | : (czas.) zluzować | : (czas.) zwalniać | : (czas.) zwolnić
relieved : relieved : (przym.) uspokojony
relight : relight : (czas.) rozświecać | : (czas.) rozświecić
religion : religion : (rzecz.) religia | : (rzecz.) wyznanie
religiosity : religiosity : (rzecz.) religianctwo | : (rzecz.) religijność
religious : religious : (przym.) nabożny | : (przym.) religijny | : (przym.) wierzeniowy | : (przym.) zakonny | : (rzecz.) religioznawstwo
religiously : religiously : (przysł.) religijnie
reline : reline : (czas.) wymieniać | : (czas.) wymienić | : (rzecz.) giełda | : (rzecz.) zamiana
relining : relining : (rzecz.) przebudowa
relinquish : relinquish : (czas.) odstąpić | : (czas.) odstępować | : (czas.) opuścić | : (czas.) opuszczać | : (czas.) poniechać | : (czas.) rezygnować | : (czas.) zaniechać | : (czas.) zarzucać | : (czas.) zrezygnować
relinquishment : relinquishment : (rzecz.) wypuszczenie | : (rzecz.) zaniechanie | : (rzecz.) zrzeczenie
reliquary : reliquary : (rzecz.) relikwiarz
relish : relish : (czas.) gustować | : (czas.) lubić | : (czas.) rozkoszować | : (czas.) smakować | : (czas.) zalatywać | : (rzecz.) delicja | : (rzecz.) przyjemność | : (rzecz.) przysmak | : (rzecz.) smak | : (rzecz.) upodobanie
relive : relive : (czas.) odżyć | : (czas.) odżywać | : (czas.) przeżywać | : (czas.) ulżyć
reload : reload : (czas.) odnawiać | : (czas.) odnowić | : (czas.) przeładować | : (czas.) przeładowywać | : (czas.) załadować | : (czas.) zarepetować
reloaded : reloaded : (czas.) przeładować
reloading : reloading : (rzecz.) przeładowanie | : (rzecz.) przeładunek
relocate : relocate : (czas.) przemieścić | : (czas.) przemieszczać | : (czas.) przenosić
relocation : relocation : (rzecz.) przemieszczenie | : (rzecz.) relokacja
reluctance : reluctance : (rzecz.) niechęć | : (rzecz.) ociąganie | : (rzecz.) opór | : (rzecz.) wstręt
reluctant : reluctant : (przym.) niechętny | : (przym.) oporny
reluctantly : reluctantly : (przysł.) niechętnie | : (przysł.) nieochoczo
rely : rely : (czas.) liczyć | : (czas.) opierać | : (czas.) polegać
remain : remain : (czas.) dochować | : (czas.) pozostać | : (czas.) pozostawać | : (czas.) przeleżeć | : (czas.) zostawać
remainder : remainder : (rzecz.) ostatek | : (rzecz.) pozostałość | : (rzecz.) reszta | : (rzecz.) resztka
remains : remains : (rzecz.) pozostałości | : (rzecz.) resztki | : (rzecz.) szczątki | : (rzecz.) zwłoki
remake : remake : (czas.) przefasonować | : (czas.) przerabiać | : (czas.) przerobić | : (rzecz.) przerób
remand : remand : (czas.) odsyłać
remark : remark : (czas.) zanotować | : (czas.) zauważyć | : (rzecz.) spostrzeżenie | : (rzecz.) uwaga
remarkable : remarkable : (przym.) nadzwyczajny | : (przym.) niepospolity | : (przym.) nietuzinkowy | : (przym.) niezwykły | : (przym.) wybitny
remarkableness : remarkableness : (rzecz.) znakomitość
remarkably : remarkably : (przysł.) nadzwyczaj | : (przysł.) nadzwyczajnie | : (przysł.) wybitnie | : (przysł.) znacząco
rematch : rematch : (rzecz.) rewanż
remediable : remediable : (przym.) uleczalny
remedial : remedial : (przym.) korekcyjny | : (przym.) pomocniczy | : (przym.) zapobiegawczy | : (przym.) zaradczy
remediation : remediation : (rzecz.) naprawa
remedy : remedy : (czas.) leczyć | : (czas.) naprawiać | : (czas.) zaradzać | : (czas.) zaradzić | : (rzecz.) lekarstwo | : (rzecz.) naprawa | : (rzecz.) remedium | : (rzecz.) środek
remember : remember : (czas.) opamiętać | : (czas.) pamiętać | : (czas.) zapamiętać
remembrance : remembrance : (rzecz.) notatka | : (rzecz.) pamiątka | : (rzecz.) pamięć | : (rzecz.) wspominanie | : (rzecz.) wspomnienie
remilitarization : remilitarization : (rzecz.) remilitaryzacja
remind : remind : (czas.) przypominać | : (czas.) przypomnieć
reminder : reminder : (rzecz.) monit | : (rzecz.) pamiątka | : (rzecz.) ponaglenie | : (rzecz.) przypominanie | : (rzecz.) przypomnienie | : (rzecz.) upomnienie
reminisce : reminisce : (czas.) wspominać
reminiscence : reminiscence : (rzecz.) reminiscencja | : (rzecz.) wspomnienie
reminiscent : reminiscent : (przym.) przypominający | : (przym.) wspominający
remise : remise : (czas.) przekazywać
remiss : remiss : (przym.) niedbały | : (przym.) ospały
remission : remission : (rzecz.) darowanie | : (rzecz.) odpuszczenie | : (rzecz.) osłabienie | : (rzecz.) przebaczenie | : (rzecz.) remisja | : (rzecz.) ulga | : (rzecz.) umorzenie | : (rzecz.) zmniejszenie
remit : remit : (czas.) darować | : (czas.) oddać | : (czas.) odstąpić | : (czas.) odstępować | : (czas.) osłabiać | : (czas.) osłabić | : (czas.) przesłać | : (czas.) umorzyć | : (czas.) wybaczyć | : (czas.) złagodnieć | : (czas.) zmniejszyć | : (rzecz.) kompetencja
remittance : remittance : (rzecz.) przekaz | : (rzecz.) przelew | : (rzecz.) przesyłka | : (rzecz.) rymesa | : (rzecz.) wpłata | : (rzecz.) wypłata
remitter : remitter : (rzecz.) odesłanie | : (rzecz.) remitent
remnant : remnant : (rzecz.) pozostałość | : (rzecz.) remanent | : (rzecz.) reszta
remnants : remnants : (rzecz.) odprysk | : (rzecz.) pozostałość | : (rzecz.) pozostałości
remodel : remodel : (czas.) przemodelować | : (czas.) przerabiać
remonstrance : remonstrance : (rzecz.) skarga
remonstrate : remonstrate : (czas.) protestować | : (czas.) skarżyć | : (czas.) upominać | : (czas.) zaprotestować
remorse : remorse : (rzecz.) skrucha | : (rzecz.) żal
remorseless : remorseless : (przym.) bezlitosny | : (przym.) niemiłosierny
remote : remote : (przym.) daleki | : (przym.) nieprzystępny | : (przym.) obcy | : (przym.) odległy | : (przym.) zdalny
remotely : remotely : (przysł.) zdalnie
remoteness : remoteness : (rzecz.) dal | : (rzecz.) oddalenie | : (rzecz.) odległość
removable : removable : (przym.) czynny | : (przym.) odejmowany | : (przym.) odłączalny | : (przym.) ruchomy | : (przym.) usuwalny
removal : removal : (rzecz.) cofanie | : (rzecz.) deportacja | : (rzecz.) odwołanie | : (rzecz.) przenosiny | : (rzecz.) przeprowadzka | : (rzecz.) sprzątnięcie | : (rzecz.) usunięcie | : (rzecz.) usuwanie | : (rzecz.) wyprowadzka | : (rzecz.) wywożenie | : (rzecz.) zabranie | : (rzecz.) zdejmowanie | : (rzecz.) zniesienie
remove : remove : (czas.) likwidować | : (czas.) niwelować | : (czas.) oddalać | : (czas.) oddalić | : (czas.) odkuć | : (czas.) odsadzać | : (czas.) odsądzać | : (czas.) odznaczyć | : (czas.) przenosić | : (czas.) przeprowadzać | : (czas.) przeprowadzić | : (czas.) skreślać | : (czas.) uchylać | : (czas.) uprzątać | : (czas.) usunąć | : (czas.) usuwać | : (czas.) wyjąć | : (czas.) wyjmować | : (czas.) wykreślać | : (czas.) zdejmować | : (czas.) zdjąć | : (czas.) zwalniać | : (czas.) zwolnić | : (rzecz.) usunięcie | : (rzecz.) wyjęcie | : (rzecz.) zdemontowanie
removed : removed : (czas.) zdemontować
remover : remover : (rzecz.) spedytor | : (rzecz.) zmywacz
remunerate : remunerate : (czas.) wynagradzać
remuneration : remuneration : (rzecz.) wynagrodzenie | : (rzecz.) zapłata
remunerative : remunerative : (przym.) dochodowy | : (przym.) opłacający | : (przym.) opłacalny | : (przym.) popłatny
renaissance : renaissance : (rzecz.) odrodzenie | : (rzecz.) renesans | : (rzecz.) rozkwit
renal : renal : (przym.) nerkowy
rename : rename : (czas.) przemianować | : (czas.) przemianowywać
renascence : renascence : (rzecz.) odrodzenie | : (rzecz.) renesans | : (rzecz.) rozkwit
rend : rend : (czas.) podrzeć | : (czas.) poszarpać | : (czas.) rozdzierać | : (czas.) rozrywać | : (czas.) rozszczepiać
render : render : (czas.) okazać | : (czas.) przedstawiać | : (czas.) przedstawić | : (czas.) robić | : (czas.) sprawić | : (czas.) świadczyć | : (czas.) uskuteczniać | : (czas.) wyrządzić | : (czas.) zaprawiać | : (czas.) zrobić | : (rzecz.) oddawanie | : (rzecz.) odtwarzanie | : (rzecz.) okazanie | : (rzecz.) sprawianie | : (rzecz.) tłumaczenie | : (rzecz.) wyraz | : (rzecz.) wyrządzanie
rendering : rendering : (rzecz.) interpretacja | : (rzecz.) obrzutka
rendezvous : rendezvous : (rzecz.) randka | : (rzecz.) schadzka | : (rzecz.) spotkanie
rendition : rendition : (rzecz.) interpretacja | : (rzecz.) oddanie
renegade : renegade : (rzecz.) odszczepieniec | : (rzecz.) renegat
renegotiate : renegotiate : (czas.) renegocjować
renegotiation : renegotiation : (rzecz.) renegocjacja
renew : renew : (czas.) odnawiać | : (czas.) odnowić | : (czas.) odświeżyć | : (czas.) podejmować | : (czas.) ponawiać | : (czas.) przedłużać | : (czas.) wznawiać | : (czas.) wznowić
renewable : renewable : (przym.) odnawialny | : (przym.) wymienny
renewal : renewal : (rzecz.) odnawianie | : (rzecz.) odnowa | : (rzecz.) odnowienie | : (rzecz.) ponowienie | : (rzecz.) przedłużenie | : (rzecz.) wznowienie
renewed : renewed : (przym.) ponowny
rennet : rennet : (rzecz.) podpuszczka | : (rzecz.) reneta
rennin : rennin : (rzecz.) chymozyna | : (rzecz.) podpuszczka
renounce : renounce : (czas.) wyrzekać | : (czas.) zrzekać
renouncement : renouncement : (rzecz.) odwołanie | : (rzecz.) rezygnacja | : (rzecz.) wyrzeczenie
renovate : renovate : (czas.) odnawiać | : (czas.) odremontować | : (czas.) remontować | : (czas.) wyremontować
renovated : renovated : (czas.) odnawiać
renovation : renovation : (rzecz.) naprawa | : (rzecz.) odnowa | : (rzecz.) odnowienie | : (rzecz.) regeneracja | : (rzecz.) remont | : (rzecz.) renowacja
renovator : renovator : (rzecz.) renowator | : (rzecz.) restaurator
renown : renown : (rzecz.) renoma | : (rzecz.) rozgłos | : (rzecz.) sława
renowned : renowned : (przym.) renomowany | : (przym.) sławny
rent : rent : (czas.) dzierżawić | : (czas.) nająć | : (czas.) odnająć | : (czas.) podrzeć | : (czas.) wynająć | : (czas.) wynajmować | : (czas.) wypożyczać | : (czas.) wypożyczyć | : (rzecz.) czynsz | : (rzecz.) dzierżawa | : (rzecz.) komorne | : (rzecz.) najem | : (rzecz.) renta | : (rzecz.) wynajęcie | : (rzecz.) wynajem | : (rzecz.) wypożyczalnia | : (rzecz.) wypożyczenie
rental : rental : (rzecz.) czynsz | : (rzecz.) dzierżawa | : (rzecz.) komorne | : (rzecz.) należność
renter : renter : (rzecz.) rentier
renunciation : renunciation : (rzecz.) rezygnacja | : (rzecz.) wyrzeczenie | : (rzecz.) zrzeczenie
reorder : reorder : (czas.) przekładać | : (czas.) przestawiać
reorganization : reorganization : (rzecz.) przeorganizowanie | : (rzecz.) reorganizacja | : (rzecz.) reorganizowanie
reorganize : reorganize : (czas.) przegrupować | : (czas.) reorganizować | : (czas.) zreorganizować
reorientation : reorientation : (rzecz.) reorientacja
rep : rep : (rzecz.) agent | : (rzecz.) przedstawiciel | : (rzecz.) ryps | : (rzecz.) wiersz
repaid : repaid : (czas.) odwdzięczać
repaint : repaint : (czas.) odmalować | : (czas.) przemalować
repainted : repainted : (rzecz.) przemalowanie
repainting : repainting : (rzecz.) przemalowanie
repair : repair : (czas.) naprawiać | : (czas.) naprawić | : (czas.) rekompensować | : (czas.) reperować | : (czas.) udawać | : (rzecz.) kryjówka | : (rzecz.) naprawa | : (rzecz.) naprawianie | : (rzecz.) remont | : (rzecz.) reperacja
repairer : repairer : (rzecz.) naprawiacz | : (rzecz.) serwisant
repairman : repairman : (rzecz.) mechanik | : (rzecz.) monter
reparable : reparable : (przym.) naprawialny
reparation : reparation : (rzecz.) naprawa | : (rzecz.) naprawienie | : (rzecz.) odszkodowanie | : (rzecz.) reparacja | : (rzecz.) reperacja | : (rzecz.) wynagrodzenie
reparations : reparations : (rzecz.) reparacja
repartee : repartee : (rzecz.) riposta | : (rzecz.) szybka
repartition : repartition : (czas.) przydzielić | : (rzecz.) podział | : (rzecz.) repartycja | : (rzecz.) rozłożenie
repast : repast : (rzecz.) jedzenie | : (rzecz.) posiłek
repatriate : repatriate : (czas.) repatriować | : (rzecz.) repatriant
repatriation : repatriation : (rzecz.) przesiedlenie | : (rzecz.) reemigracja | : (rzecz.) repatriacja
repay : repay : (czas.) odpłacać | : (czas.) odpłacić | : (czas.) odwdzięczać | : (czas.) odwdzięczyć | : (czas.) spłacać | : (czas.) zrewanżować | : (czas.) zwracać | : (czas.) zwrócić
repayable : repayable : (przym.) spłacalny
repayment : repayment : (rzecz.) odpłatność | : (rzecz.) spłata | : (rzecz.) zwrot
repeal : repeal : (czas.) odwołać | : (czas.) odwoływać | : (czas.) uchylać | : (czas.) unieważniać | : (rzecz.) odwołanie | : (rzecz.) uchylenie
repealed : repealed : (czas.) uchylić
repeat : repeat : (czas.) bisować | : (czas.) ponawiać | : (czas.) powtarzać | : (czas.) powtórzyć | : (czas.) wyrecytować | : (rzecz.) powtarzanie | : (rzecz.) powtórka | : (rzecz.) powtórzenie
repeatability : repeatability : (rzecz.) powtarzalność
repeatable : repeatable : (przym.) powtarzalny
repeated : repeated : (przym.) częsty | : (przym.) kilkakrotny | : (przym.) niejednokrotny | : (przym.) parokrotny | : (przym.) powtórny | : (przym.) wielokrotny | : (przym.) wielorazowy
repeatedly : repeatedly : (przysł.) częstokroć | : (przysł.) powtarzalnie | : (przysł.) wciąż | : (przysł.) wielokrotnie
repeater : repeater : (rzecz.) donosiciel | : (rzecz.) recydywista | : (rzecz.) repetent | : (rzecz.) repetier | : (rzecz.) repetytor | : (rzecz.) translacja | : (rzecz.) wtórnik | : (rzecz.) wzmacniak
repel : repel : (czas.) odeprzeć | : (czas.) odpierać | : (czas.) odpychać | : (czas.) odrzucać | : (czas.) odtrącać
repellent : repellent : (przym.) odpychający | : (przym.) wstrętny | : (rzecz.) odpychanie | : (rzecz.) repelent
repent : repent : (czas.) żałować
repentance : repentance : (rzecz.) pokuta | : (rzecz.) skrucha | : (rzecz.) żal
repentant : repentant : (przym.) skruszony
repercussion : repercussion : (rzecz.) echo | : (rzecz.) następstwo | : (rzecz.) odbicie | : (rzecz.) oddźwięk | : (rzecz.) odrzucenie | : (rzecz.) reperkusja
repertoire : repertoire : (rzecz.) repertuar | : (rzecz.) zakres
repertory : repertory : (rzecz.) repertuar | : (rzecz.) składnica | : (rzecz.) zapas
repetition : repetition : (rzecz.) naśladownictwo | : (rzecz.) powtarzanie | : (rzecz.) powtórka | : (rzecz.) powtórzenie | : (rzecz.) próba | : (rzecz.) recytowanie | : (rzecz.) repetycja
repetitive : repetitive : (przym.) monotonny | : (przym.) powtarzalny
rephrase : rephrase : (czas.) parafrazować | : (czas.) sparafrazować
repine : repine : (czas.) narzekać | : (czas.) poskarżyć | : (czas.) szemrać
replace : replace : (czas.) dorabiać | : (czas.) odłożyć | : (czas.) podmienić | : (czas.) podstawiać | : (czas.) wymieniać | : (czas.) wymienić | : (czas.) wyręczać | : (czas.) zamieniać | : (czas.) zamienić | : (czas.) zastąpić | : (czas.) zastępować
replaceable : replaceable : (przym.) wymienny | : (przym.) zamienny | : (przym.) zastępowalny
replacement : replacement : (rzecz.) podstawianie | : (rzecz.) wtórnik | : (rzecz.) wymiana | : (rzecz.) zamiennik | : (rzecz.) zastąpienie | : (rzecz.) zastępca | : (rzecz.) zastępowanie
replacements : replacements : (rzecz.) zastąpienie
replant : replant : (czas.) przesadzać | : (czas.) przesadzić
replay : replay : (czas.) odpowiedzieć | : (czas.) powtarzać | : (czas.) powtórzyć | : (rzecz.) powtórka | : (rzecz.) powtórzenie
replenish : replenish : (czas.) dopełniać | : (czas.) dopełnić | : (czas.) napełniać | : (czas.) napełnić | : (czas.) uzupełniać | : (czas.) zaopatrywać
replenishment : replenishment : (rzecz.) uzupełnienie
replete : replete : (przym.) pełny | : (przym.) plenarny | : (przym.) wypełniony
repletion : repletion : (rzecz.) nadmiar | : (rzecz.) napełnienie | : (rzecz.) nasycenie | : (rzecz.) wypełnienie
replica : replica : (rzecz.) kopia | : (rzecz.) replika
replicate : replicate : (czas.) replikować
replication : replication : (rzecz.) odpowiedź | : (rzecz.) odtwarzanie | : (rzecz.) powielanie | : (rzecz.) powtarzanie | : (rzecz.) replikacja
reply : reply : (czas.) odpisać | : (czas.) odpowiadać | : (czas.) odpowiedzieć | : (rzecz.) odpowiedź | : (rzecz.) odzew | : (rzecz.) reakcja
report : report : (czas.) donieść | : (czas.) donosić | : (czas.) meldować | : (czas.) poinformować | : (czas.) zawiadamiać | : (czas.) zawiadomić | : (rzecz.) detonacja | : (rzecz.) doniesienie | : (rzecz.) meldunek | : (rzecz.) odgłos | : (rzecz.) protokół | : (rzecz.) raport | : (rzecz.) recenzja | : (rzecz.) referat | : (rzecz.) sprawozdanie | : (rzecz.) świadectwo | : (rzecz.) związek
reportage : reportage : (rzecz.) reportaż
reportedly : reportedly : (przysł.) podobno
reporter : reporter : (rzecz.) dziennikarz | : (rzecz.) protokolant | : (rzecz.) reporter | : (rzecz.) sprawozdawca
repose : repose : (czas.) leżeć | : (czas.) odpoczywać | : (czas.) opierać | : (czas.) polegać | : (rzecz.) odpoczynek | : (rzecz.) sen
reposeful : reposeful : (przym.) cichy
reposition : reposition : (rzecz.) złożenie
repository : repository : (rzecz.) magazyn | : (rzecz.) przechowalnia | : (rzecz.) repozytorium | : (rzecz.) skład | : (rzecz.) składnica | : (rzecz.) zbiornik
repossess : repossess : (czas.) odzyskiwać | : (czas.) przejąć
repossessing : repossessing : (rzecz.) przejmowanie
reprehend : reprehend : (czas.) ganić | : (czas.) karcić | : (czas.) strofować | : (czas.) wypominać
reprehensible : reprehensible : (przym.) karygodny | : (przym.) naganny
reprehension : reprehension : (rzecz.) nagana | : (rzecz.) potępienie | : (rzecz.) reprymenda
represent : represent : (czas.) opisać | : (czas.) przedstawiać | : (czas.) reprezentować | : (czas.) stanowić | : (czas.) wystawiać
representation : representation : (rzecz.) odwzorowanie | : (rzecz.) przedstawianie | : (rzecz.) przedstawicielstwo | : (rzecz.) przedstawienie | : (rzecz.) reprezentacja | : (rzecz.) reprezentowanie | : (rzecz.) wyobrażenie
representational : representational : (przym.) reprezentacyjny
representative : representative : (przym.) charakterystyczny | : (przym.) przedstawicielski | : (przym.) reprezentacyjny | : (przym.) reprezentatywny | : (rzecz.) przedstawiciel | : (rzecz.) przedstawicielka | : (rzecz.) reprezentant
representatively : representatively : (przysł.) reprezentacyjnie
repress : repress : (czas.) pohamowywać | : (czas.) stłumiać | : (czas.) stłumić | : (czas.) tłumić | : (czas.) uciskać
repression : repression : (rzecz.) powstrzymanie | : (rzecz.) represja | : (rzecz.) ucisk
repressive : repressive : (przym.) represyjny
reprieve : reprieve : (czas.) odroczyć | : (czas.) przerwać | : (czas.) przerywać | : (czas.) zawieszać | : (rzecz.) zawieszenie | : (rzecz.) zwłoka
reprimand : reprimand : (czas.) ganić | : (czas.) napominać | : (czas.) wymawiać | : (rzecz.) bura | : (rzecz.) nagana | : (rzecz.) przygana | : (rzecz.) reprymenda | : (rzecz.) wymówka
reprint : reprint : (czas.) przedrukować | : (czas.) wydać | : (rzecz.) odbitka | : (rzecz.) przedruk
reprinted : reprinted : (czas.) przedrukowywać
reprinting : reprinting : (czas.) przedrukowywać
reprisal : reprisal : (rzecz.) odwet | : (rzecz.) represja
reprise : reprise : (rzecz.) powtórka
reproach : reproach : (czas.) błagać | : (czas.) karć | : (czas.) wymawiać | : (czas.) wypominać | : (czas.) wyrzucać | : (rzecz.) hańba | : (rzecz.) karcenie | : (rzecz.) skarcenie | : (rzecz.) wymówka | : (rzecz.) wyrzut | : (rzecz.) zarzut
reproachful : reproachful : (przym.) naganny
reprobate : reprobate : (czas.) ganić | : (czas.) potępiać | : (przym.) przewrotny | : (przym.) rozpustny | : (rzecz.) potępieniec
reprocess : reprocess : (czas.) przetworzyć
reprocessing : reprocessing : (rzecz.) przetwarzanie
reproduce : reproduce : (czas.) odtwarzać | : (czas.) odtworzyć | : (czas.) reprodukować | : (czas.) rozmnażać | : (czas.) rozmnożyć
reproducer : reproducer : (rzecz.) odtwarzacz | : (rzecz.) odtwórca | : (rzecz.) reproducer | : (rzecz.) reproduktor
reproducibility : reproducibility : (rzecz.) odtwarzalność
reproducible : reproducible : (przym.) odtwarzalny | : (przym.) powtarzalny
reproduction : reproduction : (rzecz.) kopia | : (rzecz.) odtwarzanie | : (rzecz.) odtworzenie | : (rzecz.) powielanie | : (rzecz.) reprodukcja | : (rzecz.) reprodukowanie | : (rzecz.) rozmnażanie | : (rzecz.) rozród | : (rzecz.) rozrodczość
reproductions : reproductions : (rzecz.) reprodukcje
reproductive : reproductive : (przym.) odtwórczy | : (przym.) reprodukcyjny | : (przym.) rozrodczy
reprogram : reprogram : (czas.) przeprogramować
reprogrammed : reprogrammed : (czas.) przeprogramować
reprogramming : reprogramming : (rzecz.) przeprogramowanie
reprograms : reprograms : (czas.) przeprogramować
reprography : reprography : (rzecz.) reprografia
reproof : reproof : (rzecz.) nagana | : (rzecz.) napomnienie | : (rzecz.) wymówka | : (rzecz.) wyrzucie | : (rzecz.) wyrzut | : (rzecz.) zarzut
reprove : reprove : (czas.) besztać | : (czas.) ganić | : (czas.) potępiać | : (czas.) zganić
reptile : reptile : (rzecz.) czołg | : (rzecz.) gad | : (rzecz.) gadzina | : (rzecz.) płaz
reptiles : reptiles : (rzecz.) gady
reptilian : reptilian : (przym.) gadzi
republic : republic : (rzecz.) republika | : (rzecz.) rzeczpospolita
republican : republican : (przym.) republikański | : (rzecz.) republikanin
republicanism : republicanism : (rzecz.) republikanizm
repudiate : repudiate : (czas.) odmawiać | : (czas.) odmówić | : (czas.) odrzucać | : (czas.) odrzucić | : (czas.) rozwieść | : (czas.) wypierać | : (czas.) wyrzekać
repudiation : repudiation : (rzecz.) odmowa | : (rzecz.) odrzucenie | : (rzecz.) odtrącenie | : (rzecz.) rozwód | : (rzecz.) wyparcie
repugnance : repugnance : (rzecz.) niechęć | : (rzecz.) niesmak | : (rzecz.) niezgodność | : (rzecz.) odraza | : (rzecz.) wstręt
repugnant : repugnant : (przym.) niekompatybilny | : (przym.) niezgodny | : (przym.) wstrętny
repulse : repulse : (czas.) odpychać | : (czas.) odtrącać | : (rzecz.) odepchnięcie | : (rzecz.) odmowa | : (rzecz.) odparcie | : (rzecz.) odprawa
repulsion : repulsion : (rzecz.) odpychanie | : (rzecz.) odstręczenie | : (rzecz.) wstręt
repulsive : repulsive : (przym.) antypatyczny | : (przym.) odpychający | : (przym.) szkaradny | : (przym.) wstrętny
repulsively : repulsively : (przysł.) wstrętnie
repurchase : repurchase : (czas.) odkupić
repurchased : repurchased : (rzecz.) odkupywanie
reputable : reputable : (przym.) poważny | : (przym.) zaszczytny
reputation : reputation : (rzecz.) renoma | : (rzecz.) reputacja | : (rzecz.) sława
repute : repute : (czas.) cenić | : (czas.) uważać | : (rzecz.) reputacja | : (rzecz.) sława
reputed : reputed : (przym.) rzekomy | : (przym.) słynny | : (przym.) uznany
reputedly : reputedly : (przysł.) podobno | : (przysł.) rzekomo
request : request : (czas.) prosić | : (czas.) ubiegać | : (czas.) wnioskować | : (czas.) wystąpić | : (czas.) żądać | : (czas.) zażądać | : (czas.) zażyczyć | : (rzecz.) popyt | : (rzecz.) postulat | : (rzecz.) prośba | : (rzecz.) wniosek | : (rzecz.) wnioskowanie | : (rzecz.) żądanie | : (rzecz.) zlecenie | : (rzecz.) życzenie
requests : requests : (rzecz.) upraszanie
requiem : requiem : (rzecz.) rekwiem
require : require : (czas.) nakazywać | : (czas.) potrzebować | : (czas.) wymagać | : (czas.) żądać | : (czas.) zażądać
required : required : (czas.) wymagać | : (przym.) konieczny | : (przym.) nakazowy | : (przym.) niezbędny | : (przym.) potrzebny
requirement : requirement : (rzecz.) potrzeba | : (rzecz.) wymaganie | : (rzecz.) wymóg | : (rzecz.) zadanie | : (rzecz.) żądanie
requisite : requisite : (przym.) konieczny | : (przym.) niezbędny | : (rzecz.) rekwizyt | : (rzecz.) rzecz | : (rzecz.) warunek
requisition : requisition : (czas.) rekwirować | : (czas.) żądać | : (rzecz.) nakaz | : (rzecz.) rekwirowanie | : (rzecz.) rekwizycja | : (rzecz.) żądanie | : (rzecz.) zapotrzebowanie
requital : requital : (rzecz.) wynagrodzenie | : (rzecz.) zapłata
requite : requite : (czas.) odpłacać | : (czas.) odpłacić | : (czas.) wynagradzać | : (czas.) wynagrodzić
rerun : rerun : (rzecz.) powtórka
resale : resale : (rzecz.) odprzedaż | : (rzecz.) odsprzedaż
reschedule : reschedule : (czas.) przełożyć | : (czas.) zmieniać | : (czas.) zmienić
rescind : rescind : (czas.) odwołać | : (czas.) odwoływać | : (czas.) unieważniać | : (czas.) unieważnić
rescission : rescission : (rzecz.) odwołanie | : (rzecz.) uchylenie | : (rzecz.) unieważnienie
rescue : rescue : (czas.) ocalać | : (czas.) ocalić | : (czas.) odratować | : (czas.) ratować | : (czas.) uratować | : (czas.) wyratować | : (rzecz.) ocalenie | : (rzecz.) odbicie | : (rzecz.) ratowanie | : (rzecz.) ratunek
rescue-worker : rescue-worker : (rzecz.) ratownik
rescuer : rescuer : (rzecz.) ratownik | : (rzecz.) wybawca
research : research : (czas.) badać | : (czas.) poszukiwać | : (rzecz.) badania | : (rzecz.) badanie | : (rzecz.) poszukiwanie | : (rzecz.) wywiad
researcher : researcher : (rzecz.) badacz | : (rzecz.) naukowiec | : (rzecz.) pracownik
researchers : researchers : (rzecz.) badacze
resection : resection : (rzecz.) resekcja
resell : resell : (czas.) odsprzedać
reseller : reseller : (rzecz.) dealer | : (rzecz.) odsprzedawca
resemblance : resemblance : (rzecz.) podobieństwo
resemble : resemble : (czas.) przypominać
resend : resend : (czas.) odsyłać
resent : resent : (czas.) gniewać | : (czas.) obrażać | : (czas.) oburzać | : (czas.) uprzykrzać
resentful : resentful : (przym.) dotknięty | : (przym.) urażony
resentfully : resentfully : (przysł.) zawzięcie
resentment : resentment : (rzecz.) gniew | : (rzecz.) obraza | : (rzecz.) oburzenie | : (rzecz.) przykrość | : (rzecz.) przykrości | : (rzecz.) rozżalenie | : (rzecz.) uraza | : (rzecz.) żal | : (rzecz.) złość
reservation : reservation : (rzecz.) rezerwacja | : (rzecz.) rezerwat | : (rzecz.) zastrzeżenie
reserve : reserve : (czas.) rezerwować | : (czas.) zachować | : (czas.) zarezerwować | : (czas.) zastrzegać | : (rzecz.) odwód | : (rzecz.) ograniczenie | : (rzecz.) powściągliwość | : (rzecz.) rezerwa | : (rzecz.) rezerwat | : (rzecz.) rezerwowanie | : (rzecz.) zapas | : (rzecz.) zasób | : (rzecz.) zastrzeżenie
reserved : reserved : (przym.) nierozmowny | : (przym.) ostrożny | : (przym.) powściągliwy | : (przym.) wstrzemięźliwy
reservist : reservist : (rzecz.) rezerwista
reservoir : reservoir : (rzecz.) akwen | : (rzecz.) rezerwuar | : (rzecz.) zalew | : (rzecz.) zbiornik
reset : reset : (czas.) naostrzyć | : (czas.) nastawiać | : (czas.) nastawić | : (czas.) przechowywać | : (czas.) przestawiać | : (czas.) wymazywać | : (czas.) wyzerować | : (czas.) zerować
resettle : resettle : (czas.) przesiedlać | : (czas.) przesiedlić
resettlement : resettlement : (rzecz.) przesiedlenie
reshape : reshape : (czas.) przekształcać | : (czas.) przekształcić
reship : reship : (czas.) przeładować
reshuffle : reshuffle : (czas.) przetasować | : (czas.) przetasowywać | : (rzecz.) tasowanie
reside : reside : (czas.) mieszkać | : (czas.) osadzać | : (czas.) rezydować | : (czas.) zamieszkać | : (czas.) zamieszkiwać | : (czas.) znajdować
residence : residence : (rzecz.) pobyt | : (rzecz.) rezydencja | : (rzecz.) zamieszkanie | : (rzecz.) zamieszkiwanie
residency : residency : (rzecz.) rezydencja | : (rzecz.) rezydentura
resident : resident : (przym.) mieszkający | : (przym.) rezydentny | : (rzecz.) mieszkaniec | : (rzecz.) rezydent | : (rzecz.) użytkownik | : (rzecz.) właściciel
residential : residential : (przym.) mieszkalny | : (przym.) mieszkaniowy | : (przym.) rezydencjonalny | : (przym.) willowy
residual : residual : (przym.) osadowy | : (przym.) pośmiertny | : (przym.) pozostały | : (przym.) resztkowy | : (przym.) śladowy | : (przym.) szczątkowy | : (rzecz.) osad
residuary : residuary : (przym.) odpadkowy | : (przym.) resztkowy | : (przym.) szczątkowy
residue : residue : (rzecz.) posmak | : (rzecz.) pozostałość | : (rzecz.) reszta
residuum : residuum : (rzecz.) osad | : (rzecz.) pozostałość
resign : resign : (czas.) dymisjonować | : (czas.) rezygnować | : (czas.) ustąpić | : (czas.) ustępować | : (czas.) zrzekać
resignation : resignation : (rzecz.) dymisja | : (rzecz.) rezygnacja | : (rzecz.) ustąpienie | : (rzecz.) wycofanie | : (rzecz.) zrzeczenie
resigned : resigned : (przym.) obojętny | : (przym.) pogodzony
resilience : resilience : (rzecz.) elastyczność | : (rzecz.) odbojność | : (rzecz.) sprężystość | : (rzecz.) wigor
resiliency : resiliency : (rzecz.) odbojność
resilient : resilient : (przym.) elastyczny | : (przym.) odbijający | : (przym.) odporny | : (przym.) odrzucający | : (przym.) prężny | : (przym.) sprężynujący | : (przym.) sprężysty | : (przym.) ustępliwy
resin : resin : (rzecz.) gumożywica | : (rzecz.) kalafonia | : (rzecz.) żywica
resinous : resinous : (przym.) żywicowaty | : (przym.) żywicowy | : (przym.) żywiczny
resist : resist : (czas.) opierać | : (czas.) powstrzymać | : (czas.) sprzeciwiać | : (czas.) sprzeciwić
resistance : resistance : (rzecz.) odpór | : (rzecz.) odporność | : (rzecz.) opór | : (rzecz.) opornica | : (rzecz.) opornik | : (rzecz.) oporność | : (rzecz.) opozycyjność | : (rzecz.) rezystancja | : (rzecz.) sprzeciw | : (rzecz.) wytrzymałość
resistance-capacitance : resistance-capacitance : (rzecz.) oporność-pojemność
resistance-inductance : resistance-inductance : (rzecz.) oporność-indukcyjność
resistant : resistant : (przym.) odporny | : (przym.) oporny | : (przym.) wytrzymały
resistible : resistible : (przym.) odporny
resistive : resistive : (przym.) oporny
resistor : resistor : (rzecz.) opornik | : (rzecz.) rezystor
resistor-capacitor : resistor-capacitor : (rzecz.) opornik-kondensator
resole : resole : (czas.) podzelować
resoluble : resoluble : (przym.) rozkładalny | : (przym.) rozwiązalny
resolute : resolute : (przym.) rezolutny | : (przym.) stanowczy | : (przym.) zdecydowany
resoluteness : resoluteness : (rzecz.) determinacja | : (rzecz.) rezolutność
resolution : resolution : (rzecz.) decyzja | : (rzecz.) postanowienie | : (rzecz.) rezolucja | : (rzecz.) rozdzielczość | : (rzecz.) rozwiązanie | : (rzecz.) rozwiązywanie | : (rzecz.) stanowczość | : (rzecz.) translacja | : (rzecz.) uchwała | : (rzecz.) ustąpienie | : (rzecz.) zdecydowanie
resolvable : resolvable : (przym.) rozpuszczalny
resolve : resolve : (czas.) analizować | : (czas.) postanawiać | : (czas.) postanowić | : (czas.) rozkładać | : (czas.) rozpuścić | : (czas.) rozpuszczać | : (czas.) rozstrzygać | : (czas.) rozwiązać | : (czas.) rozwiązywać | : (rzecz.) postanowienie | : (rzecz.) stanowczość
resolved : resolved : (przym.) stanowczy
resonance : resonance : (rzecz.) donośność | : (rzecz.) dźwięczność | : (rzecz.) rezonans | : (rzecz.) rozgłos
resonant : resonant : (przym.) akustyczny | : (przym.) brzmiący | : (przym.) donośny | : (przym.) dźwięczny | : (przym.) huczny | : (przym.) rezonansowy
resonate : resonate : (czas.) dźwięczeć | : (czas.) rezonować | : (czas.) rozbrzmiewać | : (czas.) współbrzmieć
resonator : resonator : (rzecz.) rezonator
resorcinol : resorcinol : (rzecz.) rezorcyna
resort : resort : (czas.) uciekać | : (czas.) uczęszczać | : (czas.) zwalniać | : (czas.) zwrócić | : (rzecz.) kurort | : (rzecz.) resort | : (rzecz.) ucieczka | : (rzecz.) uciekanie | : (rzecz.) zwrócenie
resound : resound : (czas.) dudnić | : (czas.) dźwięczeć | : (czas.) obiegać | : (czas.) rozbrzmiewać
resounding : resounding : (przym.) donośny | : (przym.) głośny
resoundingly : resoundingly : (przysł.) znacząco
resource : resource : (rzecz.) sposób | : (rzecz.) środek | : (rzecz.) surowiec | : (rzecz.) zabieg | : (rzecz.) zapas | : (rzecz.) zasób | : (rzecz.) źródło
resourceful : resourceful : (przym.) obrotny | : (przym.) pomysłowy | : (przym.) wynalazczy | : (przym.) zaradny
resourcefully : resourcefully : (przysł.) pomysłowo
resourcefulness : resourcefulness : (rzecz.) pomysłowość | : (rzecz.) przebiegłość | : (rzecz.) przedsiębiorczość | : (rzecz.) zaradność
resources : resources : (rzecz.) kosztowność | : (rzecz.) sumpt | : (rzecz.) zasoby
respect : respect : (czas.) honorować | : (czas.) poważać | : (czas.) respektować | : (czas.) szanować | : (czas.) uszanować | : (rzecz.) poszanowanie | : (rzecz.) poważanie | : (rzecz.) respekt | : (rzecz.) szacunek | : (rzecz.) szanowanie | : (rzecz.) uszanowanie | : (rzecz.) wzgląd
respectability : respectability : (rzecz.) poważanie | : (rzecz.) zacność
respectable : respectable : (przym.) porządny | : (przym.) przyzwoity | : (przym.) szacowny | : (przym.) szanowny | : (przym.) zacny
respectful : respectful : (przym.) szacowny
respectfulness : respectfulness : (rzecz.) szacunek
respective : respective : (przym.) indywidualny | : (przym.) odnośny | : (przym.) poszczególny | : (przym.) respektowy | : (przym.) względny
respectively : respectively : (przysł.) odpowiednio | : (przysł.) poszczególnie
respiration : respiration : (rzecz.) oddech | : (rzecz.) oddychanie
respirator : respirator : (rzecz.) respirator | : (rzecz.) sączek
respiratory : respiratory : (przym.) oddechowy
respire : respire : (czas.) oddychać
respite : respite : (rzecz.) odroczenie | : (rzecz.) prolongata | : (rzecz.) przerwa | : (rzecz.) ulga | : (rzecz.) wytchnienie | : (rzecz.) zwłoka
resplendent : resplendent : (przym.) lśniący
respond : respond : (czas.) odpowiadać | : (czas.) odpowiedzieć | : (czas.) reagować | : (czas.) ustosunkowywać | : (czas.) zareagować
responder : responder : (rzecz.) respondent
response : response : (rzecz.) oddźwięk | : (rzecz.) odezwanie | : (rzecz.) odpowiedź | : (rzecz.) odzew | : (rzecz.) reakcja | : (rzecz.) riposta
responsibility : responsibility : (rzecz.) obowiązek | : (rzecz.) odpowiedzialność
responsible : responsible : (przym.) odpowiedzialny
responsibly : responsibly : (przysł.) odpowiedzialnie
responsive : responsive : (przym.) odpowiadający | : (przym.) wrażliwy
responsiveness : responsiveness : (rzecz.) chłonność | : (rzecz.) reakcja
rest : rest : (czas.) odnawiać | : (czas.) odpoczywać | : (czas.) opierać | : (czas.) pozostać | : (czas.) spocząć | : (czas.) spoczywać | : (czas.) wypocząć | : (czas.) wypoczywać | : (rzecz.) odpoczynek | : (rzecz.) okular | : (rzecz.) ostatek | : (rzecz.) pauza | : (rzecz.) podpora | : (rzecz.) reszta | : (rzecz.) spoczynek | : (rzecz.) wypoczęcie | : (rzecz.) wypoczynek | : (rzecz.) wytchnienie
rest-camp : rest-camp : (rzecz.) wczasowisko
restart : restart : (czas.) wznawiać | : (czas.) wznowić | : (rzecz.) point | : (rzecz.) wznowienie
restate : restate : (czas.) sparafrazować
restaurant : restaurant : (rzecz.) restauracja
restaurateur : restaurateur : (rzecz.) restaurator
restful : restful : (przym.) spokojny
restfulness : restfulness : (rzecz.) spokój
restitution : restitution : (rzecz.) oddawanie | : (rzecz.) odszkodowanie | : (rzecz.) przywracanie | : (rzecz.) przywrócenie | : (rzecz.) restytucja | : (rzecz.) zwrot
restive : restive : (przym.) krnąbrny | : (przym.) narowisty | : (przym.) oporny
restless : restless : (przym.) bezsenny | : (przym.) niespokojny | : (przym.) ruchliwy
restlessly : restlessly : (przysł.) niespokojnie
restlessness : restlessness : (rzecz.) niepokój | : (rzecz.) wzburzenie | : (rzecz.) zniecierpliwienie
restock : restock : (czas.) uzupełniać | : (czas.) uzupełnić
restoration : restoration : (rzecz.) odbudowa | : (rzecz.) odnowa | : (rzecz.) odrestaurowanie | : (rzecz.) odtworzenie | : (rzecz.) przywracanie | : (rzecz.) przywrócenie | : (rzecz.) rekonstrukcja | : (rzecz.) restauracja
restorative : restorative : (przym.) odżywczy
restore : restore : (czas.) odbudować | : (czas.) odnawiać | : (czas.) odrestaurować | : (czas.) odświeżać | : (czas.) odtwarzać | : (czas.) przywracać | : (czas.) przywrócić | : (czas.) restytuować | : (czas.) wyrestaurować
restored : restored : (czas.) restaurować
restorer : restorer : (rzecz.) konserwator | : (rzecz.) odnowiciel | : (rzecz.) rekonstruktor | : (rzecz.) restaurator
restrain : restrain : (czas.) hamować | : (czas.) ograniczać | : (czas.) powstrzymać | : (czas.) powstrzymywać | : (czas.) utwierdzać | : (czas.) wstrzymywać
restrained : restrained : (przym.) powściągliwy
restraint : restraint : (rzecz.) ograniczenie | : (rzecz.) opanowanie | : (rzecz.) poskromienie | : (rzecz.) powściągliwość | : (rzecz.) powściągnięcie | : (rzecz.) powstrzymanie | : (rzecz.) powstrzymywanie | : (rzecz.) restrykcja | : (rzecz.) skrępowanie | : (rzecz.) utwierdzenie | : (rzecz.) zahamowanie
restraints : restraints : (rzecz.) ubezwłasnowolnienie
restrict : restrict : (czas.) nakładać | : (czas.) ograniczać | : (czas.) ograniczyć | : (czas.) ścieśniać
restriction : restriction : (rzecz.) obostrzenie | : (rzecz.) ograniczenie | : (rzecz.) restrykcja | : (rzecz.) zastrzeżenie
restrictive : restrictive : (przym.) ograniczony | : (przym.) restrykcyjny | : (przym.) zamknięty
restrictively : restrictively : (przysł.) ograniczająco
restrictor : restrictor : (rzecz.) przepustnica
restroom : restroom : (rzecz.) klozet | : (rzecz.) szalet | : (rzecz.) toaleta
restructure : restructure : (czas.) rekonstruować | : (czas.) restrukturyzować | : (czas.) zrestrukturyzować
restyle : restyle : (czas.) przerabiać | : (czas.) przerobić | : (czas.) przestylizować
resubmit : resubmit : (czas.) prolongować
result : result : (czas.) kończyć | : (czas.) owocować | : (czas.) pociągać | : (czas.) powodować | : (czas.) skutkować | : (czas.) spowodować | : (czas.) wynikać | : (czas.) zaowocować | : (rzecz.) rezultat | : (rzecz.) skutek | : (rzecz.) wynik
resultant : resultant : (przym.) powstały | : (przym.) wygenerowany | : (przym.) wynikający | : (przym.) wynikowy | : (przym.) wypadkowy | : (rzecz.) splot | : (rzecz.) wypadkowa
resume : resume : (czas.) dokończyć | : (czas.) rozpoczynać | : (czas.) streścić | : (czas.) streszczać | : (czas.) wznawiać | : (czas.) wznowić | : (rzecz.) streszczenie | : (rzecz.) życiorys
resumption : resumption : (rzecz.) kontynuacja | : (rzecz.) wznowienie
resurface : resurface : (czas.) powracać | : (czas.) powrócić
resurgence : resurgence : (rzecz.) odżycie
resurrect : resurrect : (czas.) cucić | : (czas.) wskrzeszać | : (czas.) zmartwychwstać
resurrection : resurrection : (rzecz.) rezurekcja | : (rzecz.) wskrzeszenie | : (rzecz.) zmartwychwstanie
resuscitate : resuscitate : (czas.) odżywać | : (czas.) ożyć | : (czas.) ożywiać | : (czas.) wskrzeszać
resuscitation : resuscitation : (rzecz.) reanimacja | : (rzecz.) resuscytacja | : (rzecz.) wskrzeszenie
resuscitative : resuscitative : (przym.) ożywczy | : (przym.) reanimacyjny
resuscitator : resuscitator : (rzecz.) resuscytator | : (rzecz.) wskrzesiciel
ret : ret : (czas.) gnić | : (czas.) rosić
retail : retail : (przym.) detaliczny | : (rzecz.) detal | : (rzecz.) handel
retailer : retailer : (rzecz.) detalista
retailers : retailers : (rzecz.) hipermarket
retain : retain : (czas.) pamiętać | : (czas.) przetrzymać | : (czas.) przyjmować | : (czas.) utrzymać | : (czas.) utrzymywać | : (czas.) wstrzymać | : (czas.) zaangażować | : (czas.) zachować | : (czas.) zachowywać | : (czas.) zatrzymać | : (czas.) zatrzymywać
retainer : retainer : (rzecz.) orszak | : (rzecz.) służący | : (rzecz.) wasal | : (rzecz.) zachowanie
retainers : retainers : (rzecz.) orszak | : (rzecz.) świta
retake : retake : (czas.) odbierać | : (czas.) odbijać | : (rzecz.) zwrot
retaliate : retaliate : (czas.) mścić | : (czas.) odpłacać | : (czas.) odwzajemniać
retaliation : retaliation : (rzecz.) odpłata | : (rzecz.) odwet | : (rzecz.) zemsta
retaliatory : retaliatory : (przym.) odwetowy
retard : retard : (czas.) opóźniać | : (czas.) opóźnić | : (czas.) wstrzymywać
retardant : retardant : (przym.) ochronny | : (przym.) opóźniający | : (przym.) przeciwzapalny | : (przym.) zwalniający | : (rzecz.) opóźniacz | : (rzecz.) zwalniacz
retardation : retardation : (rzecz.) opóźnienie | : (rzecz.) retardacja | : (rzecz.) spóźnienie
retarget : retarget : (czas.) zmieniać
retell : retell : (czas.) przetłumaczyć
retention : retention : (rzecz.) areszt | : (rzecz.) retencja | : (rzecz.) wstrzymanie | : (rzecz.) zachowanie | : (rzecz.) zachowywanie | : (rzecz.) zatrzymanie
retentions : retentions : (rzecz.) podtrzymywanie
retentive : retentive : (przym.) trwały | : (przym.) wierny
rethink : rethink : (czas.) przemyśleć
reticence : reticence : (rzecz.) małomówność | : (rzecz.) niedomówienie
reticent : reticent : (przym.) małomówny | : (przym.) milczący | : (przym.) powściągliwy | : (przym.) skryty
reticular : reticular : (czas.) posiatkować | : (przym.) siatkowaty | : (przym.) siatkowy
reticulate : reticulate : (przym.) siatkowy
reticulated : reticulated : (czas.) posiatkować | : (przym.) siatkowy
reticulation : reticulation : (rzecz.) siatka
reticule : reticule : (rzecz.) siatka | : (rzecz.) torebka
retina : retina : (rzecz.) siatkówka
retinal : retinal : (przym.) siatkówkowy
retinue : retinue : (rzecz.) orszak | : (rzecz.) świta
retire : retire : (czas.) cofać | : (czas.) dymisjonować | : (czas.) iść | : (czas.) odchodzić | : (czas.) odejść | : (czas.) przechodzić | : (czas.) przejść | : (czas.) usuwać | : (czas.) wycofać | : (czas.) zdymisjonować
retired : retired : (przym.) emerytowany | : (przym.) osamotniony | : (przym.) samotny | : (przym.) ustronny
retirement : retirement : (rzecz.) dymisja | : (rzecz.) emerytura | : (rzecz.) osamotnienie
retiring : retiring : (przym.) małomówny | : (przym.) skromny
retort : retort : (czas.) odcinać | : (czas.) odparowywać | : (czas.) odpierać | : (czas.) replikować | : (czas.) ripostować | : (rzecz.) ostra | : (rzecz.) replika | : (rzecz.) retorta | : (rzecz.) riposta
retouch : retouch : (czas.) podretuszować | : (czas.) retuszować | : (czas.) wyretuszować | : (rzecz.) retusz | : (rzecz.) retuszowanie
retouched : retouched : (czas.) retuszować
retrace : retrace : (czas.) cofać | : (czas.) odtwarzać | : (czas.) powtarzać
retract : retract : (czas.) chować | : (czas.) cofać | : (czas.) odwoływać | : (czas.) wciągać
retractable : retractable : (przym.) chowany | : (przym.) wciągany
retractile : retractile : (przym.) kurczliwy
retraction : retraction : (rzecz.) odwołanie | : (rzecz.) wycofanie
retrain : retrain : (czas.) przekwalifikowywać | : (czas.) reedukować
retraining : retraining : (rzecz.) przekwalifikowanie
retransmission : retransmission : (rzecz.) retransmisja
retransmit : retransmit : (czas.) retransmitować
retreat : retreat : (czas.) cofać | : (czas.) rejterować | : (czas.) ustępować | : (czas.) wycofać | : (czas.) wycofywać | : (czas.) wypoczywać | : (czas.) zrejterować | : (rzecz.) odwrót | : (rzecz.) rejterada | : (rzecz.) rekolekcje | : (rzecz.) schronienie | : (rzecz.) ucieczka | : (rzecz.) ustronie | : (rzecz.) zacisze
retrench : retrench : (czas.) obciąć | : (czas.) obwarować | : (czas.) okopać | : (czas.) skracać | : (czas.) skrócić
retrenchment : retrenchment : (rzecz.) oszańcowanie | : (rzecz.) szaniec
retribution : retribution : (rzecz.) odpłata | : (rzecz.) odwet | : (rzecz.) zapłata | : (rzecz.) zemsta
retrieval : retrieval : (rzecz.) naprawa | : (rzecz.) odnalezienie | : (rzecz.) odzyskanie | : (rzecz.) odzyskiwanie | : (rzecz.) poratowanie | : (rzecz.) wydobywanie | : (rzecz.) wyszukiwanie
retrievals : retrievals : (rzecz.) odnalezienie
retrieve : retrieve : (czas.) aportować | : (czas.) naprawiać | : (czas.) naprawić | : (czas.) odczytać | : (czas.) odzyskać | : (czas.) odzyskiwać | : (czas.) poratować | : (czas.) powetować | : (czas.) wyszukać | : (czas.) wyszukiwać | : (czas.) zaaportować
retriever : retriever : (rzecz.) aporter
retro-virus : retro-virus : (rzecz.) retrowirus
retroact : retroact : (czas.) cofać | : (czas.) wycofywać
retroactive : retroactive : (przym.) wsteczny
retroactively : retroactively : (przysł.) retroaktywnie
retrocession : retrocession : (rzecz.) retrocesja
retrofit : retrofit : (czas.) wyposażyć
retrograde : retrograde : (czas.) cofać | : (przym.) regresywny | : (przym.) wsteczny | : (przym.) zacofany
retrogress : retrogress : (czas.) cofać | : (czas.) podupadać
retrogression : retrogression : (rzecz.) nawrót | : (rzecz.) wsteczność
retrospect : retrospect : (rzecz.) retrospekcja
retrospection : retrospection : (rzecz.) retrospekcja
retrospective : retrospective : (przym.) retrospektywny
retrospectively : retrospectively : (przysł.) wstecznie
retrovirus : retrovirus : (rzecz.) retrowirus
retry : retry : (czas.) ponawiać | : (czas.) ponowić
retune : retune : (czas.) przestrajać | : (rzecz.) przestrój
retuning : retuning : (rzecz.) przestrojenie
return : return : (czas.) odesłać | : (czas.) odwzajemniać | : (czas.) odwzajemnić | : (czas.) wracać | : (czas.) wrócić | : (czas.) zwalniać | : (czas.) zwracać | : (czas.) zwrócić | : (rzecz.) dochód | : (rzecz.) nawrót | : (rzecz.) odbicie | : (rzecz.) odebranie | : (rzecz.) powrót | : (rzecz.) wynik | : (rzecz.) zwrot
returnable : returnable : (przym.) zwrotny
returnee : returnee : (rzecz.) reemigrant
retype : retype : (czas.) przepisywać
reunion : reunion : (rzecz.) zjazd
reunite : reunite : (czas.) połączyć | : (czas.) zjednoczyć
reusability : reusability : (rzecz.) używalność | : (rzecz.) wieloużywalność
rev : rev : (czas.) obracać | : (rzecz.) obrót
rev-counter : rev-counter : (rzecz.) obrotomierz | : (rzecz.) tachometr
revalorization : revalorization : (rzecz.) rewaloryzacja
revaluation : revaluation : (rzecz.) przecena | : (rzecz.) przeszacowanie | : (rzecz.) rewaloryzacja | : (rzecz.) rewaluacja
revalue : revalue : (czas.) przewartościować | : (czas.) przewartościowywać
revamp : revamp : (czas.) odnawiać | : (czas.) przerabiać | : (czas.) reorganizować | : (czas.) rewidować
revamped : revamped : (czas.) przekształcać | : (czas.) reorganizować | : (czas.) ulepszać | : (czas.) usprawniać
reveal : reveal : (czas.) objawić | : (czas.) odkryć | : (czas.) odkrywać | : (czas.) odsłaniać | : (czas.) odsłonić | : (czas.) ujawniać | : (czas.) ujawnić | : (czas.) wyjawiać | : (czas.) wyjawić | : (czas.) zdradzać | : (czas.) zdradzić
revealing : revealing : (przym.) odkrywczy
reveille : reveille : (rzecz.) pobudka
revel : revel : (czas.) łajdaczyć | : (czas.) lumpować | : (czas.) poszaleć | : (czas.) rozkoszować | : (czas.) ucztować | : (czas.) zabawiać | : (czas.) zabawić | : (rzecz.) biesiada | : (rzecz.) uczta | : (rzecz.) zabawa
revelation : revelation : (rzecz.) apokalipsa | : (rzecz.) objawienie | : (rzecz.) odkrycie | : (rzecz.) rewelacja
reveller : reveller : (rzecz.) birbant | : (rzecz.) hulaka | : (rzecz.) lump
revelry : revelry : (rzecz.) bachanalia | : (rzecz.) biesiada | : (rzecz.) hulanka | : (rzecz.) uczta | : (rzecz.) ucztowanie | : (rzecz.) zabawa
revenant : revenant : (rzecz.) duch | : (rzecz.) upiór
revenge : revenge : (czas.) mścić | : (czas.) pomścić | : (czas.) zemścić | : (rzecz.) mściwość | : (rzecz.) pomsta | : (rzecz.) rewanż | : (rzecz.) zemsta
revenge-seeker : revenge-seeker : (rzecz.) odwetowiec
revengeful : revengeful : (przym.) mściwy
revenue : revenue : (rzecz.) dochód | : (rzecz.) przychód
reverberate : reverberate : (czas.) odbijać | : (czas.) oddawać | : (czas.) pobrzmiewać | : (czas.) promieniować
reverberation : reverberation : (rzecz.) pogłos
revere : revere : (czas.) czcić | : (czas.) szanować
reverence : reverence : (czas.) czcić | : (rzecz.) cześć | : (rzecz.) kult | : (rzecz.) namaszczenie | : (rzecz.) pietyzm | : (rzecz.) szacunek | : (rzecz.) uwielbienie
reverend : reverend : (przym.) czcigodny | : (przym.) przewielebny | : (przym.) wielebny | : (rzecz.) ksiądz
reverent : reverent : (przym.) czcigodny | : (przym.) szacowny | : (przym.) wielebny
reverential : reverential : (przym.) czcigodny | : (przym.) szacowny
reverentially : reverentially : (przysł.) nabożnie
reverie : reverie : (rzecz.) dumanie | : (rzecz.) marzenie | : (rzecz.) mrzonka | : (rzecz.) rozmarzenie | : (rzecz.) zaduma | : (rzecz.) zamyślenie
reversal : reversal : (rzecz.) odwracanie | : (rzecz.) odwrócenie | : (rzecz.) uchylenie | : (rzecz.) unieważnienie | : (rzecz.) zmiana | : (rzecz.) zwrot
reverse : reverse : (czas.) cofać | : (czas.) odwracać | : (czas.) odwrócić | : (czas.) przemieszczać | : (czas.) przenicować | : (czas.) wywracać | : (czas.) zanegować | : (czas.) zawracać | : (przym.) odwrotny | : (przym.) przeciwny | : (przym.) wsteczny | : (rzecz.) dekompilacja | : (rzecz.) odwrotność | : (rzecz.) porażka | : (rzecz.) przeciwieństwo | : (rzecz.) rewers | : (rzecz.) wyłóg
reversed : reversed : (czas.) wydarzyć
reverser : reverser : (rzecz.) nawrotnik
reversibility : reversibility : (rzecz.) odwracalność
reversible : reversible : (przym.) nawrotny | : (przym.) odwracalny
reversion : reversion : (rzecz.) atawizm | : (rzecz.) nawrót | : (rzecz.) powrót | : (rzecz.) rewersja
revert : revert : (czas.) odwracać | : (czas.) odwrócić | : (czas.) powracać | : (czas.) wracać | : (czas.) zawracać
review : review : (czas.) przeglądać | : (czas.) recenzować | : (czas.) zrecenzować | : (rzecz.) czasopismo | : (rzecz.) omówienie | : (rzecz.) opis | : (rzecz.) przegląd | : (rzecz.) przeglądnięcie | : (rzecz.) recenzja | : (rzecz.) repetytorium | : (rzecz.) rewia | : (rzecz.) weryfikacja | : (rzecz.) zrewidowanie
reviewed : reviewed : (czas.) poddawać
reviewer : reviewer : (rzecz.) krytyk | : (rzecz.) recenzent
revile : revile : (czas.) kląć | : (czas.) lżyć | : (czas.) urągać | : (czas.) wymyślać
revise : revise : (czas.) poprawiać | : (czas.) przeglądać | : (czas.) rewidować | : (rzecz.) dokonanie
reviser : reviser : (rzecz.) korektor | : (rzecz.) recenzent
revision : revision : (rzecz.) adiustacja | : (rzecz.) nowelizacja | : (rzecz.) poprawka | : (rzecz.) powtórka | : (rzecz.) przegląd | : (rzecz.) rewidowanie | : (rzecz.) rewizja | : (rzecz.) weryfikacja | : (rzecz.) zmiana
revisionism : revisionism : (rzecz.) rewizjonizm
revisionist : revisionist : (przym.) rewizjonistyczny | : (rzecz.) rewizjonista
revitalization : revitalization : (rzecz.) ożywienie | : (rzecz.) rewitalizacja
revitalize : revitalize : (czas.) ożywiać | : (czas.) ożywić | : (czas.) uaktywniać
revival : revival : (rzecz.) ocucenie | : (rzecz.) odrodzenie | : (rzecz.) odżycie | : (rzecz.) ożywienie | : (rzecz.) wznowienie
revive : revive : (czas.) cucić | : (czas.) ocucać | : (czas.) ocucić | : (czas.) odraczać | : (czas.) odradzać | : (czas.) odżyć | : (czas.) ożywiać | : (czas.) przywrócić | : (czas.) wskrzesić
reviver : reviver : (rzecz.) wskrzesiciel
revivification : revivification : (rzecz.) odświeżenie | : (rzecz.) ożywienie | : (rzecz.) zregenerowanie
revivify : revivify : (czas.) zregenerować
reviving : reviving : (czas.) odżyć
revocable : revocable : (przym.) odwołalny
revocation : revocation : (rzecz.) cofnięcie | : (rzecz.) odwołanie | : (rzecz.) unieważnienie
revoke : revoke : (czas.) cofać | : (czas.) odebrać | : (czas.) odmawiać | : (czas.) odmówić | : (czas.) odwołać | : (czas.) odwoływać | : (czas.) skasować | : (czas.) uchylać | : (czas.) unieważniać
revolt : revolt : (czas.) buntować | : (czas.) oburzać | : (czas.) powstawać | : (czas.) zbuntować | : (rzecz.) bunt | : (rzecz.) powstanie | : (rzecz.) rewolta
revolting : revolting : (przym.) buntowniczy | : (przym.) obrzydliwy | : (przym.) wstrętny
revoltingly : revoltingly : (przysł.) odrażająco
revolution : revolution : (rzecz.) obrót | : (rzecz.) odwrót | : (rzecz.) przewrót | : (rzecz.) rewolucja
revolutionary : revolutionary : (przym.) obrotowy | : (przym.) przewrotowy | : (przym.) rewolucyjny | : (rzecz.) rewolucjonista | : (rzecz.) wywrotowiec
revolutionist : revolutionist : (rzecz.) rewolucjonista
revolutionize : revolutionize : (czas.) rewolucjonizować | : (czas.) zrewolucjonizować
revolutions : revolutions : (rzecz.) obroty
revolve : revolve : (czas.) krążyć | : (czas.) kręcić | : (czas.) obracać | : (czas.) przekręcać | : (czas.) przekręcić
revolver : revolver : (rzecz.) pistolet | : (rzecz.) rewolwer
revolving : revolving : (przym.) obrotowy
revue : revue : (rzecz.) rewia
revulsion : revulsion : (rzecz.) niesmak | : (rzecz.) odciągnięcie | : (rzecz.) wstręt
reward : reward : (czas.) nagradzać | : (czas.) nagrodzić | : (czas.) wynagradzać | : (czas.) wynagrodzić | : (rzecz.) nagroda | : (rzecz.) odpłata | : (rzecz.) wynagrodzenie
rewarding : rewarding : (przym.) dochodowy
rewind : rewind : (czas.) naciągać | : (czas.) odwijać | : (czas.) przewijać | : (czas.) przewinąć | : (czas.) przezwajać
reword : reword : (czas.) przeredagować
rework : rework : (czas.) przerabiać | : (czas.) przeredagowywać
rewound : rewound : (czas.) nakręcić
rewrap : rewrap : (rzecz.) przewijanie
rewrite : rewrite : (czas.) przepisać | : (czas.) przepisywać | : (czas.) przerabiać | : (czas.) przerobić
rewritten : rewritten : (czas.) przepisać
rhapsodic : rhapsodic : (przym.) rapsodyczny
rhapsodize : rhapsodize : (czas.) unieść
rhapsody : rhapsody : (rzecz.) rapsod | : (rzecz.) rapsodia
rhenium : rhenium : (rzecz.) ren
rheostat : rheostat : (rzecz.) reostat
rhesus : rhesus : (rzecz.) makak | : (rzecz.) rezus
rhetoric : rhetoric : (rzecz.) retoryczność | : (rzecz.) retoryka
rhetorical : rhetorical : (przym.) retoryczny
rhetorically : rhetorically : (przysł.) retorycznie
rhetorician : rhetorician : (rzecz.) retor
rheumatic : rheumatic : (przym.) gośćcowy | : (przym.) reumatyczny | : (rzecz.) reumatyk
rheumatism : rheumatism : (rzecz.) gościec | : (rzecz.) reumatyzm
rheumatoid : rheumatoid : (przym.) reumatoidalny
rheumatologist : rheumatologist : (rzecz.) reumatolog
rheumatology : rheumatology : (rzecz.) reumatologia
rhinestone : rhinestone : (rzecz.) stras
rhinitis : rhinitis : (rzecz.) katar
rhino : rhino : (rzecz.) nosorożec
rhinoceros : rhinoceros : (rzecz.) nosorożec
rhizome : rhizome : (rzecz.) kłącze
rhizomes : rhizomes : (rzecz.) kłącze
rhodium : rhodium : (rzecz.) rod
rhododendron : rhododendron : (rzecz.) rododendron | : (rzecz.) różanecznik
rhomb : rhomb : (rzecz.) romb | : (rzecz.) ukośnik
rhombic : rhombic : (przym.) romboidalny | : (przym.) rombowy
rhomboid : rhomboid : (rzecz.) romboid | : (rzecz.) równoległobok
rhombus : rhombus : (rzecz.) romb
rhubarb : rhubarb : (rzecz.) rabarbar
rhyme : rhyme : (czas.) rymować | : (czas.) wierszować | : (rzecz.) rym | : (rzecz.) wiersz | : (rzecz.) wierszyk
rhyming : rhyming : (przym.) rymowy
rhythm : rhythm : (rzecz.) rytm | : (rzecz.) rytmika
rhythmic : rhythmic : (przym.) miarowy | : (przym.) rytmiczny
rhythmical : rhythmical : (przym.) rytmiczny
rhythmically : rhythmically : (przysł.) rytmicznie
rib : rib : (rzecz.) żeberko | : (rzecz.) żebro
ribald : ribald : (przym.) sprośny | : (rzecz.) rozpustnik
ribaldry : ribaldry : (rzecz.) grubiaństwo | : (rzecz.) ordynarność | : (rzecz.) sprośność
ribbed : ribbed : (przym.) żebrowy
ribbing : ribbing : (rzecz.) ożebrowanie | : (rzecz.) użebrowanie | : (rzecz.) żebro | : (rzecz.) żebrowanie
ribbon : ribbon : (rzecz.) baretka | : (rzecz.) splotka | : (rzecz.) tasiemka | : (rzecz.) taśma | : (rzecz.) wstążka | : (rzecz.) wstęga
riboflavin : riboflavin : (rzecz.) laktoflawina | : (rzecz.) ryboflawina
ribose : ribose : (rzecz.) ryboza
rice : rice : (rzecz.) ryż
ricers : ricers : (przym.) rycerski
rich : rich : (przym.) bogaty | : (przym.) obfity | : (przym.) pożywny | : (przym.) soczysty | : (przym.) wysokokaloryczny | : (przym.) zasobny | : (przym.) zbytkowny
richer : richer : (przym.) bogaty
riches : riches : (rzecz.) bogactwo
richly : richly : (przysł.) bogato | : (przysł.) dostatnio | : (przysł.) obficie | : (przysł.) okazale
richness : richness : (rzecz.) bogactwo
rickets : rickets : (rzecz.) krzywica
rickety : rickety : (przym.) chybotliwy | : (przym.) koślawy | : (przym.) krzywiczny | : (przym.) kulawy
rickrack : rickrack : (rzecz.) przybranie
rickshaw : rickshaw : (rzecz.) riksza | : (rzecz.) ryksza
ricochet : ricochet : (rzecz.) rykoszet
rid : rid : (czas.) oczyścić | : (czas.) oczyszczać | : (czas.) pozbawić | : (czas.) pozbyć | : (czas.) pozbywać | : (czas.) uwalniać | : (czas.) uwolnić | : (czas.) wybawić
riddance : riddance : (rzecz.) pozbycie | : (rzecz.) pozbywanie | : (rzecz.) uwolnienie | : (rzecz.) zwolnienie
riddle : riddle : (czas.) podziurawić | : (rzecz.) rzeszoto | : (rzecz.) sito | : (rzecz.) tajemnica | : (rzecz.) zagadka
ride : ride : (czas.) jechać | : (czas.) jeździć | : (rzecz.) jazda | : (rzecz.) kurs | : (rzecz.) podróż | : (rzecz.) przejazd | : (rzecz.) przejażdżka
rider : rider : (rzecz.) alonż | : (rzecz.) dżokej | : (rzecz.) jeździec | : (rzecz.) rowerzysta
ridge : ridge : (czas.) prążkować | : (rzecz.) brzeg | : (rzecz.) grań | : (rzecz.) grzbiet | : (rzecz.) kalenica | : (rzecz.) krawędź | : (rzecz.) redlina | : (rzecz.) skiba
ridging : ridging : (rzecz.) obredlanie | : (rzecz.) obsypywanie
ridicule : ridicule : (czas.) dworować | : (czas.) ośmieszać | : (czas.) wykpić | : (czas.) wyśmiać | : (czas.) wyśmiewać | : (rzecz.) śmieszność | : (rzecz.) szyderstwo
ridiculous : ridiculous : (przym.) bezsensowny | : (przym.) śmieszny | : (przym.) zabawny
ridiculously : ridiculously : (przysł.) absurdalnie | : (przysł.) śmiesznie
ridiculousness : ridiculousness : (rzecz.) śmieszność
riding : riding : (rzecz.) jazda | : (rzecz.) jeżdżenie | : (rzecz.) jeździectwo
riding-breeches : riding-breeches : (rzecz.) rajtuzy
riding-whip : riding-whip : (rzecz.) harap
rife : rife : (przym.) częsty | : (przym.) mnogi | : (przym.) obfity | : (przym.) pełny
riff-raff : riff-raff : (rzecz.) hołota
riffle : riffle : (rzecz.) próg
riffraff : riffraff : (rzecz.) chamstwo | : (rzecz.) draństwo | : (rzecz.) gałgaństwo | : (rzecz.) hołota | : (rzecz.) motłoch
rifle : rifle : (czas.) gwintować | : (czas.) nagwintować | : (czas.) obrabować | : (czas.) porwać | : (czas.) porywać | : (czas.) zrabować | : (rzecz.) fuzja | : (rzecz.) karabin | : (rzecz.) rusznica | : (rzecz.) strzelba | : (rzecz.) sztucer
rifle-range : rifle-range : (rzecz.) strzelnica
rifleman : rifleman : (rzecz.) strzelec | : (rzecz.) woltyżer
rifles : rifles : (rzecz.) strzelcy
rifling : rifling : (rzecz.) ograbienie | : (rzecz.) rabowanie
rift : rift : (rzecz.) kłótnia | : (rzecz.) pęknięcie | : (rzecz.) rozdźwięk | : (rzecz.) rysa | : (rzecz.) szczelina | : (rzecz.) szpara
rig : rig : (czas.) szachrować | : (czas.) wyfiokować | : (czas.) zmontować | : (rzecz.) machinacja | : (rzecz.) oszustwo | : (rzecz.) ożaglowanie | : (rzecz.) psota | : (rzecz.) rusztowanie | : (rzecz.) strój | : (rzecz.) takielunek | : (rzecz.) wygląd
rig-out : rig-out : (rzecz.) ciuch | : (rzecz.) strój
rigger : rigger : (rzecz.) sztukmistrz | : (rzecz.) takielarz
rigging : rigging : (rzecz.) olinowanie | : (rzecz.) takielunek
right : right : (przym.) dobry | : (przym.) odpowiedni | : (przym.) prawicowy | : (przym.) prawidłowy | : (przym.) prawostronny | : (przym.) prawy | : (przym.) słuszny | : (przym.) stosowny | : (przym.) trafny | : (przym.) właściwy | : (przysł.) dobrze | : (przysł.) dokładnie | : (przysł.) słusznie | : (przysł.) wprost | : (przysł.) zaraz | : (rzecz.) prawica | : (rzecz.) prawo | : (rzecz.) racja | : (rzecz.) słuszność | : (rzecz.) uprawnienie
right-bank : right-bank : (przym.) prawobrzeżny
right-hand : right-hand : (przym.) prawostronny | : (przym.) prawy
right-handed : right-handed : (przym.) praworęczny
right-of-way : right-of-way : (rzecz.) teren
right-sided : right-sided : (przym.) prawostronny
right-wing : right-wing : (przym.) prawicowy | : (rzecz.) prawica
right-winger : right-winger : (rzecz.) prawicowiec
righteous : righteous : (przym.) bogobojny | : (przym.) prawy | : (przym.) rzetelny | : (przym.) słuszny | : (przym.) sprawiedliwy
righteously : righteously : (przysł.) sprawiedliwie | : (przysł.) właściwie
righteousness : righteousness : (rzecz.) prawość
rightful : rightful : (przym.) legalny | : (przym.) pełnoprawny | : (przym.) prawny | : (przym.) prawowity | : (przym.) słuszny | : (przym.) sprawiedliwy
rightfully : rightfully : (przysł.) prawnie
rightfulness : rightfulness : (rzecz.) sprawiedliwość
rightist : rightist : (rzecz.) prawicowiec
rightly : rightly : (przysł.) słusznie
rightness : rightness : (rzecz.) prawość | : (rzecz.) słuszność | : (rzecz.) trafność
rightwing : rightwing : (przym.) prawicowy
rigid : rigid : (przym.) bezwzględny | : (przym.) nieugięty | : (przym.) sztywny | : (przym.) twardy
rigidity : rigidity : (rzecz.) nieugiętość | : (rzecz.) rygoryzm | : (rzecz.) sztywność | : (rzecz.) twardość
rigidly : rigidly : (przysł.) ściśle | : (przysł.) sztywno
rigmarole : rigmarole : (rzecz.) koszmar
rigor : rigor : (rzecz.) dreszcze | : (rzecz.) rygor | : (rzecz.) stężenie | : (rzecz.) sztywność | : (rzecz.) zesztywnienie
rigorist : rigorist : (rzecz.) rygorysta
rigorous : rigorous : (przym.) rygorystyczny | : (przym.) surowy
rigorously : rigorously : (przysł.) rygorystycznie | : (przysł.) ściśle
rigour : rigour : (rzecz.) rygor
rile : rile : (czas.) bóść | : (czas.) irytować | : (czas.) rozzłościć | : (czas.) wściekać | : (czas.) złościć
rill : rill : (rzecz.) strumyk
rim : rim : (rzecz.) bordiura | : (rzecz.) brzeg | : (rzecz.) cyrkiel | : (rzecz.) felga | : (rzecz.) krawędź | : (rzecz.) obręcz | : (rzecz.) obrzeże | : (rzecz.) obwódka | : (rzecz.) oprawka | : (rzecz.) otok | : (rzecz.) rant | : (rzecz.) wieniec
rime : rime : (rzecz.) rym | : (rzecz.) szron | : (rzecz.) wiersz
rimmed : rimmed : (przym.) otoczony
rims : rims : (rzecz.) felga
rind : rind : (rzecz.) koło | : (rzecz.) kora | : (rzecz.) krąg | : (rzecz.) łupina | : (rzecz.) łuska | : (rzecz.) obrączka | : (rzecz.) pierścień | : (rzecz.) pierścionek | : (rzecz.) skóra | : (rzecz.) skórka | : (rzecz.) spekulacja
ring : ring : (czas.) dźwięczeć | : (czas.) dzwonić | : (czas.) telefonować | : (rzecz.) dzwonek | : (rzecz.) kółko | : (rzecz.) obrączka | : (rzecz.) pierścień | : (rzecz.) pierścionek | : (rzecz.) ring
ring-dove : ring-dove : (rzecz.) grzywacz
ring-shaped : ring-shaped : (przym.) pierścieniowy
ringdove : ringdove : (rzecz.) grzywacz
ringed : ringed : (przym.) obrączkowy | : (przym.) pierścieniowaty
ringer : ringer : (rzecz.) dzwonek | : (rzecz.) dzwonnik
ringleader : ringleader : (rzecz.) herszt | : (rzecz.) prowodyr
ringlet : ringlet : (rzecz.) kółeczko | : (rzecz.) kółko | : (rzecz.) pierścionek
ringworm : ringworm : (rzecz.) grzybica | : (rzecz.) liszaj
rink : rink : (rzecz.) lodowisko | : (rzecz.) ślizgawka
rinse : rinse : (czas.) opłukać | : (czas.) płukać | : (czas.) przemywać | : (czas.) przepłukiwać | : (czas.) spłukać | : (czas.) wypłukać | : (czas.) wypłukiwać | : (rzecz.) płukanie | : (rzecz.) płukanka | : (rzecz.) przepłukiwanie | : (rzecz.) wypłukanie
rinsing : rinsing : (rzecz.) płukanie | : (rzecz.) spłukiwanie
riot : riot : (czas.) buntować | : (czas.) hulać | : (czas.) szaleć | : (czas.) wybujać | : (rzecz.) bunt | : (rzecz.) ruchawka | : (rzecz.) wykroczenie
rioter : rioter : (rzecz.) demonstrant | : (rzecz.) hulaka | : (rzecz.) rozpustnik
riotous : riotous : (przym.) buntowniczy | : (przym.) burzliwy
rip : rip : (czas.) drzeć | : (czas.) rozdzierać | : (czas.) rozerwać | : (czas.) rozłupywać | : (czas.) rozpruwać | : (czas.) rozrywać | : (czas.) rwać | : (czas.) spruć | : (czas.) trzaskać | : (czas.) zgrać | : (czas.) zgrywać | : (rzecz.) hulaka | : (rzecz.) pęknięcie | : (rzecz.) rozdarcie | : (rzecz.) rozprucie | : (rzecz.) zdzierstwo
rip-off : rip-off : (rzecz.) zdzierstwo
riparian : riparian : (przym.) nadbrzeżny
ripe : ripe : (przym.) dojrzały | : (przym.) dorodny | : (przym.) doskonały
ripen : ripen : (czas.) dojrzeć | : (czas.) dojrzewać
ripeness : ripeness : (rzecz.) dojrzałość
riposte : riposte : (czas.) ripostować | : (rzecz.) riposta
ripper : ripper : (rzecz.) rozpruwacz | : (rzecz.) spulchniacz
ripping : ripping : (przym.) pierwszorzędny | : (przym.) wdechowy
ripple : ripple : (czas.) czochrać | : (czas.) falować | : (czas.) marszczyć | : (czas.) pofalować | : (czas.) pomarszczyć | : (czas.) rozprzestrzeniać | : (czas.) szemrać | : (czas.) zaszumieć | : (czas.) zmarszczyć | : (rzecz.) czochranie | : (rzecz.) falowanie | : (rzecz.) marszczenie | : (rzecz.) pluskanie | : (rzecz.) sfalowanie | : (rzecz.) szmer | : (rzecz.) tętnienie | : (rzecz.) zmarszczka
rippling : rippling : (przym.) perlisty
riprap : riprap : (rzecz.) podłoże
rise : rise : (czas.) podlecieć | : (czas.) podnieść | : (czas.) podnosić | : (czas.) podrożeć | : (czas.) rosnąć | : (czas.) wschodzić | : (czas.) wspinać | : (czas.) wstać | : (czas.) zrodzić | : (rzecz.) podwyżka | : (rzecz.) powstanie | : (rzecz.) przybór | : (rzecz.) przyrost | : (rzecz.) rozkwit | : (rzecz.) ryż | : (rzecz.) utworzenie | : (rzecz.) wschodzenie | : (rzecz.) wydźwignięcie | : (rzecz.) wzlot | : (rzecz.) wzniesienie | : (rzecz.) wzrost | : (rzecz.) zwyżka
risen : risen : (czas.) podnieść
riser : riser : (rzecz.) nadlew | : (rzecz.) pion | : (rzecz.) podnóżek | : (rzecz.) podstawka
rising : rising : (rzecz.) podnoszenie | : (rzecz.) powstanie | : (rzecz.) wezbranie | : (rzecz.) wschodzenie | : (rzecz.) wzbieranie | : (rzecz.) wzrost
risk : risk : (czas.) ryzykować | : (czas.) zaryzykować | : (rzecz.) hazard | : (rzecz.) niebezpieczeństwo | : (rzecz.) ryzyko | : (rzecz.) zagrożenie
risky : risky : (przym.) hazardowy | : (przym.) niebezpieczny | : (przym.) ryzykowny
risotto : risotto : (rzecz.) risotto
risqué : risqué : (przym.) drastyczny
rissole : rissole : (rzecz.) sznycel
rite : rite : (rzecz.) ceremonia | : (rzecz.) ceremoniał | : (rzecz.) obrządek | : (rzecz.) obrzęd | : (rzecz.) ryt | : (rzecz.) rytuał
ritual : ritual : (przym.) obrzędowy | : (przym.) rytualny | : (rzecz.) obrządek | : (rzecz.) rytuał
ritually : ritually : (przysł.) rytualnie
ritzy : ritzy : (przym.) luksusowy
rival : rival : (czas.) rywalizować | : (rzecz.) firma | : (rzecz.) konkurent | : (rzecz.) rywal
rivalry : rivalry : (rzecz.) rywalizacja
rive : rive : (czas.) łupać | : (czas.) rozłupywać
river : river : (rzecz.) rzeka
riverbed : riverbed : (rzecz.) koryto | : (rzecz.) łożysko
riverside : riverside : (rzecz.) brzeg | : (rzecz.) nadrzecze
rivet : rivet : (czas.) nitować | : (czas.) przykuwać | : (czas.) przynitować | : (czas.) utkwić | : (czas.) wzmocnić | : (czas.) zacieśniać | : (czas.) zakuć | : (czas.) zanitować | : (czas.) znitować | : (rzecz.) nit
riveter : riveter : (rzecz.) niciarka | : (rzecz.) niciarz | : (rzecz.) nitownica
rivulet : rivulet : (rzecz.) rzeczka | : (rzecz.) strumień | : (rzecz.) strumyk
roach : roach : (rzecz.) karaluch | : (rzecz.) płoć | : (rzecz.) płotka
road : road : (rzecz.) dróg | : (rzecz.) droga | : (rzecz.) jezdnia | : (rzecz.) podróż | : (rzecz.) sposób | : (rzecz.) szosa | : (rzecz.) ulica
roadbed : roadbed : (przym.) podkładowy | : (rzecz.) podtorze
roadblock : roadblock : (rzecz.) barykada
roadhouse : roadhouse : (rzecz.) restauracja | : (rzecz.) zajazd
roadman : roadman : (rzecz.) drogowiec
roads : roads : (rzecz.) dróg | : (rzecz.) reda
roadside : roadside : (przym.) przydrożny | : (rzecz.) pobocze
roadstead : roadstead : (rzecz.) reda
roadster : roadster : (rzecz.) terenówka
roadway : roadway : (rzecz.) droga | : (rzecz.) jezdnia | : (rzecz.) szosa
roam : roam : (czas.) błąkać | : (czas.) wałęsać | : (czas.) wędrować | : (czas.) włóczyć | : (czas.) wywędrować | : (rzecz.) wędrowiec | : (rzecz.) wędrówka
roan : roan : (przym.) dereszowaty | : (przym.) graniasty
roar : roar : (czas.) grzmieć | : (czas.) huczeć | : (czas.) ryczeć | : (czas.) trąbić | : (czas.) wydzierać | : (czas.) zaryczeć | : (rzecz.) huk | : (rzecz.) ryk
roaring : roaring : (rzecz.) ryczenie
roast : roast : (czas.) podprażać | : (czas.) prażyć | : (czas.) smażyć | : (czas.) uprażyć | : (czas.) wyprażać | : (rzecz.) befsztyk | : (rzecz.) piec | : (rzecz.) pieczeń | : (rzecz.) pieczenie | : (rzecz.) piekarnik
roast-meat : roast-meat : (rzecz.) pieczyste
roaster : roaster : (rzecz.) piekarnik | : (rzecz.) prażak
rob : rob : (czas.) łupić | : (czas.) obłupić | : (czas.) obrabować | : (czas.) obrabowywać | : (czas.) okradać | : (czas.) okraść | : (czas.) rabować | : (czas.) rozgrabić | : (czas.) zawalić | : (czas.) zrabować
robber : robber : (rzecz.) bandyta | : (rzecz.) bandzior | : (rzecz.) grabieżca | : (rzecz.) hajdamak | : (rzecz.) hajdamaka | : (rzecz.) rabuś | : (rzecz.) rozbójnik | : (rzecz.) zbój | : (rzecz.) zbójca | : (rzecz.) złodziej
robbery : robbery : (rzecz.) bandytyzm | : (rzecz.) grabież | : (rzecz.) napad | : (rzecz.) okradzenie | : (rzecz.) rabowanie | : (rzecz.) rabunek | : (rzecz.) rozbój | : (rzecz.) skok | : (rzecz.) włamanie
robe : robe : (rzecz.) kontusz | : (rzecz.) podomka | : (rzecz.) suknia | : (rzecz.) szata | : (rzecz.) szlafrok | : (rzecz.) toga
robin : robin : (rzecz.) drozd | : (rzecz.) raszka | : (rzecz.) rudzik
robot : robot : (rzecz.) robot
robotics : robotics : (rzecz.) robotyka | : (rzecz.) robotyzacja
robots : robots : (rzecz.) robot
robust : robust : (przym.) czerstwy | : (przym.) dorodny | : (przym.) krzepki | : (przym.) mocny | : (przym.) rosły | : (przym.) rubaszny | : (przym.) silny | : (przym.) solidny | : (przym.) zdrowy | : (przym.) żelazny | : (przym.) żwawy
robustly : robustly : (przysł.) mocno | : (przysł.) rubasznie
robustness : robustness : (rzecz.) odporność | : (rzecz.) solidność | : (rzecz.) uodpornienie
rock : rock : (czas.) bujać | : (czas.) chybotać | : (czas.) huśtać | : (czas.) kołysać | : (czas.) rozbujać | : (czas.) wstrząsać | : (czas.) zachybotać | : (rzecz.) głaz | : (rzecz.) kamień | : (rzecz.) opoka | : (rzecz.) rock | : (rzecz.) skała
rocker : rocker : (rzecz.) biegun | : (rzecz.) bujak | : (rzecz.) wahacz
rocket : rocket : (rzecz.) raca | : (rzecz.) rakieta
rockiness : rockiness : (rzecz.) skalistość
rockweed : rockweed : (rzecz.) morszczyn
rocky : rocky : (przym.) chwiejny | : (przym.) skalisty | : (przym.) skalny
rococo : rococo : (przym.) rokokowy | : (rzecz.) rokoko
rod : rod : (rzecz.) drąg | : (rzecz.) drążek | : (rzecz.) laska | : (rzecz.) młot | : (rzecz.) pręt | : (rzecz.) różdżka | : (rzecz.) rózga | : (rzecz.) wędka
rodent : rodent : (rzecz.) gryzoń
rodents : rodents : (rzecz.) gryzonie
rodomontade : rodomontade : (rzecz.) fanfaronada
roe : roe : (rzecz.) ikra | : (rzecz.) łania | : (rzecz.) sarna
roebuck : roebuck : (rzecz.) rogacz
rogation : rogation : (rzecz.) litania
rogue : rogue : (rzecz.) drapichrust | : (rzecz.) figlarz | : (rzecz.) frant | : (rzecz.) huncwot | : (rzecz.) łajdak | : (rzecz.) łobuz | : (rzecz.) łotrzyk | : (rzecz.) niecnota | : (rzecz.) skurczybyk | : (rzecz.) szelma | : (rzecz.) szubrawiec | : (rzecz.) szuja | : (rzecz.) wywłoka | : (rzecz.) zgniłek | : (rzecz.) ziółko
roguery : roguery : (rzecz.) draństwo | : (rzecz.) hultajstwo | : (rzecz.) szubrawstwo
roguish : roguish : (przym.) figlarny | : (przym.) łajdacki | : (przym.) łobuzerski | : (przym.) łotrowski | : (przym.) szelmowski
roguishly : roguishly : (przysł.) łobuzersko
roguishness : roguishness : (rzecz.) figlarność
roister : roister : (czas.) zachowywać
roistering : roistering : (przym.) bitny
role : role : (rzecz.) rola
roll : roll : (czas.) kłębić | : (czas.) koziołkować | : (czas.) obracać | : (czas.) potoczyć | : (czas.) poturlać | : (czas.) przewalać | : (czas.) rolować | : (czas.) stoczyć | : (czas.) tarzać | : (czas.) toczyć | : (czas.) turlać | : (czas.) uwałować | : (czas.) walcować | : (czas.) wałować | : (czas.) wtaczać | : (czas.) zakasać | : (czas.) zataczać | : (czas.) zrolować | : (rzecz.) beczka | : (rzecz.) bułka | : (rzecz.) krążek | : (rzecz.) lista | : (rzecz.) przewracanie | : (rzecz.) rolka | : (rzecz.) rulon | : (rzecz.) spis | : (rzecz.) walcowanie | : (rzecz.) walec | : (rzecz.) werbel | : (rzecz.) wokanda | : (rzecz.) zwitek | : (rzecz.) zwój
roll-in/roll-out : roll-in/roll-out : (rzecz.) sprowadzanie-odprowadzanie
roll-up : roll-up : (rzecz.) roleta
rollback : rollback : (rzecz.) obniżka | : (rzecz.) odwracanie | : (rzecz.) zwijanie
roller : roller : (rzecz.) fala | : (rzecz.) roleta | : (rzecz.) walcownik | : (rzecz.) walec | : (rzecz.) wałek
roller-skate : roller-skate : (rzecz.) wrotka
roller-skates : roller-skates : (rzecz.) wrotka
rollick : rollick : (czas.) hałasować | : (czas.) hulać | : (czas.) swawolić | : (rzecz.) eskapada | : (rzecz.) swawola | : (rzecz.) wybryk
rollicking : rollicking : (przym.) huczny | : (przym.) swawolny
rolling : rolling : (rzecz.) falowanie | : (rzecz.) przechylanie | : (rzecz.) przewalanie | : (rzecz.) tabor | : (rzecz.) tarzanie | : (rzecz.) walcowanie | : (rzecz.) walcówka | : (rzecz.) zataczanie | : (rzecz.) zwijanie
rolling-mill : rolling-mill : (rzecz.) walcownia
rollover : rollover : (rzecz.) przepełnienie | : (rzecz.) refinansowanie
rollup : rollup : (rzecz.) roleta
rollway : rollway : (rzecz.) samotok
roly-poly : roly-poly : (rzecz.) legumina
roman : roman : (przym.) romański | : (przym.) rzymski | : (rzecz.) antykwa | : (rzecz.) rzymianin
romance : romance : (czas.) fantazjować | : (czas.) romansować | : (przym.) romansowy | : (rzecz.) romanca | : (rzecz.) romans | : (rzecz.) romansowanie | : (rzecz.) romantyczność | : (rzecz.) romantyka
romancer : romancer : (rzecz.) blagier | : (rzecz.) romansopisarz
romantic : romantic : (przym.) nastrojowy | : (przym.) romantyczny | : (przym.) sercowy | : (rzecz.) romantyk | : (rzecz.) romantyka
romantically : romantically : (przysł.) romantycznie
romanticism : romanticism : (rzecz.) romantyczność | : (rzecz.) romantyzm
romanticist : romanticist : (rzecz.) romantyk
romp : romp : (czas.) baraszkować | : (czas.) bawić | : (czas.) broić | : (czas.) brykać | : (czas.) buszować | : (czas.) dokazywać | : (czas.) hasać | : (czas.) swawolić | : (czas.) zbytkować | : (rzecz.) dokazywanie | : (rzecz.) swawola | : (rzecz.) wybryki
rompers : rompers : (rzecz.) śpioszki
roof : roof : (rzecz.) dach | : (rzecz.) podniebienie | : (rzecz.) zadaszenie
roof-tile : roof-tile : (rzecz.) dachówka
roofer : roofer : (rzecz.) dacharz | : (rzecz.) dachowiec | : (rzecz.) dekarz
roofing : roofing : (rzecz.) dekarstwo | : (rzecz.) zadaszenie
rooftop : rooftop : (rzecz.) dach
rook : rook : (czas.) oszukiwać | : (rzecz.) gawron | : (rzecz.) oszust | : (rzecz.) szuler | : (rzecz.) wieża
rookery : rookery : (rzecz.) kolonia | : (rzecz.) melina
rookie : rookie : (rzecz.) pierwszoroczniak | : (rzecz.) rekrut | : (rzecz.) żółtodziób
room : room : (rzecz.) archanioł | : (rzecz.) izba | : (rzecz.) komnata | : (rzecz.) miejsce | : (rzecz.) pokoik | : (rzecz.) pokój | : (rzecz.) pomieszczenie | : (rzecz.) przestrzeń | : (rzecz.) sala | : (rzecz.) stancja
room-mate : room-mate : (rzecz.) współlokator | : (rzecz.) współmieszkaniec
roommate : roommate : (rzecz.) współlokator | : (rzecz.) współmieszkaniec
roomy : roomy : (przym.) obszerny | : (przym.) przestronny | : (przym.) przestrzenny
roost : roost : (rzecz.) grzęda | : (rzecz.) żerdź
rooster : rooster : (rzecz.) kogut | : (rzecz.) kurek
root : root : (czas.) bruździć | : (czas.) dopingować | : (czas.) grzebać | : (czas.) kibicować | : (czas.) korzenić | : (czas.) ukorzeniać | : (czas.) zakorzeniać | : (czas.) zakorzenić | : (rzecz.) korzeń | : (rzecz.) okopowizna | : (rzecz.) pierwiastek | : (rzecz.) podstawa | : (rzecz.) źródło | : (rzecz.) źródłosłów
rooted : rooted : (przym.) mocny | : (przym.) trwały | : (przym.) zakorzeniony
rooter : rooter : (rzecz.) karczownik | : (rzecz.) kibic | : (rzecz.) wyorywacz
rootlet : rootlet : (rzecz.) korzonek
rope : rope : (czas.) przywiązywać | : (rzecz.) granica | : (rzecz.) hol | : (rzecz.) lina | : (rzecz.) postronek | : (rzecz.) powróz | : (rzecz.) skakanka | : (rzecz.) sznur
rope-dancer : rope-dancer : (rzecz.) linoskoczek
rope-ladder : rope-ladder : (rzecz.) sztormtrap
rope-maker : rope-maker : (rzecz.) powroźnik
ropedancer : ropedancer : (rzecz.) linoskoczek
ropeway : ropeway : (rzecz.) kolej
ropy : ropy : (przym.) lepki | : (przym.) lichy | : (przym.) marny
rosary : rosary : (rzecz.) klomb | : (rzecz.) różaniec | : (rzecz.) rozarium
rose : rose : (rzecz.) róż | : (rzecz.) róża | : (rzecz.) rozeta | : (rzecz.) rozetka | : (rzecz.) wzrost
rose-coloured : rose-coloured : (przym.) różowy
rose-garden : rose-garden : (rzecz.) rozarium
roseate : roseate : (przym.) różany | : (przym.) różowawy
rosemary : rosemary : (rzecz.) rozmaryn
roses : roses : (rzecz.) róż
rosette : rosette : (rzecz.) rozeta | : (rzecz.) rozetka | : (rzecz.) różyca
rosewood : rosewood : (rzecz.) palisander
rosin : rosin : (rzecz.) kalafonia | : (rzecz.) żywica
roster : roster : (rzecz.) lista | : (rzecz.) spis
rostrum : rostrum : (rzecz.) mównica | : (rzecz.) trybuna
rosy : rosy : (przym.) kwitnący | : (przym.) różany | : (przym.) różowy
rosy-cheeked : rosy-cheeked : (przym.) rumiany
rot : rot : (czas.) butwieć | : (czas.) gnić | : (czas.) gnoić | : (czas.) murszeć | : (czas.) niszczyć | : (czas.) próchnieć | : (czas.) przegnić | : (czas.) psuć | : (czas.) spróchnieć | : (czas.) zbutwieć | : (czas.) zmurszeć | : (rzecz.) gnicie | : (rzecz.) nonsens | : (rzecz.) psucie | : (rzecz.) zgnicie | : (rzecz.) zgnilizna
rot-proof : rot-proof : (rzecz.) butwienie
rota : rota : (rzecz.) grafik
rotary : rotary : (przym.) krążkowy | : (przym.) obiegowy | : (przym.) obrotowy | : (przym.) rotacyjny | : (przym.) wirnikowy
rotate : rotate : (czas.) krążyć | : (czas.) następować | : (czas.) obracać | : (czas.) obrócić | : (czas.) wirować
rotation : rotation : (rzecz.) kolejność | : (rzecz.) obieg | : (rzecz.) obrót | : (rzecz.) płodozmian | : (rzecz.) rotacja | : (rzecz.) skręcalność | : (rzecz.) wirowanie
rotational : rotational : (przym.) obrotowy | : (przym.) rotacyjny | : (przym.) wirowy
rotator : rotator : (rzecz.) rotator
rote : rote : (rzecz.) rutyna
rotogravure : rotogravure : (rzecz.) rotograwiura | : (rzecz.) wklęsłodruk
rotor : rotor : (rzecz.) wirnik
rotorcraft : rotorcraft : (rzecz.) wiropłat
rotten : rotten : (przym.) cuchnący | : (przym.) kiepski | : (przym.) parszy | : (przym.) zmurszały
rottenness : rottenness : (rzecz.) zepsucie | : (rzecz.) zgnilizna
rottenstone : rottenstone : (rzecz.) trypla
rotund : rotund : (przym.) okrągły
rotunda : rotunda : (rzecz.) rotunda
rotundity : rotundity : (rzecz.) okrągłość | : (rzecz.) pulchność
rouble : rouble : (rzecz.) rubel
rouge : rouge : (czas.) różować | : (rzecz.) róż | : (rzecz.) szminka
rough : rough : (przym.) brutalny | : (przym.) burzliwy | : (przym.) chropowaty | : (przym.) grubiański | : (przym.) gruboskórny | : (przym.) kostropaty | : (przym.) nierówny | : (przym.) niespokojny | : (przym.) pobieżny | : (przym.) przykry | : (przym.) spartański | : (przym.) szorstki | : (przym.) włochaty | : (przym.) zgrubny
rough-cast : rough-cast : (rzecz.) tynk
rough-hew : rough-hew : (czas.) okrzesać
rough-neck : rough-neck : (rzecz.) brutal | : (rzecz.) chuligan
roughcast : roughcast : (rzecz.) tynk
roughen : roughen : (czas.) schamieć
roughly : roughly : (przysł.) brutalnie | : (przysł.) chropowato | : (przysł.) grubo | : (przysł.) gwałtownie | : (przysł.) ordynarnie | : (przysł.) pobieżnie | : (przysł.) szorstko | : (przysł.) zgrubnie
roughneck : roughneck : (rzecz.) brutal | : (rzecz.) chuligan | : (rzecz.) łobuz | : (rzecz.) rozrabiaka
roughness : roughness : (rzecz.) chropowatość | : (rzecz.) nierówność | : (rzecz.) prymitywizm | : (rzecz.) szorstkość
roughrider : roughrider : (rzecz.) ujeżdżacz
roulade : roulade : (rzecz.) rolada | : (rzecz.) rulada
roulette : roulette : (rzecz.) radełko | : (rzecz.) ruleta | : (rzecz.) ruletka
round : round : (czas.) oprowadzać | : (czas.) zaokrąglać | : (czas.) zaokrąglić | : (przym.) dosadny | : (przym.) kulisty | : (przym.) okrągły | : (przym.) okrężny | : (przym.) potoczysty | : (przym.) szczery | : (przym.) uczciwy | : (rzecz.) cykl | : (rzecz.) kolej | : (rzecz.) kolejka | : (rzecz.) krąg | : (rzecz.) następstwo | : (rzecz.) obchód | : (rzecz.) obchodzenie | : (rzecz.) obieg | : (rzecz.) runda | : (rzecz.) seria | : (rzecz.) spęd | : (rzecz.) tura | : (rzecz.) udziec
round-shouldered : round-shouldered : (przym.) przygarbiony
round-the-clock : round-the-clock : (przym.) całodobowy | : (przym.) całodzienny
round-up : round-up : (rzecz.) łapanka | : (rzecz.) obława
roundabout : roundabout : (przym.) okólny | : (przym.) okrężny | : (przym.) pośredni | : (przym.) rozwlekły | : (rzecz.) karuzela | : (rzecz.) rondo
rounded : rounded : (przym.) obły | : (przym.) zaokrąglony
roundel : roundel : (rzecz.) krążek | : (rzecz.) medalionik | : (rzecz.) okno
roundhouse : roundhouse : (rzecz.) parowozownia
roundly : roundly : (przysł.) stanowczo
roundness : roundness : (rzecz.) kulistość | : (rzecz.) okrągłość
roundup : roundup : (rzecz.) łapanka | : (rzecz.) obława | : (rzecz.) przegląd | : (rzecz.) recenzja | : (rzecz.) spęd
roundworm : roundworm : (rzecz.) glista | : (rzecz.) obleniec
rouse : rouse : (czas.) budzić | : (czas.) obudzić | : (czas.) ocucić | : (czas.) ożywiać | : (czas.) pobudzać | : (czas.) pobudzić | : (czas.) podburzyć | : (czas.) podniecać | : (czas.) podniecić | : (czas.) wstrząsnąć | : (czas.) wypłaszać
roustabout : roustabout : (rzecz.) portowiec | : (rzecz.) wyrobnik
rout : rout : (czas.) gromić | : (czas.) rozgromić | : (rzecz.) pogrom | : (rzecz.) raut | : (rzecz.) rozgromienie | : (rzecz.) rozsypka | : (rzecz.) trasa
route : route : (rzecz.) ciąg | : (rzecz.) droga | : (rzecz.) marszruta | : (rzecz.) szlak | : (rzecz.) trasa
route-march : route-march : (rzecz.) marsz
router : router : (rzecz.) kolec | : (rzecz.) przesyłacz | : (rzecz.) traser
routine : routine : (rzecz.) koleina | : (rzecz.) procedura | : (rzecz.) rutyna
routinely : routinely : (przysł.) proceduralnie | : (przysł.) rutynowo
roux : roux : (rzecz.) zasmażka
rove : rove : (czas.) błądzić | : (czas.) błąkać | : (czas.) przewędrować | : (czas.) wędrować | : (czas.) włóczyć
rover : rover : (rzecz.) pirat | : (rzecz.) wędrowiec | : (rzecz.) wędrownik | : (rzecz.) włóczęga
row : row : (czas.) besztać | : (czas.) opływać | : (czas.) wiosłować | : (rzecz.) awantura | : (rzecz.) burda | : (rzecz.) draka | : (rzecz.) hałas | : (rzecz.) harmider | : (rzecz.) kłótnia | : (rzecz.) przeprawa | : (rzecz.) pyskówka | : (rzecz.) raban | : (rzecz.) rejwach | : (rzecz.) rów | : (rzecz.) rubryka | : (rzecz.) rząd | : (rzecz.) rządek | : (rzecz.) szereg | : (rzecz.) wers | : (rzecz.) wiersz | : (rzecz.) wiosłowanie | : (rzecz.) zamieszanie | : (rzecz.) zgiełk
rowan : rowan : (rzecz.) jarzębina | : (rzecz.) owoc
rowdily : rowdily : (przysł.) awanturniczo | : (przysł.) hałaśliwie
rowdiness : rowdiness : (rzecz.) awanturnictwo | : (rzecz.) hałaśliwość
rowdy : rowdy : (przym.) awanturniczy | : (przym.) hałaśliwy | : (rzecz.) awanturnik | : (rzecz.) chuligan | : (rzecz.) grandziarz
rowel : rowel : (rzecz.) kółko | : (rzecz.) sączek
rower : rower : (rzecz.) korsarz | : (rzecz.) wioślarz
rowing : rowing : (rzecz.) wioślarstwo | : (rzecz.) wiosłowanie
rowlock : rowlock : (rzecz.) dulka
rows : rows : (rzecz.) brewerie
royal : royal : (przym.) koronny | : (przym.) królewski | : (przym.) wspaniały | : (rzecz.) bombramżagiel
royalist : royalist : (rzecz.) rojalista
royalty : royalty : (rzecz.) królewskość | : (rzecz.) tantiema
rub : rub : (czas.) czochrać | : (czas.) czyścić | : (czas.) masować | : (czas.) nacierać | : (czas.) pocierać | : (czas.) przecierać | : (czas.) rozcierać | : (czas.) trzeć | : (czas.) uwierać | : (czas.) wcierać | : (czas.) wycierać | : (rzecz.) nacieranie | : (rzecz.) natarcie | : (rzecz.) sęk | : (rzecz.) starcie
rub-a-dub : rub-a-dub : (rzecz.) werbel
rubber : rubber : (rzecz.) guma | : (rzecz.) gumka | : (rzecz.) kauczuk | : (rzecz.) recepturka | : (rzecz.) rober | : (rzecz.) ścierka
rubberize : rubberize : (czas.) gumować
rubbers : rubbers : (rzecz.) gumiaki
rubbery : rubbery : (przym.) gumowaty | : (przym.) gumowy
rubbing : rubbing : (rzecz.) nacieranie | : (rzecz.) rozcieranie | : (rzecz.) wcieranie
rubbish : rubbish : (rzecz.) bambetle | : (rzecz.) brednia | : (rzecz.) bzdura | : (rzecz.) gruz | : (rzecz.) lichota | : (rzecz.) odpadki | : (rzecz.) śmieci | : (rzecz.) starzyzna | : (rzecz.) tandeta
rubble : rubble : (rzecz.) gruz | : (rzecz.) gruzy | : (rzecz.) osypisko | : (rzecz.) rumosz | : (rzecz.) rumowisko | : (rzecz.) szuter | : (rzecz.) tłuczeń | : (rzecz.) zsypisko | : (rzecz.) zwalisko | : (rzecz.) żwir
rubdown : rubdown : (rzecz.) nacieranie
rube : rube : (rzecz.) prostak
rubella : rubella : (rzecz.) różyczka
rubicund : rubicund : (przym.) rumiany
rubidium : rubidium : (rzecz.) rubid
rubric : rubric : (rzecz.) rubryka
ruby : ruby : (przym.) rubinowy | : (rzecz.) rubin
ruche : ruche : (rzecz.) kreza | : (rzecz.) riusza
rucksack : rucksack : (rzecz.) plecak
ruckus : ruckus : (rzecz.) burda | : (rzecz.) chryja
ruction : ruction : (rzecz.) awantura | : (rzecz.) granda
rudder : rudder : (rzecz.) ster
ruddiness : ruddiness : (rzecz.) krwistość
ruddy : ruddy : (przym.) czerwony | : (przym.) różowy | : (przym.) rumiany | : (przym.) sakramencki | : (przym.) świeży
rude : rude : (przym.) arogancki | : (przym.) grubiański | : (przym.) gruboskórny | : (przym.) gwałtowny | : (przym.) karczemny | : (przym.) niegrzeczny | : (przym.) nieprzyzwoity | : (przym.) nieuprzejmy | : (przym.) ordynarny | : (przym.) prostacki | : (przym.) prymitywny
rudely : rudely : (przysł.) niegrzecznie | : (przysł.) nieuprzejmie
rudeness : rudeness : (rzecz.) bezczelność | : (rzecz.) niegrzeczność | : (rzecz.) nieuprzejmość
rudiment : rudiment : (rzecz.) początek | : (rzecz.) zaczątek
rudimentary : rudimentary : (przym.) elementarny | : (przym.) podstawowy | : (przym.) rudymentarny | : (przym.) zasadniczy
rue : rue : (czas.) współczuć | : (czas.) żałować | : (rzecz.) ruta
rueful : rueful : (przym.) łzawy | : (przym.) smutny | : (przym.) żałosny
ruefully : ruefully : (przysł.) smutno
ruff : ruff : (rzecz.) atut | : (rzecz.) kołnierz | : (rzecz.) krawatka | : (rzecz.) kreza | : (rzecz.) kryza
ruffian : ruffian : (rzecz.) awanturnik | : (rzecz.) brutal | : (rzecz.) łotr | : (rzecz.) zbój
ruffle : ruffle : (czas.) bałaganić | : (czas.) burzyć | : (czas.) czochrać | : (czas.) drażnić | : (czas.) gnieść | : (czas.) jeżyć | : (czas.) marszczyć | : (czas.) mierzwić | : (czas.) nastroszać | : (czas.) niepokoić | : (czas.) pognieść | : (czas.) rozczochrać | : (czas.) rozwiewać | : (czas.) wichrzyć | : (czas.) zmarszczyć | : (czas.) zwichrzać
rug : rug : (rzecz.) derka | : (rzecz.) dywan | : (rzecz.) dywanik | : (rzecz.) kilim | : (rzecz.) koc
rugged : rugged : (przym.) chropowaty | : (przym.) gburowaty | : (przym.) mrukliwy | : (przym.) nierówny | : (przym.) skalisty | : (przym.) surowy | : (przym.) urwisty | : (przym.) wyboisty | : (przym.) złośliwy
ruggedness : ruggedness : (rzecz.) nierówność
ruin : ruin : (czas.) rujnować | : (czas.) trwonić | : (czas.) zepsuć | : (czas.) zrujnować | : (rzecz.) destrukcja | : (rzecz.) rudera | : (rzecz.) ruina | : (rzecz.) upadek | : (rzecz.) zagłada | : (rzecz.) zaprzepaszczenie
ruination : ruination : (rzecz.) ruina | : (rzecz.) upadek
ruinous : ruinous : (przym.) zgrubny | : (przym.) zgubny | : (przym.) zrujnowany
rule : rule : (czas.) orzekać | : (czas.) rządzić | : (rzecz.) berło | : (rzecz.) calówka | : (rzecz.) linia | : (rzecz.) orzeknięcie | : (rzecz.) panowanie | : (rzecz.) prawidło | : (rzecz.) przepis | : (rzecz.) przymiar | : (rzecz.) reguła | : (rzecz.) władza | : (rzecz.) zasada
rulebook : rulebook : (rzecz.) regulamin
ruler : ruler : (rzecz.) liniał | : (rzecz.) linijka | : (rzecz.) przyrząd | : (rzecz.) przywódca | : (rzecz.) rządca | : (rzecz.) władca
ruling : ruling : (przym.) panujący | : (rzecz.) decyzja | : (rzecz.) grafion | : (rzecz.) liniatura | : (rzecz.) liniowanie | : (rzecz.) orzeczenie | : (rzecz.) postanowienie | : (rzecz.) władanie | : (rzecz.) wyrok | : (rzecz.) zarządzanie
rum : rum : (przym.) dziwaczny | : (przym.) dziwny | : (rzecz.) rum
rumble : rumble : (czas.) burczeć | : (czas.) dudnić | : (czas.) grzmieć | : (czas.) huczeć | : (czas.) turkotać | : (czas.) zaburczeć | : (rzecz.) dudnienie | : (rzecz.) grzmot | : (rzecz.) huk | : (rzecz.) rumor | : (rzecz.) turkot
rumble-tumble : rumble-tumble : (rzecz.) landara | : (rzecz.) trzęsienie
rumen : rumen : (rzecz.) żwacz
ruminant : ruminant : (rzecz.) przeżuwacz
ruminate : ruminate : (czas.) przemyśleć | : (czas.) przeżuć | : (czas.) przeżuwać | : (czas.) rozmyślać | : (czas.) żuć
rumination : rumination : (rzecz.) przeżuwanie
rummage : rummage : (czas.) buszować | : (czas.) poszperać | : (czas.) przeszukiwać | : (czas.) szperać | : (czas.) szukać | : (rzecz.) przetrząsanie | : (rzecz.) szperanie
rummy : rummy : (przym.) dziwny
rumour : rumour : (rzecz.) fama | : (rzecz.) plotka | : (rzecz.) pogłoska | : (rzecz.) wieść
rump : rump : (rzecz.) kuper | : (rzecz.) rostbef | : (rzecz.) zad
rumple : rumple : (czas.) miąć | : (czas.) mierzwić | : (czas.) miętosić | : (czas.) zmiąć | : (czas.) zmiętosić
rumpus : rumpus : (rzecz.) awantura | : (rzecz.) burda | : (rzecz.) wrzawa | : (rzecz.) zgiełk
run : run : (czas.) biegać | : (czas.) ganiać | : (czas.) gnać | : (czas.) jechać | : (czas.) najechać | : (czas.) pędzić | : (czas.) prowadzić | : (czas.) spieszyć | : (czas.) uciekać | : (czas.) uruchamiać | : (czas.) wywoływać | : (rzecz.) biec | : (rzecz.) bieg | : (rzecz.) sklep | : (rzecz.) ślizg | : (rzecz.) trasa | : (rzecz.) tura
run-down : run-down : (rzecz.) rozbieg
run-off : run-off : (rzecz.) dogrywka | : (rzecz.) spływ
run-purge : run-purge : (rzecz.) przedmuchiwanie
run-through : run-through : (rzecz.) próba
run-time : run-time : (przym.) wykonawczy
run-up : run-up : (rzecz.) rozbieg
runabout : runabout : (rzecz.) mikrus | : (rzecz.) motorówka | : (rzecz.) samochodzik
runaway : runaway : (przym.) zbiegły | : (rzecz.) uciekinier | : (rzecz.) wybieg | : (rzecz.) zbieg
rundle : rundle : (rzecz.) bęben | : (rzecz.) gałka | : (rzecz.) koło | : (rzecz.) szczebel
rundown : rundown : (rzecz.) redukcja
rune : rune : (rzecz.) magia | : (rzecz.) zaklęcie
rung : rung : (rzecz.) szczebel
runic : runic : (przym.) runiczny
runlet : runlet : (rzecz.) beczułka | : (rzecz.) strumyk
runnel : runnel : (rzecz.) strumyk
runner : runner : (rzecz.) biegacz | : (rzecz.) dywan | : (rzecz.) goniec | : (rzecz.) kandydowanie | : (rzecz.) płoza | : (rzecz.) prowadnica | : (rzecz.) wirnik
running : running : (rzecz.) bieg | : (rzecz.) bieganie | : (rzecz.) gospodarzenie | : (rzecz.) jazda | : (rzecz.) kierowanie | : (rzecz.) kursowanie
runoff : runoff : (rzecz.) dogrywka | : (rzecz.) spływ
runway : runway : (rzecz.) bieżnia
rupee : rupee : (rzecz.) rupia
rupture : rupture : (czas.) pękać | : (czas.) przerywać | : (czas.) rwać | : (czas.) zrywać | : (rzecz.) pęknięcie | : (rzecz.) poróżnienie | : (rzecz.) przebicie | : (rzecz.) przepuklina | : (rzecz.) przerwa | : (rzecz.) przerwanie | : (rzecz.) przeszkoda | : (rzecz.) ruptura | : (rzecz.) zerwanie
rural : rural : (przym.) rolniczy | : (przym.) sielski | : (przym.) wiejski
rurally : rurally : (przysł.) wiejsko
ruse : ruse : (rzecz.) fortel | : (rzecz.) podstęp | : (rzecz.) przebiegłość
rush : rush : (czas.) gnać | : (czas.) mknąć | : (czas.) pędzić | : (czas.) popędzać | : (czas.) przynaglać | : (czas.) przyspieszyć | : (czas.) ruszać | : (czas.) spieszyć | : (czas.) śpieszyć | : (czas.) wpadać | : (rzecz.) pęd | : (rzecz.) podmuch | : (rzecz.) popyt | : (rzecz.) pośpiech | : (rzecz.) przypływ | : (rzecz.) sitowie
rushes : rushes : (rzecz.) sitowie | : (rzecz.) szuwary
russet : russet : (przym.) brunatny | : (przym.) czerwonobrązowy | : (rzecz.) reneta
rust : rust : (czas.) pordzewieć | : (czas.) rdzewieć | : (rzecz.) rdza
rust-proof : rust-proof : (przym.) nierdzewny | : (przym.) rdzoodporny
rust-resisting : rust-resisting : (przym.) nierdzewny
rustic : rustic : (przym.) chłopski | : (przym.) nieokrzesany | : (przym.) prosty | : (przym.) rustykalny | : (przym.) sielski | : (przym.) wiejski | : (przym.) wieśniaczy | : (przym.) wsiowy | : (rzecz.) cham | : (rzecz.) wieśniak
rustication : rustication : (rzecz.) boniowanie | : (rzecz.) rustyka
rusticity : rusticity : (rzecz.) chłopskość | : (rzecz.) nieokrzesanie | : (rzecz.) prostactwo | : (rzecz.) wiejskość
rustiness : rustiness : (rzecz.) zardzewiałość
rustle : rustle : (czas.) szeleścić | : (czas.) szumieć | : (czas.) zaszeleścić | : (rzecz.) grzechot | : (rzecz.) poszum | : (rzecz.) szelest | : (rzecz.) szmer | : (rzecz.) szum
rustler : rustler : (rzecz.) koniokrad
rustling : rustling : (rzecz.) szelest
rustproof : rustproof : (przym.) nierdzewny | : (przym.) rdzoodporny
rusty : rusty : (przym.) nieużyteczny | : (przym.) rdzawy | : (przym.) zardzewiały
rut : rut : (rzecz.) bekowisko | : (rzecz.) bruzda | : (rzecz.) koleina | : (rzecz.) ruja | : (rzecz.) rutyna | : (rzecz.) rykowisko | : (rzecz.) wyżłobienie
rutabaga : rutabaga : (rzecz.) brukiew | : (rzecz.) karpiel | : (rzecz.) rzepa
ruthenium : ruthenium : (rzecz.) ruten
ruthful : ruthful : (przym.) współczujący | : (przym.) zatroskany
ruthless : ruthless : (przym.) bezlitosny | : (przym.) bezpardonowy | : (przym.) bezwzględny
ruthlessly : ruthlessly : (przysł.) bezlitośnie | : (przysł.) bezwzględnie | : (przysł.) niemiłosiernie
ruthlessness : ruthlessness : (rzecz.) bezwzględność
rye : rye : (rzecz.) cygan | : (rzecz.) żyto
