xylogen : (n.) Nascent wood; wood cells in a forming state. | : (n.) Lignin.
xenomi : (n. pl.) A suborder of soft-rayed fresh-water fishes of which the blackfish of Alaska (Dallia pectoralis) is the type.
xenelasia : (n.) A Spartan institution which prohibited strangers from residing in Sparta without permission, its object probably being to preserve the national simplicity of manners.
xiphosura : (n. pl.) See Xiphura.
xanthic : (a.) Tending toward a yellow color, or to one of those colors, green being excepted, in which yellow is a constituent, as scarlet, orange, etc. | : (a.) Possessing, imparting, or producing a yellow color; as, xanthic acid. | : (a.) Of or pertaining to xanthic acid, or its compounds; xanthogenic. | : (a.) Of or pertaining to xanthin.
xylographic : (a.) Alt. of Xylographical
xanthate : (n.) A salt of xanthic; a xanthogenate.
xanthin : (n.) A crystalline nitrogenous body closely related to both uric acid and hypoxanthin, present in muscle tissue, and occasionally found in the urine and in some urinary calculi. It is also present in guano. So called from the yellow color of certain of its salts (nitrates). | : (n.) A yellow insoluble coloring matter extracted from yellow flowers; specifically, the coloring matter of madder. | : (n.) One of the gaseous or volatile decomposition products of the xanthates, and probably identical with carbon disulphide.
xylidic : (a.) Pertaining to, or designating, either one of two distinct acids which are derived from xylic acid and related compounds, and are metameric with uvitic acid.
xenogenesis : (n.) Same as Heterogenesis. | : (n.) The fancied production of an organism of one kind by an organism of another.
xiphius : (n.) A genus of cetaceans having a long, pointed, bony beak, usually two tusklike teeth in the lower jaw, but no teeth in the upper jaw.
xylyl : (n.) Any one of three metameric radicals which are characteristic respectively of the three xylenes.
xanthophyll : (n.) A yellow coloring matter found in yellow autumn leaves, and also produced artificially from chlorophyll; -- formerly called also phylloxanthin.
xylotile : (n.) Same as Parkesine.
xylostein : (n.) A glucoside found in the poisonous berries of a species of honeysuckle (Lonicera xylosteum), and extracted as a bitter, white, crystalline substance.
xenogamy : (n.) Cross fertilization.
xyloquinone : (n.) Any one of a group of quinone compounds obtained respectively by the oxidation of certain xylidine compounds. In general they are yellow crystalline substances.
xiphiplastron : (n.) The posterior, or fourth, lateral plate in the plastron of turtles; -- called also xiphisternum.
xylitone : (n.) A yellow oil having a geraniumlike odor, produced as a side product in making phorone; -- called also xylite oil.
xylophilous : (a.) Of or pertaining to the xylophilans.
xiphisterna : (pl. ) of Xiphisternum
xyst : (n.) Alt. of Xystus
xenurine : (n.) A cabassou.
xylophagides : (n. pl.) A tribe or family of dipterous flies whose larvae live in decayed wood. Some of the tropical species are very large.
xyloplastic : (a.) Formed of wood pulp by molds; relating to casts made of wood pulp in molds.
xanthide : (n.) A compound or derivative of xanthogen.
xenopterygii : (n. pl.) A suborder of fishes including Gobiesox and allied genera. These fishes have soft-rayed fins, and a ventral sucker supported in front by the pectoral fins. They are destitute of scales.
xiphidium : (n.) A genus of plants of the order Haemodraceae, having two-ranked, sword-shaped leaves.
xanthogenate : (n.) A salt of xanthic acid.
xenomania : (n.) A mania for, or an inordinate attachment to, foreign customs, institutions, manners, fashions, etc.
xanthophane : (n.) The yellow pigment present in the inner segments of the retina in animals. See Chromophane.
xeriff : (n.) A gold coin formerly current in Egypt and Turkey, of the value of about 9s. 6d., or about $2.30; -- also, in Morocco, a ducat.
xanthogenic : (a.) Producing a yellow color or compound; xanthic. See Xanthic acid, under Xanthic.
xeroderma : (n.) Ichthyosis. | : (n.) A skin disease characterized by the presence of numerous small pigmented spots resembling freckles, with which are subsequently mingled spots of atrophied skin.
xenia : (pl. ) of Xenium
xyloidin : (n.) A substance resembling pyroxylin, obtained by the action of nitric acid on starch; -- called also nitramidin.
xylic : (a.) Pertaining to, derived from, or related to, xylene; specifically, designating any one of several metameric acids produced by the partial oxidation of mesitylene and pseudo-cumene.
xiphiplastra : (pl. ) of Xiphiplastron
xenyl : (n.) The radical characteristic of xenylic compounds.
xanthorhamnin : (n.) A glucoside extracted from Persian berries as a yellow crystalline powder, used as a dyestuff.
xanthoprotein : (n.) A yellow acid substance formed by the action of hot nitric acid on albuminous or proteid matter. It is changed to a deep orange-yellow color by the addition of ammonia.
xerophagy : (n.) Among the primitive Christians, the living on a diet of dry food in Lent and on other fasts.
xanthoproteic : (a.) Pertaining to, or derived from, xanthoprotein; showing the characters of xanthoprotein; as, xanthoproteic acid; the xanthoproteic reaction for albumin.
xylonite : (n.) See Zylonite.
xylobalsamum : (n.) The dried twigs of a Syrian tree (Balsamodendron Gileadense).
xanthidium : (n.) A genus of minute unicellular algae of the desmids. These algae have a rounded shape and are armed with glochidiate or branched aculei. Several species occur in ditches, and others are found fossil in flint or hornstone.
xanthoxylum : (n.) A genus of prickly shrubs or small trees, the bark and rots of which are of a deep yellow color; prickly ash.
xiphophyllous : (a.) Having sword-shaped leaves.
xenotime : (n.) A native phosphate of yttrium occurring in yellowish-brown tetragonal crystals.
xanthosis : (n.) The yellow discoloration often observed in cancerous tumors.
xerophthalmia : (n.) An abnormal dryness of the eyeball produced usually by long-continued inflammation and subsequent atrophy of the conjunctiva.
xylocopa : (n.) A genus of hymenopterous insects including the carpenter. See Carpenter bee, under Carpenter.
xystarch : (n.) An office/ having the superintendence of the xyst.
xenodochium : (n.) A house for the reception of strangers. | : (n.) In the Middle Ages, a room in a monastery for the reception and entertainment of strangers and pilgrims, and for the relief of paupers. [Called also Xenodocheion.]
xylophaga : (n.) A genus of marine bivalves which bore holes in wood. They are allied to Pholas.
xeres : (n.) Sherry. See Sherry.
xanthium : (n.) A genus of composite plants in which the scales of the involucre are united so as to form a kind of bur; cocklebur; clotbur.
xenogenetic : (a.) Of or pertaining to xenogenesis; as, the xenogenetic origin of microzymes.
xylindein : (n.) A green or blue pigment produced by Peziza in certain kinds of decayed wood, as the beech, oak, birch, etc., and extracted as an amorphous powder resembling indigo.
xanthochroi : (n. pl.) A division of the Caucasian races, comprising the lighter-colored members.
xerophilous : (a.) Drought-loving; able withstand the absence or lack of moisture.
xeronic : (a.) Pertaining to, or designating, an acid, C8H12O4, related to fumaric acid, and obtained from citraconic acid as an oily substance having a bittersweet taste; -- so called from its tendency to form its anhydride.
xiphias : (n.) A genus of fishes comprising the common swordfish. | : (n.) The constellation Dorado. | : (n.) A comet shaped like a sword
xylamide : (n.) An acid amide derivative of xylic acid, obtained as a white crystalline substance.
xylograph : (n.) An engraving on wood, or the impression from such an engraving; a print by xylography.
xiphura : (n. pl.) Same as Limuloidea. Called also Xiphosura.
xenodochy : (n.) Reception of strangers; hospitality.
xylophilan : (n.) One of a tribe of beetles (Xylophili) whose larvae live on decayed wood.
xeronate : (n.) A salt of xeronic acid.
xylanthrax : (n.) Wood coal, or charcoal; -- so called in distinction from mineral coal.
x : ( ) X, the twenty-fourth letter of the English alphabet, has three sounds; a compound nonvocal sound (that of ks), as in wax; a compound vocal sound (that of gz), as in example; and, at the beginning of a word, a simple vocal sound (that of z), as in xanthic. See Guide to Pronunciation, // 217, 270, 271.
xylol : (n.) Same as Xylene.
xeme : (n.) An Arctic fork-tailed gull (Xema Sabinii).
xylopyrography : (n.) The art or practice of burning pictures on wood with a hot iron; -- called also poker painting. See Poker picture, under Poker.
xanthinine : (n.) A complex nitrogenous substance related to urea and uric acid, produced as a white powder; -- so called because it forms yellow salts, and because its solution forms a blue fluorescence like quinine.
xantho- : ( ) A combining form from Gr. xanqo`s yellow; as in xanthocobaltic salts. Used also adjectively in chemistry.
xyridaceous : (a.) Of or pertaining to a natural order (Xyrideae) of endogenous plants, of which Xyris is the type.
xanthorhiza : (n.) A genus of shrubby ranunculaceous plants of North America, including only the species Xanthorhiza apiifolia, which has roots of a deep yellow color; yellowroot. The bark is intensely bitter, and is sometimes used as a tonic.
xenylic : (a.) Pertaining to, derived from, designating, certain amido compounds obtained by reducing certain nitro derivatives of diphenyl.
xylographical : (a.) Of or pertaining to xylography, or wood engraving.
xylate : (n.) A salt of xylic acid.
xanthospermous : (a.) Having yellow seeds.
xenium : (n.) A present given to a guest or stranger, or to a foreign ambassador.
xeraphim : (n.) An old money of account in Bombay, equal to three fifths of a rupee.
xylite : (n.) A liquid hydrocarbon found in crude wood spirits.
xylophagous : (a.) Eating, boring in, or destroying, wood; -- said especially of certain insect larvae, crustaceans, and mollusks. | : (a.) Of or pertaining to the genus Xylophaga.
xylophagan : (n.) One of a tribe of beetles whose larvae bore or live in wood. | : (n.) Any species of Xylophaga. | : (n.) Any one of the Xylophagides.
xyletic : (a.) Pertaining to, or designating, a complex acid related to mesitylenic acid, obtained as a white crystalline substance by the action of sodium and carbon dioxide on crude xylenol.
xylographer : (n.) One who practices xylography.
xanthochroic : (a.) Having a yellowish or fair complexion; of or pertaining to the Xanthochroi.
xiphisternum : (n.) The posterior segment, or extremity, of the sternum; -- sometimes called metasternum, ensiform cartilage, ensiform process, or xiphoid process. | : (n.) The xiphiplastron.
xylocarpous : (a.) Bearing fruit which becomes hard or woody.
xanthose : (n.) An orange-yellow substance found in pigment spots of certain crabs.
xiphodon : (n.) An extinct genus of artiodactylous mammals found in the European Tertiary formations. It had slender legs, didactylous feet, and small canine teeth.
xylidine : (n.) Any one of six metameric hydrocarbons, (CH3)2.C6H3.NH2, resembling aniline, and related to xylene. They are liquids, or easily fusible crystalline substances, of which three are derived from metaxylene, two from orthoxylene, and one from paraxylene. They are called the amido xylenes.
xanthopuccine : (n.) One of three alkaloids found in the root of the yellow puccoon (Hydrastis Canadensis). It is a yellow crystalline substance, and resembles berberine.
xylem : (n.) That portion of a fibrovascular bundle which has developed, or will develop, into wood cells; -- distinguished from phloem.
xylorcin : (n.) A derivative of xylene obtained as a white crystalline substance which on exposure in the air becomes red; -- called also betaorcin.
xerophthalmy : (n.) Xerophthalmia.
xyris : (n.) A genus of endogenous herbs with grassy leaves and small yellow flowers in short, scaly-bracted spikes; yellow-eyed grass. There are about seventeen species in the Atlantic United States.
xanthopous : (a.) Having a yellow stipe, or stem.
xanthamide : (n.) An amido derivative of xanthic acid obtained as a white crystalline substance, C2H5O.CS.NH2; -- called also xanthogen amide.
xylotrya : (n.) A genus of marine bivalves closely allied to Teredo, and equally destructive to timber. One species (Xylotrya fimbriata) is very common on the Atlantic coast of the United States.
xylylene : (n.) Any one of three metameric radicals, CH2.C6H4.CH2, derived respectively from the three xylenes. Often used adjectively; as, xylylene alcohol.
xebec : (n.) A small three-masted vessel, with projecting bow stern and convex decks, used in the Mediterranean for transporting merchandise, etc. It carries large square sails, or both. Xebecs were formerly armed and used by corsairs.
xylo- : ( ) A combining form from Gr. xy`lon wood; as in xylogen, xylograph.
xanthorhoea : (n.) A genus of endogenous plants, native to Australia, having a thick, sometimes arborescent, stem, and long grasslike leaves. See Grass tree.
xylophone : (n.) An instrument common among the Russians, Poles, and Tartars, consisting of a series of strips of wood or glass graduated in length to the musical scale, resting on belts of straw, and struck with two small hammers. Called in Germany strohfiedel, or straw fiddle. | : (n.) An instrument to determine the vibrative properties of different kinds of wood.
xanthous : (a.) Yellow; specifically (Ethnol.), of or pertaining to those races of man which have yellowish, red, auburn, or brown hair.
xerif : (n.) A shereef.
xanthoxylene : (n.) A liquid hydrocarbon of the terpene series extracted from the seeds of a Japanese prickly ash (Xanthoxylum pipertium) as an aromatic oil.
xanthian : (a.) Of or pertaining to Xanthus, an ancient town on Asia Minor; -- applied especially to certain marbles found near that place, and now in the British Museum.
xylene : (n.) Any of a group of three metameric hydrocarbons of the aromatic series, found in coal and wood tar, and so named because found in crude wood spirit. They are colorless, oily, inflammable liquids, C6H4.(CH3)2, being dimethyl benzenes, and are called respectively orthoxylene, metaxylene, and paraxylene. Called also xylol.
xylenol : (n.) Any one of six metameric phenol derivatives of xylene, obtained as crystalline substances, (CH3)2.C6H3.OH.
xanthoma : (n.) A skin disease marked by the development or irregular yellowish patches upon the skin, especially upon the eyelids; -- called also xanthelasma.
xiphoidian : (a.) Xiphoid.
xylography : (n.) The art of engraving on wood. | : (n.) The art of making prints from the natural grain of wood. | : (n.) A method pf printing in colors upon wood for purposes of house decoration.
xystus : (n.) A long and open portico, for athletic exercises, as wrestling, running, etc., for use in winter or in stormy weather.
xanthogen : (n.) The hypothetical radical supposed to be characteristic of xanthic acid. | : (n.) Persulphocyanogen.
xyster : (n.) An instrument for scraping bones.
xiphioid : (a.) Of, pertaining to, or resembling, a cetacean of the genus Xiphius or family Xiphiidae.
xiphoid : (a.) Like a sword; ensiform. | : (a.) Of or pertaining to the xiphoid process; xiphoidian.
xanthodontous : (a.) Having yellow teeth.
xanthocarpous : (a.) Having yellow fruit.
xanthidia : (pl. ) of Xanthidium
xanthelasma : (n.) See Xanthoma.
xyloid : (a.) Resembling wood; having the nature of wood.
