barbra : Barbra : (rzecz.) Barbara
bartholomew : Bartholomew : (rzecz.) Bartłomiej
basilisk's : Basilisk's : (przym.) bazyliszkowy
becky : Becky : (rzecz.) Rebeka
benedictine : Benedictine : (rzecz.) benedyktyn
benjamin : Benjamin : (rzecz.) Beniamin
bob : Bob : (rzecz.) Robert
bolshevik : Bolshevik : (rzecz.) bolszewik
boolean : Boolean : (przym.) logiczny
byronism : Byronism : (rzecz.) bajronizm
baa : baa : (czas.) beczeć
babble : babble : (czas.) bełkotać | : (czas.) gadać | : (czas.) gaworzyć | : (czas.) paplać | : (czas.) rozgadać | : (rzecz.) gadanie | : (rzecz.) mamrotanie | : (rzecz.) paplanina
babbler : babbler : (rzecz.) gaduła | : (rzecz.) papla
babe : babe : (rzecz.) dzieciątko | : (rzecz.) dziecinka | : (rzecz.) dziecko | : (rzecz.) naiwniak | : (rzecz.) niemowlę
baboon : baboon : (rzecz.) głupek | : (rzecz.) pawian
baby : baby : (rzecz.) bobas | : (rzecz.) dzidziuś | : (rzecz.) dzieciątko | : (rzecz.) dziecina | : (rzecz.) dziecinka | : (rzecz.) dzieciuch | : (rzecz.) dziecko | : (rzecz.) kochanie | : (rzecz.) niemowlak | : (rzecz.) niemowlę | : (rzecz.) noworodek | : (rzecz.) złotko
baby-linen : baby-linen : (rzecz.) wyprawka
baby-sitter : baby-sitter : (rzecz.) niania
babyhood : babyhood : (rzecz.) niemowlęctwo
babyish : babyish : (przym.) dziecinny | : (przym.) niemowlęcy
babysitter : babysitter : (rzecz.) niania
baccarat : baccarat : (rzecz.) bakarat
bacchanal : bacchanal : (przym.) bachusowy
bacchanalia : bacchanalia : (rzecz.) bachanalia
bachelor : bachelor : (rzecz.) bakałarz | : (rzecz.) kawaler | : (rzecz.) licencjat
bachelor's : bachelor's : (przym.) kawalerski
bachelorhood : bachelorhood : (rzecz.) kawalerstwo
bacillus : bacillus : (rzecz.) bakcyl | : (rzecz.) lasecznik | : (rzecz.) prątek
back : back : (czas.) cofać | : (czas.) odwzajemnić | : (czas.) podkasać | : (czas.) podpierać | : (czas.) popierać | : (czas.) wesprzeć | : (przym.) odwrotny | : (przym.) plecowy | : (przym.) tylny | : (przysł.) niegrzecznie | : (przysł.) wstecz | : (rzecz.) grzbiet | : (rzecz.) krzyż | : (rzecz.) obrona | : (rzecz.) obrońca | : (rzecz.) oparcie | : (rzecz.) plecy | : (rzecz.) powracanie | : (rzecz.) powrót | : (rzecz.) samochód | : (rzecz.) tył | : (rzecz.) wierzch
back-comb : back-comb : (czas.) tapirować | : (czas.) utapirować
back-current : back-current : (rzecz.) przeciwprąd
back-end : back-end : (rzecz.) zaplecze
back-lit : back-lit : (przym.) podświetlany
back-to-back : back-to-back : (przym.) symetryczny
back-up : back-up : (przym.) zapasowy
backbite : backbite : (czas.) obgadać | : (czas.) obmawiać | : (czas.) oczerniać
backbiter : backbiter : (rzecz.) oszczerca
backbiting : backbiting : (rzecz.) obgadywanie | : (rzecz.) obmawianie | : (rzecz.) obmowa
backbone : backbone : (rzecz.) grzbiet | : (rzecz.) istota | : (rzecz.) kręgosłup | : (rzecz.) oparcie | : (rzecz.) ostoja | : (rzecz.) podstawa | : (rzecz.) trzon
backbreaking : backbreaking : (przym.) karkołomny
backchat : backchat : (rzecz.) impertynencja
backcloth : backcloth : (rzecz.) tło
backcomb : backcomb : (czas.) tapirować | : (czas.) utapirować
backdate : backdate : (czas.) antydatować
backdoor : backdoor : (przym.) potajemny | : (przym.) tajemniczy | : (przym.) zakulisowy | : (rzecz.) furtka | : (rzecz.) wybieg | : (rzecz.) zapadnia
backdrop : backdrop : (rzecz.) tło | : (rzecz.) zasłona
backer : backer : (rzecz.) partyzant | : (rzecz.) stronnik
backfill : backfill : (rzecz.) podsadzka
backfiring : backfiring : (rzecz.) strzelanie
backflow : backflow : (rzecz.) cofka
backgammon : backgammon : (rzecz.) tryktrak
background : background : (rzecz.) pochodzenie | : (rzecz.) podstawa | : (rzecz.) przygotowanie | : (rzecz.) tło | : (rzecz.) wykształcenie | : (rzecz.) założenie
backhand : backhand : (rzecz.) bekhend | : (rzecz.) uderzenie
backhander : backhander : (rzecz.) bekhend
backhoe : backhoe : (rzecz.) koparka
backhouse : backhouse : (rzecz.) oficyna
backing : backing : (rzecz.) podłoże | : (rzecz.) podsadzanie | : (rzecz.) pokrycie | : (rzecz.) pomoc | : (rzecz.) poparcie | : (rzecz.) protekcja | : (rzecz.) wsparcie | : (rzecz.) wypełnianie
backing-off : backing-off : (rzecz.) zataczanie
backlash : backlash : (rzecz.) luz
backlight : backlight : (rzecz.) podświetlenie
backlog : backlog : (rzecz.) zaległość | : (rzecz.) zaległości
backorder : backorder : (rzecz.) zamówienie | : (rzecz.) zlecenie
backpack : backpack : (rzecz.) plecak | : (rzecz.) tornister
backrest : backrest : (rzecz.) oparcie
backs : backs : (rzecz.) plecy
backside : backside : (rzecz.) tyłek | : (rzecz.) zadek
backslid : backslid : (czas.) stoczyć
backslide : backslide : (czas.) sprzeniewierzyć
backspace : backspace : (czas.) cofać
backspaced : backspaced : (rzecz.) cofacz
backspaces : backspaces : (rzecz.) cofacz
backspacing : backspacing : (rzecz.) cofacz | : (rzecz.) cofanie
backstage : backstage : (przym.) prywatny | : (przym.) zakulisowy
backstay : backstay : (rzecz.) baksztag | : (rzecz.) usztywnienie
backstitched : backstitched : (czas.) przestebnować
backstitching : backstitching : (rzecz.) przestebnowanie
backstreet : backstreet : (rzecz.) uliczka | : (rzecz.) zaułek
backtrack : backtrack : (czas.) wycofywać
backtracking : backtracking : (rzecz.) nawracanie | : (rzecz.) wycofywanie
backward : backward : (przym.) opieszały | : (przym.) tylny | : (przym.) wsteczny | : (przym.) zacofany | : (przysł.) tyłem | : (przysł.) wspak | : (przysł.) wstecz
backwardness : backwardness : (rzecz.) zacofanie | : (rzecz.) zapóźnienie
backwards : backwards : (przysł.) tyłem | : (przysł.) wspak | : (przysł.) wstecz
backwater : backwater : (rzecz.) cofka | : (rzecz.) prowincja | : (rzecz.) rozlewisko | : (rzecz.) spiętrzenie | : (rzecz.) zalew | : (rzecz.) zaścianek
backwoods : backwoods : (rzecz.) głusza
backyard : backyard : (rzecz.) dziedziniec | : (rzecz.) podwórko
bacon : bacon : (rzecz.) bekon | : (rzecz.) boczek | : (rzecz.) słonina
bacteria : bacteria : (rzecz.) bakteria | : (rzecz.) bakterie
bacterial : bacterial : (przym.) bakteryjny
bactericidal : bactericidal : (przym.) bakteriobójczy
bacteriological : bacteriological : (przym.) bakteriologiczny
bacteriologist : bacteriologist : (rzecz.) bakteriolog
bacteriology : bacteriology : (rzecz.) bakteriologia
bacterium : bacterium : (rzecz.) bakteria | : (rzecz.) zarazek
bad : bad : (przym.) chory | : (przym.) kiepski | : (przym.) kusy | : (przym.) lichy | : (przym.) morowy | : (przym.) niedobry | : (przym.) niegrzeczny | : (przym.) nieprzyjemny | : (przym.) nieściągalny | : (przym.) nieświeży | : (przym.) okropny | : (przym.) zdrożny | : (przym.) zły | : (przysł.) niedobrze | : (rzecz.) zło | : (rzecz.) zły
bad-tempered : bad-tempered : (przym.) gderliwy
baddie : baddie : (rzecz.) bandzior
badge : badge : (rzecz.) naszywka | : (rzecz.) numer | : (rzecz.) odznaka | : (rzecz.) oznaka | : (rzecz.) plakietka | : (rzecz.) tarcza | : (rzecz.) żeton
badger : badger : (rzecz.) borsuk
badinage : badinage : (rzecz.) przekomarzanie
badly : badly : (przysł.) bardzo | : (przysł.) dotkliwie | : (przysł.) intensywnie | : (przysł.) kiepsko | : (przysł.) marnie | : (przysł.) niepomyślnie | : (przysł.) paskudnie | : (przysł.) silnie | : (przysł.) źle
badminton : badminton : (rzecz.) badminton | : (rzecz.) kometka
badness : badness : (rzecz.) lichość | : (rzecz.) niegodziwość
baffle : baffle : (czas.) krzyżować | : (czas.) łudzić | : (czas.) pokrzyżować | : (czas.) przegradzać | : (czas.) skonfundować | : (czas.) udaremniać | : (czas.) urągać | : (czas.) zakłopotać | : (czas.) zastawiać | : (czas.) zawodzić | : (czas.) zdumiewać | : (rzecz.) deflektor | : (rzecz.) przegroda
baffled : baffled : (przym.) bezradny | : (przym.) zdumiony
baffling : baffling : (przym.) kłopotliwy
bag : bag : (czas.) zapakować | : (rzecz.) brzydula | : (rzecz.) plecak | : (rzecz.) pokrowiec | : (rzecz.) torba | : (rzecz.) torebka | : (rzecz.) walizka | : (rzecz.) worek
bag-piper : bag-piper : (rzecz.) dudziarz
bagatelle : bagatelle : (rzecz.) bagatela | : (rzecz.) bilard
bagel : bagel : (rzecz.) obwarzanek
bagful : bagful : (rzecz.) torba
baggage : baggage : (rzecz.) bagaż | : (rzecz.) ekwipunek
bagger : bagger : (rzecz.) bagrownica | : (rzecz.) workownica
bagging : bagging : (rzecz.) parcianka | : (rzecz.) workowanie
baggy : baggy : (przym.) luźny | : (przym.) obszerny | : (przym.) workowaty | : (przym.) workowy
bagman : bagman : (rzecz.) komiwojażer
bagnio : bagnio : (rzecz.) burdel | : (rzecz.) łaźnia | : (rzecz.) więzienie
bagpipe : bagpipe : (rzecz.) duda | : (rzecz.) kobza
bagpiper : bagpiper : (rzecz.) kobziarz
bagpipes : bagpipes : (rzecz.) dudy
baguette : baguette : (rzecz.) bagietka
bah : bah : (wykrzyknik) ba
bail : bail : (czas.) czerpać | : (rzecz.) czerpak | : (rzecz.) gwarancja | : (rzecz.) kabłąk | : (rzecz.) kaucja | : (rzecz.) obłąk | : (rzecz.) poręczenie | : (rzecz.) poręczyciel | : (rzecz.) poręka | : (rzecz.) zakładnik
bailer : bailer : (rzecz.) czerpak | : (rzecz.) szlamówka
bailiff : bailiff : (rzecz.) komornik | : (rzecz.) zarządca
bailing : bailing : (rzecz.) łyżkowanie
bailment : bailment : (rzecz.) zdeponowanie
bailout : bailout : (rzecz.) dofinansowanie
bailsman : bailsman : (rzecz.) gwarant | : (rzecz.) poręczyciel
bait : bait : (czas.) bestwić | : (czas.) drażnić | : (czas.) nęcić | : (czas.) popasać | : (czas.) szczuć | : (rzecz.) pokusa | : (rzecz.) przynęta | : (rzecz.) wabik
baize : baize : (rzecz.) piec | : (rzecz.) ryps | : (rzecz.) sukno
bake : bake : (czas.) dopalić | : (czas.) prażyć | : (czas.) wypiekać
bakelite : bakelite : (rzecz.) bakelit
baker : baker : (rzecz.) piekarnia | : (rzecz.) piekarz
baker's : baker's : (rzecz.) piekarnia
bakery : bakery : (rzecz.) piekarnia | : (rzecz.) piekarnictwo
baking : baking : (rzecz.) pieczenie | : (rzecz.) piekarnictwo | : (rzecz.) piekarstwo | : (rzecz.) wypał | : (rzecz.) wypalanie | : (rzecz.) wypieczenie | : (rzecz.) wypiek | : (rzecz.) wypiekanie
baksheesh : baksheesh : (rzecz.) napiwek
bal : bal : (przym.) balowy
balaclava : balaclava : (rzecz.) kominiarka
balalaika : balalaika : (rzecz.) bałałajka
balance : balance : (czas.) balansować | : (czas.) bilansować | : (czas.) równoważyć | : (czas.) wyważyć | : (czas.) zbilansować | : (rzecz.) balans | : (rzecz.) bilans | : (rzecz.) kompromis | : (rzecz.) równowaga | : (rzecz.) saldo | : (rzecz.) waga | : (rzecz.) współzależność | : (rzecz.) wyważenie | : (rzecz.) zrównoważenie
balanced : balanced : (przym.) pełnowartościowy
balancer : balancer : (rzecz.) równoważnik | : (rzecz.) stabilizator | : (rzecz.) statecznik | : (rzecz.) wyrównywacz | : (rzecz.) wyważarka
balancing : balancing : (rzecz.) równoważenie | : (rzecz.) wyważanie | : (rzecz.) wyważenie | : (rzecz.) zrównoważenie
balancing-pole : balancing-pole : (rzecz.) balans
balata : balata : (rzecz.) balata
balcony : balcony : (rzecz.) balkon
bald : bald : (przym.) bezlistny | : (przym.) jawny | : (przym.) łysy
bald-headed : bald-headed : (przym.) łysy
baldachin : baldachin : (rzecz.) baldach
balderdash : balderdash : (rzecz.) duby
baldhead : baldhead : (przym.) łysy
balding : balding : (przym.) łysiejący
baldly : baldly : (przysł.) poważnie
baldness : baldness : (rzecz.) łysienie | : (rzecz.) łysina
baldric : baldric : (rzecz.) pendent
bale : bale : (rzecz.) bal | : (rzecz.) bela | : (rzecz.) niedola | : (rzecz.) nieszczęście | : (rzecz.) zguba
baleen : baleen : (rzecz.) fiszbin
balefire : balefire : (rzecz.) sobótka
baleful : baleful : (przym.) nieszczęsny | : (przym.) zgubny | : (przym.) złowrogi
baling : baling : (rzecz.) belowanie | : (rzecz.) czerpanie
balk : balk : (czas.) narowić | : (czas.) przeszkadzać | : (czas.) udaremniać | : (czas.) udaremnić | : (czas.) utkwić | : (czas.) wzdragać | : (czas.) zatrzymać | : (rzecz.) bal | : (rzecz.) belka | : (rzecz.) miedza | : (rzecz.) niepowodzenie | : (rzecz.) przeszkoda | : (rzecz.) zawada
balky : balky : (przym.) krnąbrny | : (przym.) narowisty
ball : ball : (rzecz.) bal | : (rzecz.) bila | : (rzecz.) gałka | : (rzecz.) kłębek | : (rzecz.) kula | : (rzecz.) kulka | : (rzecz.) motek | : (rzecz.) piłka | : (rzecz.) siatkówka | : (rzecz.) zabawa
ball-pen : ball-pen : (rzecz.) długopis
ball-shaped : ball-shaped : (przym.) kulisty
ballad : ballad : (rzecz.) ballada | : (rzecz.) pieśń
ballast : ballast : (rzecz.) balast | : (rzecz.) balastowanie | : (rzecz.) podsypka | : (rzecz.) zrównoważenie
ballasting : ballasting : (rzecz.) balastowanie
ballerina : ballerina : (rzecz.) balerina | : (rzecz.) baletnica
ballet : ballet : (rzecz.) balet
ballet-dancer : ballet-dancer : (rzecz.) baletnica | : (rzecz.) baletnik
ballgame : ballgame : (rzecz.) rozgrywka
balling : balling : (rzecz.) grudkowanie | : (rzecz.) sferoidyzacja | : (rzecz.) zbrylanie
ballista : ballista : (rzecz.) balista
ballistic : ballistic : (przym.) balistyczny
ballistics : ballistics : (rzecz.) balistyka
ballonet : ballonet : (rzecz.) balonik
balloon : balloon : (czas.) dymać | : (czas.) nadymać | : (rzecz.) balon | : (rzecz.) balonik | : (rzecz.) dymek
ballooning : ballooning : (rzecz.) baloniarstwo | : (rzecz.) pęcznienie | : (rzecz.) wydęcie | : (rzecz.) wydymanie
balloonist : balloonist : (rzecz.) baloniarz
ballot : ballot : (czas.) głosować | : (rzecz.) balotaż | : (rzecz.) balotowanie | : (rzecz.) głosowanie
ballot-box : ballot-box : (rzecz.) urna
balloting : balloting : (rzecz.) balotowanie
ballpark : ballpark : (rzecz.) boisko
ballplayer : ballplayer : (rzecz.) baseballista
ballpoint : ballpoint : (rzecz.) długopis
balls : balls : (rzecz.) bile | : (rzecz.) piłeczki
bally : bally : (przym.) cholerny
ballyhoo : ballyhoo : (rzecz.) hałas
balm : balm : (rzecz.) balsam | : (rzecz.) pociecha
balmy : balmy : (przym.) balsamiczny | : (przym.) balsamowy | : (przym.) kojący
balneologist : balneologist : (rzecz.) balneolog
balneology : balneology : (rzecz.) balneologia
baloney : baloney : (rzecz.) nonsens
balsam : balsam : (rzecz.) balsam
balsamic : balsamic : (przym.) balsamiczny
baluster : baluster : (rzecz.) balas | : (rzecz.) tralka
balustrade : balustrade : (rzecz.) balustrada | : (rzecz.) poręcz
bam : bam : (rzecz.) stodoła
bamboo : bamboo : (rzecz.) bambus
bamboozle : bamboozle : (czas.) wykiwać
ban : ban : (czas.) bluźnić | : (czas.) przeklinać | : (czas.) wyklinać | : (czas.) zablokować | : (czas.) zabraniać | : (czas.) zabronić | : (czas.) zakazać | : (czas.) zakazywać | : (rzecz.) banicja | : (rzecz.) interdykt | : (rzecz.) klątwa | : (rzecz.) obwódka | : (rzecz.) zakaz
banal : banal : (przym.) banalny
banality : banality : (rzecz.) banał | : (rzecz.) banalność
banally : banally : (przysł.) banalnie
banana : banana : (rzecz.) banan
band : band : (rzecz.) banda | : (rzecz.) gąsienica | : (rzecz.) grupa | : (rzecz.) kapela | : (rzecz.) obwódka | : (rzecz.) opaska | : (rzecz.) orkiestra | : (rzecz.) pasek | : (rzecz.) pasmo | : (rzecz.) szajka | : (rzecz.) szlaczek | : (rzecz.) taśma | : (rzecz.) wstążka | : (rzecz.) wstęga | : (rzecz.) zespół | : (rzecz.) zgraja
bandage : bandage : (czas.) bandażować | : (czas.) zabandażować | : (rzecz.) bandaż | : (rzecz.) opatrunek
bandaging : bandaging : (rzecz.) bandażowanie
bandbox : bandbox : (rzecz.) pudło
banderol : banderol : (rzecz.) banderola
banding : banding : (rzecz.) bandażowanie | : (rzecz.) wiązanie
bandit : bandit : (rzecz.) bandyta | : (rzecz.) bandzior | : (rzecz.) rozbójnik | : (rzecz.) zbójca
bandit's : bandit's : (przym.) rozbójniczy
banditry : banditry : (rzecz.) bandytyzm
bandleader : bandleader : (rzecz.) kapelmistrz
bandmaster : bandmaster : (rzecz.) dyrygent | : (rzecz.) kapelmistrz
bandoleer : bandoleer : (rzecz.) bandolier
bandsman : bandsman : (rzecz.) muzyk | : (rzecz.) muzykant
bandstand : bandstand : (rzecz.) estrada | : (rzecz.) rozpiętość | : (rzecz.) szerokość
bandwidth : bandwidth : (rzecz.) pasmo | : (rzecz.) przepustowość
bandy : bandy : (czas.) huśtać | : (czas.) obrzucać | : (czas.) odbijać | : (czas.) odrzucać | : (czas.) podrzucać | : (czas.) przerzucać | : (przym.) krzywy | : (przym.) pałąkowaty
bandy-legged : bandy-legged : (przym.) krzywonogi | : (przym.) pałąkowaty
bane : bane : (rzecz.) jad | : (rzecz.) nieszczęście | : (rzecz.) trucizna | : (rzecz.) zguba | : (rzecz.) zmora
baneful : baneful : (przym.) beznadziejny | : (przym.) fatalny
bang : bang : (czas.) trzaskać | : (czas.) trzasnąć | : (czas.) uderzać | : (czas.) walić | : (czas.) wrąbać | : (rzecz.) grzywka | : (rzecz.) huk | : (rzecz.) trzask | : (rzecz.) uderzenie
bangle : bangle : (rzecz.) bransoleta | : (rzecz.) bransoletka
banish : banish : (czas.) pozbyć | : (czas.) wydalać | : (czas.) wydalić | : (czas.) wygnać | : (czas.) wypędzać | : (czas.) wypędzić
banishment : banishment : (rzecz.) banicja | : (rzecz.) wygnanie
banister : banister : (rzecz.) balas | : (rzecz.) balustrada | : (rzecz.) poręcz | : (rzecz.) tralka
banjo : banjo : (rzecz.) bandżo | : (rzecz.) banjo
bank : bank : (czas.) gromadzić | : (czas.) obwałować | : (czas.) przechylać | : (czas.) przechylić | : (czas.) składać | : (rzecz.) bank | : (rzecz.) brzeg | : (rzecz.) ławica | : (rzecz.) nachylenie | : (rzecz.) nasyp | : (rzecz.) pula | : (rzecz.) skarpa | : (rzecz.) wał | : (rzecz.) zaspa
bank-note : bank-note : (rzecz.) banknot
banker : banker : (rzecz.) bankier | : (rzecz.) bankowiec
banker's : banker's : (przym.) bankierski
banking : banking : (rzecz.) bankierstwo | : (rzecz.) bankowość
banknote : banknote : (rzecz.) banknot
bankroll : bankroll : (czas.) finansować | : (rzecz.) forsa
bankrupt : bankrupt : (czas.) bankrutować | : (rzecz.) bankructwo | : (rzecz.) bankrut
bankruptcy : bankruptcy : (rzecz.) bankructwo | : (rzecz.) plajta | : (rzecz.) upad | : (rzecz.) upadłość
bankrupting : bankrupting : (rzecz.) bankrutowanie
bankrupts : bankrupts : (rzecz.) bankrutowanie
banks : banks : (rzecz.) bank
banner : banner : (rzecz.) bandera | : (rzecz.) chorągiew | : (rzecz.) proporzec | : (rzecz.) sztandar | : (rzecz.) transparent
banning : banning : (rzecz.) zakaz | : (rzecz.) zakazywanie
bannock : bannock : (rzecz.) podpłomyk
banquet : banquet : (czas.) bankietować | : (czas.) ucztować | : (rzecz.) bankiet | : (rzecz.) biesiada | : (rzecz.) uczta
banqueter : banqueter : (rzecz.) biesiadnik
banshee : banshee : (rzecz.) kostucha
banter : banter : (czas.) drażnić | : (czas.) droczyć | : (czas.) gawędzić | : (czas.) kpinkować | : (czas.) naciągać | : (czas.) przekomarzać | : (rzecz.) naciąganie | : (rzecz.) przekomarzanie | : (rzecz.) żart
bantling : bantling : (rzecz.) bachor | : (rzecz.) brzdąc
baobab : baobab : (rzecz.) baobab
baptise : baptise : (czas.) chrzcić
baptism : baptism : (rzecz.) chrzest | : (rzecz.) ochrzczenie
baptismal : baptismal : (przym.) chrzcielny | : (przym.) chrzestny
baptize : baptize : (czas.) chrzcić | : (czas.) ochrzcić
baptizing : baptizing : (rzecz.) chrzczenie
bar : bar : (czas.) tarasować | : (czas.) zagradzać | : (czas.) zakazywać | : (rzecz.) bar | : (rzecz.) bariera | : (rzecz.) bramka | : (rzecz.) kostka | : (rzecz.) krata | : (rzecz.) palestra | : (rzecz.) pasek | : (rzecz.) pręt | : (rzecz.) rogatka | : (rzecz.) rygiel | : (rzecz.) sztaba | : (rzecz.) sztabka | : (rzecz.) sztanga | : (rzecz.) tabliczka | : (rzecz.) takt | : (rzecz.) zakaz | : (rzecz.) zapora
bar-room : bar-room : (rzecz.) bufet
barb : barb : (rzecz.) broda | : (rzecz.) haczyk | : (rzecz.) kolec | : (rzecz.) łuska | : (rzecz.) wąs | : (rzecz.) zadzior
barbarian : barbarian : (rzecz.) barbarzyńca | : (rzecz.) dzicz | : (rzecz.) dzikus
barbarians : barbarians : (rzecz.) dzicz
barbaric : barbaric : (przym.) barbarzyński
barbarically : barbarically : (przysł.) barbarzyńsko
barbarism : barbarism : (rzecz.) barbaryzm | : (rzecz.) barbarzyństwo
barbarity : barbarity : (rzecz.) barbarzyństwo
barbarous : barbarous : (przym.) barbarzyński
barbate : barbate : (przym.) ciernisty | : (przym.) kłaczasty
barbecue : barbecue : (rzecz.) grill | : (rzecz.) grillowanie | : (rzecz.) rożen | : (rzecz.) ruszt
barbecues : barbecues : (rzecz.) grillowanie
barbed : barbed : (przym.) haczykowaty | : (przym.) kolczasty
barbell : barbell : (rzecz.) sztanga
barber : barber : (rzecz.) balwierz | : (rzecz.) cyrulik | : (rzecz.) fryzjer | : (rzecz.) golarz | : (rzecz.) golibroda
barberries : barberries : (rzecz.) berberys
barberry : barberry : (rzecz.) berberys | : (rzecz.) kwaśnica
barbet : barbet : (rzecz.) brodacz | : (rzecz.) pudel
barbican : barbican : (rzecz.) barbakan
barbital : barbital : (rzecz.) kwas
barbiturate : barbiturate : (rzecz.) barbituran
barcarole : barcarole : (rzecz.) barkarola
barcarolle : barcarolle : (rzecz.) barkarola
bard : bard : (rzecz.) pieśniarz | : (rzecz.) słonina | : (rzecz.) wieszcz
bare : bare : (czas.) obnażać | : (czas.) odkrywać | : (czas.) odsłaniać | : (czas.) wyszczerzać | : (przym.) absolutny | : (przym.) bosy | : (przym.) czysty | : (przym.) goły | : (przym.) jasny | : (przym.) jedyny | : (przym.) nagi | : (przym.) nieosłonięty | : (przym.) obnażony | : (przym.) pusty | : (przym.) zwykły
bare-bone : bare-bone : (przym.) schematyczny | : (przym.) szkieletowy
barefaced : barefaced : (przym.) bezczelny | : (przym.) bezwstydny
barefacedly : barefacedly : (przysł.) bezczelnie | : (przysł.) śmiało
barefoot : barefoot : (przym.) bosonogi | : (przym.) bosy | : (przysł.) boso
barefooted : barefooted : (przym.) bosonogi | : (przym.) bosy
barely : barely : (przysł.) jedynie | : (przysł.) ledwie | : (przysł.) ledwo | : (przysł.) tylko | : (przysł.) zaledwie
bareness : bareness : (rzecz.) nagość | : (rzecz.) ogołocenie | : (rzecz.) pustka | : (rzecz.) ubóstwo
barf : barf : (czas.) wymiotować
bargain : bargain : (czas.) targować | : (czas.) umawiać | : (rzecz.) interes | : (rzecz.) kupno | : (rzecz.) okazja | : (rzecz.) sposobność | : (rzecz.) transakcja | : (rzecz.) umowa
bargaining : bargaining : (rzecz.) negocjacja | : (rzecz.) umowa
barge : barge : (rzecz.) barka | : (rzecz.) berlinka | : (rzecz.) galar | : (rzecz.) szkuta
baric : baric : (przym.) baryczny
baring : baring : (rzecz.) casting
barite : barite : (rzecz.) baryt
baritone : baritone : (rzecz.) baryton
barium : barium : (rzecz.) bar
bark : bark : (czas.) impregnować | : (czas.) korować | : (czas.) szczekać | : (rzecz.) bark | : (rzecz.) kora | : (rzecz.) szczekanie | : (rzecz.) żagle
barker : barker : (rzecz.) korowarka | : (rzecz.) naganiacz | : (rzecz.) szczekacz
barley : barley : (rzecz.) jęczmień
barmaid : barmaid : (rzecz.) bufetowa
barman : barman : (rzecz.) barman
barn : barn : (rzecz.) kurnik | : (rzecz.) obora | : (rzecz.) stodoła
barnacle : barnacle : (rzecz.) natręt | : (rzecz.) pąkla | : (rzecz.) skorupiak | : (rzecz.) szczypce
barnstorm : barnstorm : (czas.) objeżdżać
barnyard : barnyard : (rzecz.) podwórze
barograph : barograph : (rzecz.) barograf
barometer : barometer : (rzecz.) barometr
barometric : barometric : (przym.) barometryczny
barometrical : barometrical : (przym.) barometryczny
baron : baron : (rzecz.) magnat
baronage : baronage : (rzecz.) baronostwo | : (rzecz.) herbarz | : (rzecz.) magnateria
baronial : baronial : (przym.) baronowski | : (przym.) hrabiowski | : (przym.) magnacki
barony : barony : (rzecz.) baronia | : (rzecz.) baronostwo
baroque : baroque : (przym.) barokowy | : (rzecz.) barok
barque : barque : (rzecz.) barka
barrack : barrack : (rzecz.) barak | : (rzecz.) koszary
barracking : barracking : (rzecz.) koszarowanie
barracks : barracks : (rzecz.) koszara | : (rzecz.) koszarowanie | : (rzecz.) koszary
barrage : barrage : (rzecz.) grobla | : (rzecz.) zapora
barratry : barratry : (rzecz.) barateria
barrel : barrel : (czas.) beczkować | : (rzecz.) baniak | : (rzecz.) baryła | : (rzecz.) baryłka | : (rzecz.) bębenek | : (rzecz.) beczka | : (rzecz.) beczułka | : (rzecz.) lufa | : (rzecz.) rura
barrel-organ : barrel-organ : (rzecz.) katarynka
barrel-shaped : barrel-shaped : (przym.) baryłkowaty | : (przym.) beczkowaty
barren : barren : (przym.) bezlistny | : (przym.) bezużyteczny | : (przym.) jałowy | : (przym.) niepłodny | : (przym.) nieurodzajny | : (przym.) suchy
barrenness : barrenness : (rzecz.) jałowość
barrette : barrette : (rzecz.) garda | : (rzecz.) wsuwka
barricade : barricade : (czas.) barykadować | : (czas.) zabarykadować | : (rzecz.) barykada
barrier : barrier : (rzecz.) bariera | : (rzecz.) bramka | : (rzecz.) przegroda | : (rzecz.) przegródka | : (rzecz.) przeszkoda | : (rzecz.) rogatka | : (rzecz.) szlaban | : (rzecz.) zagrodzenie | : (rzecz.) zapora
barrister : barrister : (rzecz.) adwokat | : (rzecz.) obrońca | : (rzecz.) orędownik
barroom : barroom : (rzecz.) bufet
barrow : barrow : (rzecz.) kopiec | : (rzecz.) kurhan | : (rzecz.) nosiłki | : (rzecz.) taczka | : (rzecz.) taczki | : (rzecz.) wózek
bars : bars : (rzecz.) bary | : (rzecz.) krata | : (rzecz.) kraty
bartender : bartender : (rzecz.) barman
barter : barter : (czas.) frymarczyć | : (czas.) wymieniać | : (rzecz.) nachylenie | : (rzecz.) pochylenie | : (rzecz.) skarpa | : (rzecz.) wymiana
bartizan : bartizan : (rzecz.) parapet
baryon : baryon : (rzecz.) barion
bas : bas : (przym.) basowy
bas-relief : bas-relief : (rzecz.) płaskorzeźba
basal : basal : (przym.) nasadowy | : (przym.) podstawowy | : (przym.) typowy
basalt : basalt : (rzecz.) bazalt
basaltic : basaltic : (przym.) bazaltowy
base : base : (czas.) bazować | : (czas.) gruntować | : (czas.) opierać | : (czas.) oprzeć | : (czas.) ugruntować | : (czas.) zasadzać | : (czas.) zasądzać | : (przym.) bazowy | : (przym.) fałszywy | : (przym.) niegodziwy | : (przym.) nieszlachetny | : (przym.) nikczemny | : (przym.) niski | : (przym.) podkładowy | : (przym.) podły | : (rzecz.) baza | : (rzecz.) nasada | : (rzecz.) oparcie | : (rzecz.) podkład | : (rzecz.) podłoże | : (rzecz.) podnóże | : (rzecz.) podstawa | : (rzecz.) podstawka | : (rzecz.) rozstaw | : (rzecz.) zasada
base-forming : base-forming : (przym.) zasadotwórczy
baseball : baseball : (rzecz.) baseball | : (rzecz.) palant
baseless : baseless : (przym.) bezpodstawny | : (przym.) bezprzyczynowy | : (przym.) bezzasadny
basely : basely : (przysł.) niegodziwie | : (przysł.) nieuczciwie | : (przysł.) podle
baseman : baseman : (przym.) bazowy
basement : basement : (rzecz.) piwnica | : (rzecz.) podziemie | : (rzecz.) przyziemie | : (rzecz.) suterena
baseness : baseness : (rzecz.) podłość
bash : bash : (czas.) przeżegnać | : (czas.) uderzyć | : (czas.) walić
bashful : bashful : (przym.) bojaźliwy | : (przym.) lękliwy | : (przym.) nieśmiały | : (przym.) wstydliwy
bashfully : bashfully : (przysł.) wstydliwie
bashfulness : bashfulness : (rzecz.) lękliwość | : (rzecz.) nieśmiałość | : (rzecz.) wstydliwość
basic : basic : (przym.) elitarny | : (przym.) fundamentalny | : (przym.) podstawowy | : (przym.) prymitywny | : (przym.) zasadniczy | : (przym.) zasadowy | : (rzecz.) podstawa
basically : basically : (przysł.) zasadniczo
basil : basil : (rzecz.) bazylia
basilar : basilar : (przym.) podstawowy
basilica : basilica : (rzecz.) bazylika
basilisk : basilisk : (rzecz.) bazyliszek
basin : basin : (rzecz.) balia | : (rzecz.) basen | : (rzecz.) baza | : (rzecz.) czara | : (rzecz.) dorzecze | : (rzecz.) miednica | : (rzecz.) podłoże | : (rzecz.) podstawa | : (rzecz.) porzecze | : (rzecz.) rezerwuar | : (rzecz.) szala | : (rzecz.) umywalka | : (rzecz.) umywalnia | : (rzecz.) zagłębie
basis : basis : (rzecz.) baza | : (rzecz.) podstawa | : (rzecz.) zasada
bask : bask : (czas.) grzać | : (czas.) wygrzać | : (czas.) wygrzewać
basket : basket : (rzecz.) kosz | : (rzecz.) koszyk | : (rzecz.) koszykówka
basket-ball : basket-ball : (rzecz.) koszykówka
basket-work : basket-work : (przym.) koszykowy
basketball : basketball : (rzecz.) koszykarz | : (rzecz.) koszykówka
basketry : basketry : (rzecz.) koszykarstwo
basketwork : basketwork : (rzecz.) koszykarstwo | : (rzecz.) plecionka
basophilic : basophilic : (przym.) zasadochłonny
bass : bass : (przym.) basowy | : (rzecz.) bas | : (rzecz.) basetla | : (rzecz.) basista | : (rzecz.) kontrabas | : (rzecz.) okoń
bass-relief : bass-relief : (rzecz.) płaskorzeźba
bass-viol : bass-viol : (rzecz.) kontrabas | : (rzecz.) wiolonczela
basset : basset : (rzecz.) jamnik | : (rzecz.) odsłonięcie
bassinet : bassinet : (rzecz.) kołyska
basso : basso : (przym.) basowy
bassoon : bassoon : (rzecz.) fagot
bassoonist : bassoonist : (rzecz.) fagocista
bastard : bastard : (rzecz.) bękart | : (rzecz.) cham | : (rzecz.) drań | : (rzecz.) mieszaniec | : (rzecz.) psubrat
baste : baste : (czas.) fastrygować | : (czas.) przyfastrygować
bastinado : bastinado : (rzecz.) bastonada
basting : basting : (rzecz.) fastryga | : (rzecz.) fastrygowanie | : (rzecz.) wygrzmocenie
bastion : bastion : (rzecz.) bastion
bat : bat : (rzecz.) gacek | : (rzecz.) kij | : (rzecz.) nietoperz | : (rzecz.) palant | : (rzecz.) rakieta | : (rzecz.) rakietka
batch : batch : (rzecz.) grupa | : (rzecz.) namiar | : (rzecz.) paczka | : (rzecz.) partia | : (rzecz.) plik | : (rzecz.) porcja | : (rzecz.) seria | : (rzecz.) wsad | : (rzecz.) wypiek
batch-free : batch-free : (przym.) stopiony
batcher : batcher : (rzecz.) dawkownik | : (rzecz.) dozator | : (rzecz.) dozownik
batching : batching : (rzecz.) dozowanie | : (rzecz.) porcjowanie
bate : bate : (czas.) spadać | : (czas.) wytrawiać
bath : bath : (czas.) kapać | : (czas.) kąpać | : (czas.) wykąpać | : (rzecz.) kąpiel | : (rzecz.) łaźnia | : (rzecz.) wanna
bath-tub : bath-tub : (rzecz.) wanienka | : (rzecz.) wanna
bathe : bathe : (czas.) kapać | : (czas.) kąpać | : (czas.) pływać | : (czas.) przemywać | : (czas.) wykąpać | : (rzecz.) kąpiel
bather : bather : (rzecz.) kuracjusz
bathing : bathing : (rzecz.) kąpiel
bathrobe : bathrobe : (rzecz.) szlafrok
bathroom : bathroom : (rzecz.) łazienka | : (rzecz.) sanitariat | : (rzecz.) toaleta
bathrooms : bathrooms : (rzecz.) ubikacja
baths : baths : (rzecz.) kąpielisko
bathtub : bathtub : (rzecz.) wanienka | : (rzecz.) wanna
bathymetry : bathymetry : (rzecz.) batymetria
bathyscaph : bathyscaph : (rzecz.) batyskaf
bathyscaphe : bathyscaphe : (rzecz.) batyskaf
bathysphere : bathysphere : (rzecz.) batysfera
batik : batik : (rzecz.) batik
batiste : batiste : (rzecz.) batyst
batman : batman : (rzecz.) ordynans
baton : baton : (rzecz.) batuta | : (rzecz.) buława | : (rzecz.) pałeczka | : (rzecz.) pałka
batsman : batsman : (rzecz.) pałkarz
battalion : battalion : (rzecz.) batalion
batten : batten : (rzecz.) listwa
batter : batter : (czas.) gruchotać | : (czas.) łomotać | : (czas.) rozbijać | : (czas.) tłuc | : (czas.) walić | : (czas.) wybijać | : (czas.) wywalać | : (czas.) zdemolować | : (rzecz.) nachylenie | : (rzecz.) pałkarz | : (rzecz.) pochylenie | : (rzecz.) skarpa | : (rzecz.) zbijanie
battery : battery : (rzecz.) akumulator | : (rzecz.) bateria | : (rzecz.) bateryjka | : (rzecz.) pobicie | : (rzecz.) tuczarnia
battle : battle : (czas.) bić | : (czas.) walczyć | : (rzecz.) batalia | : (rzecz.) bitwa | : (rzecz.) bój | : (rzecz.) walka
battle-cruiser : battle-cruiser : (rzecz.) krążownik
battle-painter : battle-painter : (rzecz.) batalista
battledore : battledore : (rzecz.) kijanka | : (rzecz.) łopata
battledress : battledress : (rzecz.) mundur
battlefield : battlefield : (rzecz.) pobojowisko
battlement : battlement : (rzecz.) blanka
battleship : battleship : (rzecz.) okręt | : (rzecz.) pancernik
battue : battue : (rzecz.) nagonka
bauble : bauble : (rzecz.) ozdóbka | : (rzecz.) świecidełko
baud : baud : (rzecz.) bod
baulk : baulk : (rzecz.) zawada
bauxite : bauxite : (rzecz.) boksyt
bawd : bawd : (rzecz.) rajfurka | : (rzecz.) stręczyciel
bawdiness : bawdiness : (rzecz.) sprośność
bawdy : bawdy : (przym.) pikantny | : (przym.) rubaszny | : (przym.) sprośny
bawl : bawl : (czas.) napyskować | : (czas.) wrzeszczeć | : (czas.) wykrzykiwać | : (czas.) wywrzaskiwać | : (rzecz.) wrzask
bawler : bawler : (rzecz.) pyskacz
bay : bay : (czas.) przepaść | : (czas.) szczekać | : (czas.) ujadać | : (przym.) gniady | : (rzecz.) gniadosz | : (rzecz.) przęsło | : (rzecz.) stanowisko | : (rzecz.) szczekanie | : (rzecz.) ujadanie | : (rzecz.) wnęka | : (rzecz.) wysepka | : (rzecz.) zalew | : (rzecz.) zatoczka | : (rzecz.) zatoka | : (rzecz.) zatrzymanie
bayonet : bayonet : (rzecz.) bagnet
bayou : bayou : (rzecz.) zalewisko
bazaar : bazaar : (rzecz.) bazar | : (rzecz.) jarmark | : (rzecz.) kiermasz
bazooka : bazooka : (rzecz.) pancerzownica
be : be : (czas.) być | : (czas.) czuć | : (czas.) istnieć | : (czas.) mieć | : (czas.) miewać | : (czas.) należeć | : (czas.) nastąpić | : (czas.) następować | : (czas.) przysługiwać | : (czas.) wynosić | : (czas.) zaistnieć | : (czas.) zostać | : (czas.) żyć
beach : beach : (rzecz.) plaża
beach-suit : beach-suit : (rzecz.) opalacz | : (rzecz.) plażówka
beachhead : beachhead : (rzecz.) przyczółek
beaching : beaching : (rzecz.) plaża | : (rzecz.) wyrzucanie
beacon : beacon : (rzecz.) boja | : (rzecz.) latarnia | : (rzecz.) pława | : (rzecz.) stawa | : (rzecz.) sygnał
beaconing : beaconing : (rzecz.) świecenie
bead : bead : (rzecz.) koralik | : (rzecz.) kropla | : (rzecz.) kulka | : (rzecz.) łza | : (rzecz.) paciorek | : (rzecz.) różaniec
beadledom : beadledom : (rzecz.) ważniactwo
beads : beads : (rzecz.) sieczka
beagle : beagle : (czas.) polować | : (rzecz.) szpicel | : (rzecz.) szpieg
beak : beak : (rzecz.) belfer | : (rzecz.) dziób | : (rzecz.) dziobek | : (rzecz.) dzióbek | : (rzecz.) łzawnik | : (rzecz.) szyjka
beaker : beaker : (rzecz.) kubek | : (rzecz.) puchar | : (rzecz.) zlewka
beakers : beakers : (rzecz.) zlewek
beam : beam : (czas.) promienieć | : (czas.) promieniować | : (czas.) rozpromieniać | : (czas.) świecić | : (czas.) uśmiechać | : (rzecz.) bela | : (rzecz.) belka | : (rzecz.) dyszel | : (rzecz.) dźwigar | : (rzecz.) legar | : (rzecz.) promień | : (rzecz.) równoważnia | : (rzecz.) snop | : (rzecz.) trawers | : (rzecz.) wiązka
beaming : beaming : (przym.) jasny | : (przym.) promienny
beamy : beamy : (przym.) masywny
bean : bean : (rzecz.) fasola | : (rzecz.) fasolka | : (rzecz.) makówka | : (rzecz.) ziarnko | : (rzecz.) ziarno
beanery : beanery : (rzecz.) jadłodajnia
beanpole : beanpole : (rzecz.) tyka
beans : beans : (rzecz.) fasola
bear : bear : (czas.) cierpieć | : (czas.) dźwigać | : (czas.) nieść | : (czas.) nosić | : (czas.) obarczać | : (czas.) podpierać | : (czas.) podtrzymywać | : (czas.) ponieść | : (czas.) ponosić | : (czas.) rodzić | : (czas.) unosić | : (czas.) wytrzymać | : (czas.) znosić | : (rzecz.) miś | : (rzecz.) narost | : (rzecz.) niedźwiedź | : (rzecz.) niedźwiedzica | : (rzecz.) skrzep
bear's-foot : bear's-foot : (rzecz.) ciemiernik
bearable : bearable : (przym.) znośny
bearbaiting : bearbaiting : (rzecz.) szczucie
beard : beard : (czas.) wyzwać | : (rzecz.) broda | : (rzecz.) bródka | : (rzecz.) zarost
bearded : bearded : (przym.) brodaty
bearer : bearer : (rzecz.) nosiciel | : (rzecz.) okaziciel | : (rzecz.) posiadacz | : (rzecz.) przedstawiciel | : (rzecz.) wspornik
bearing : bearing : (rzecz.) cierpienie | : (rzecz.) kierunek | : (rzecz.) łożysko | : (rzecz.) namiar | : (rzecz.) nawis | : (rzecz.) niedźwiedź | : (rzecz.) panew | : (rzecz.) peleng | : (rzecz.) ponoszenie | : (rzecz.) postawa | : (rzecz.) postępowanie | : (rzecz.) stosunek | : (rzecz.) wytrzymałość | : (rzecz.) zachowanie | : (rzecz.) znoszenie
bearish : bearish : (przym.) niedźwiedzi | : (przym.) zniżkowy
beast : beast : (rzecz.) bestia | : (rzecz.) bydlak | : (rzecz.) bydle | : (rzecz.) potwór | : (rzecz.) zwierz
beastliness : beastliness : (rzecz.) zezwierzęcenie | : (rzecz.) zwierzęcość
beastly : beastly : (przym.) brutalny | : (przym.) ohydny | : (przym.) wstrętny | : (przym.) zwierzęcy | : (przysł.) okropnie
beat : beat : (czas.) bić | : (czas.) lać | : (czas.) lawirować | : (czas.) naganiać | : (czas.) pobić | : (czas.) pokonać | : (czas.) pokonywać | : (czas.) ubijać | : (czas.) uderzać | : (czas.) walić | : (czas.) wygrać | : (rzecz.) bicie | : (rzecz.) dudnienie | : (rzecz.) pokonanie | : (rzecz.) rytm | : (rzecz.) takt | : (rzecz.) uderzenie
beater : beater : (rzecz.) bijak | : (rzecz.) kijanka | : (rzecz.) naganiacz | : (rzecz.) tłuczek | : (rzecz.) trzepak | : (rzecz.) ubijak
beatification : beatification : (rzecz.) beatyfikacja
beatify : beatify : (czas.) beatyfikować
beating : beating : (rzecz.) bicie | : (rzecz.) grzmocenie | : (rzecz.) lanie | : (rzecz.) obijanie | : (rzecz.) pobicie | : (rzecz.) pobijanie | : (rzecz.) porażka | : (rzecz.) pot | : (rzecz.) rozpłaszczanie | : (rzecz.) trzepanie | : (rzecz.) ubijanie | : (rzecz.) wytrzepanie | : (rzecz.) zbicie
beating-in : beating-in : (rzecz.) zdudnianie
beatitude : beatitude : (rzecz.) błogosławieństwo | : (rzecz.) szczęśliwość
beatnik : beatnik : (rzecz.) bitnik
beau : beau : (rzecz.) amant
beauteous : beauteous : (przym.) piękny
beautician : beautician : (rzecz.) kosmetyczka
beautiful : beautiful : (przym.) cudny | : (przym.) krasny | : (przym.) ładny | : (przym.) malowniczy | : (przym.) piękny | : (przym.) przepiękny | : (przym.) śliczny
beautifully : beautifully : (przysł.) pięknie
beautify : beautify : (czas.) upiększać | : (czas.) upiększyć
beauty : beauty : (rzecz.) cudo | : (rzecz.) krasa | : (rzecz.) piękno | : (rzecz.) piękność | : (rzecz.) uroda | : (rzecz.) urok
beaver : beaver : (rzecz.) bóbr
becalm : becalm : (czas.) osłaniać | : (czas.) osłonić | : (czas.) uspokajać
became : became : (czas.) stać | : (czas.) stawać
because : because : (spójnik) albowiem | : (spójnik) bo | : (spójnik) bowiem | : (spójnik) gdyż | : (spójnik) ponieważ
bechance : bechance : (czas.) przydarzać
becharm : becharm : (czas.) oczarować | : (czas.) zaczarować
beck : beck : (rzecz.) kadź | : (rzecz.) skinienie | : (rzecz.) zbiornik
beckon : beckon : (czas.) kiwać | : (czas.) kiwnąć | : (czas.) kusić | : (czas.) przywołać | : (czas.) skinąć | : (czas.) wabić | : (czas.) wykiwać
becloud : becloud : (czas.) zachmurzać
become : become : (czas.) nabierać | : (czas.) ogłuchnąć | : (czas.) robić | : (czas.) stać | : (czas.) stawać | : (czas.) wypadać | : (czas.) zostać | : (czas.) zostawać
becomes : becomes : (rzecz.) nabieranie
becoming : becoming : (przym.) stosowny | : (przym.) twarzowy
bed : bed : (rzecz.) dno | : (rzecz.) dostawka | : (rzecz.) grządka | : (rzecz.) grzęda | : (rzecz.) korpus | : (rzecz.) legowisko | : (rzecz.) łoże | : (rzecz.) łóżko | : (rzecz.) łożysko | : (rzecz.) nocleg | : (rzecz.) podkład | : (rzecz.) posłanie | : (rzecz.) rama | : (rzecz.) spanie | : (rzecz.) stojak | : (rzecz.) warstwa
bed-bug : bed-bug : (rzecz.) pluskwa
bed-clothes : bed-clothes : (rzecz.) obleczenie | : (rzecz.) pościel
bed-linen : bed-linen : (rzecz.) powleczenie
bed-ridden : bed-ridden : (przym.) chory
bed-wetting : bed-wetting : (rzecz.) moczenie
bedaub : bedaub : (czas.) posmarować | : (czas.) zababrać | : (czas.) zabazgrać
bedazzle : bedazzle : (czas.) olśnić | : (czas.) oślepiać
bedbug : bedbug : (rzecz.) pluskwa | : (rzecz.) robak
bedclothes : bedclothes : (rzecz.) pościel | : (rzecz.) przykrycie
bedding : bedding : (rzecz.) pościel | : (rzecz.) posłanie | : (rzecz.) ściółka
bedeck : bedeck : (czas.) przyozdobić | : (czas.) przystroić
bedevil : bedevil : (czas.) dokuczać | : (czas.) nękać | : (czas.) poniewierać | : (czas.) uprzykrzać
bedevilment : bedevilment : (rzecz.) dokuczanie
bedew : bedew : (czas.) zraszać
bedewing : bedewing : (rzecz.) zroszenie
bedight : bedight : (czas.) przybrać | : (czas.) przystroić
bedim : bedim : (czas.) przyciemniać | : (czas.) przyciemnić | : (czas.) zamglić
bedizen : bedizen : (czas.) wystrajać | : (czas.) wystroić
bedlam : bedlam : (rzecz.) hałas | : (rzecz.) harmider | : (rzecz.) obłąkanie | : (rzecz.) wrzawa | : (rzecz.) zamieszanie
bedpan : bedpan : (rzecz.) basen | : (rzecz.) naczynie
bedpost : bedpost : (rzecz.) kolumienka
bedraggle : bedraggle : (czas.) zaszargać | : (czas.) zwłóczyć
bedridden : bedridden : (przym.) chory
bedrock : bedrock : (rzecz.) podłoże
bedroom : bedroom : (rzecz.) sypialnia
bedside : bedside : (rzecz.) odleżyna
bedsore : bedsore : (rzecz.) odleżyna
bedspread : bedspread : (rzecz.) kapa | : (rzecz.) narzuta | : (rzecz.) narzutka
bedspring : bedspring : (rzecz.) sprężyna
bedstead : bedstead : (rzecz.) łóżko
bedwetting : bedwetting : (rzecz.) moczenie
bee : bee : (rzecz.) pszczoła
bee-eater : bee-eater : (rzecz.) żołna
bee-keeper : bee-keeper : (rzecz.) pszczelarz
bee-keeping : bee-keeping : (rzecz.) pszczelarstwo
bee-master : bee-master : (rzecz.) pszczelarz
beech : beech : (przym.) bukowy | : (rzecz.) buczyna | : (rzecz.) buk | : (rzecz.) huk
beechnut : beechnut : (rzecz.) bukiew
beef : beef : (rzecz.) pretensja | : (rzecz.) wołowina
beefeater : beefeater : (rzecz.) wartownik
beefsteak : beefsteak : (rzecz.) befsztyk
beefy : beefy : (przym.) muskularny | : (przym.) silny | : (przym.) wołowy
beehive : beehive : (rzecz.) ul
beekeeper : beekeeper : (rzecz.) pszczelarz
beekeeping : beekeeping : (rzecz.) pszczelarstwo
beep : beep : (czas.) brzęczeć | : (czas.) piszczeć | : (czas.) zapiszczeć | : (rzecz.) brzęczyk | : (rzecz.) piszczenie
beeper : beeper : (przym.) bezzałogowy | : (rzecz.) brzęczyk
beeps : beeps : (rzecz.) brzęczenie
beer : beer : (rzecz.) piwko | : (rzecz.) piwo
beer-mug : beer-mug : (rzecz.) kufel
beery : beery : (przym.) piwny
beestings : beestings : (rzecz.) siara
beeswax : beeswax : (rzecz.) wosk
beet : beet : (rzecz.) burak
beetle : beetle : (rzecz.) baba | : (rzecz.) chrabąszcz | : (rzecz.) chrząszcz | : (rzecz.) dobniak | : (rzecz.) kafar | : (rzecz.) stępor | : (rzecz.) ubijacz | : (rzecz.) ubijak | : (rzecz.) żuk
beetroot : beetroot : (rzecz.) burak | : (rzecz.) ćwikła
befall : befall : (czas.) przytrafiać | : (czas.) spotykać | : (czas.) wydarzać | : (czas.) zdarzać | : (czas.) zdarzyć
befallen : befallen : (czas.) napaść | : (czas.) przytrafiać | : (czas.) zdarzyć
befit : befit : (czas.) pasować | : (czas.) wypadać
befool : befool : (czas.) okpić
before : before : (przyim.) przed | : (przyim.) przede | : (przyim.) sprzed | : (przysł.) kiedyś | : (przysł.) naprzeciwko | : (przysł.) przedtem | : (przysł.) przedwczoraj
beforehand : beforehand : (przysł.) najpierw | : (przysł.) naprzód | : (przysł.) przedtem | : (przysł.) uprzednio | : (przysł.) zawczasu
befoul : befoul : (czas.) brudzić | : (czas.) oszukać | : (czas.) oszukiwać | : (czas.) plugawić | : (czas.) skalać
befriend : befriend : (czas.) zaprzyjaźniać | : (czas.) zaprzyjaźnić
befriended : befriended : (przym.) przyjacielski
befuddle : befuddle : (czas.) zaciemniać | : (czas.) zamroczyć
befuddlement : befuddlement : (rzecz.) zamroczenie
beg : beg : (czas.) błagać | : (czas.) dopraszać | : (czas.) prosić | : (czas.) wybłagać | : (czas.) zebrać | : (czas.) żebrać
began : began : (czas.) rozpoczynać | : (czas.) zaczynać
beget : beget : (czas.) płodzić | : (czas.) spowodować | : (czas.) tworzyć
begetting : begetting : (rzecz.) płodzenie | : (rzecz.) spłodzenie
beggar : beggar : (rzecz.) żebrak
beggarly : beggarly : (przym.) dziadowski | : (przym.) nędzny | : (przym.) żebraczy
beggary : beggary : (rzecz.) nędza | : (rzecz.) żebractwo
begin : begin : (czas.) rozpocząć | : (czas.) rozpoczynać | : (czas.) zaczynać | : (czas.) zapoczątkowywać
beginner : beginner : (rzecz.) nowicjusz
beginning : beginning : (rzecz.) początek | : (rzecz.) rozpoczęcie | : (rzecz.) zaczątek | : (rzecz.) zaczynanie
begird : begird : (czas.) opasać | : (czas.) przepasać
begonia : begonia : (rzecz.) begonia
begotten : begotten : (czas.) spowodować
begrime : begrime : (czas.) zabrudzić
begrudge : begrudge : (czas.) skąpić | : (czas.) żałować | : (czas.) zazdrościć
beguile : beguile : (czas.) mamić | : (czas.) oczarowywać | : (czas.) omamiać | : (czas.) omamić | : (czas.) oszukiwać | : (czas.) skracać | : (czas.) spędzać | : (czas.) wyłudzać
beguilement : beguilement : (rzecz.) czarowanie | : (rzecz.) oszukanie
beguiler : beguiler : (rzecz.) oszust
beguiling : beguiling : (przym.) złudny
begun : begun : (czas.) rozpoczynać | : (czas.) zaczynać
behalf : behalf : (rzecz.) korzyść | : (rzecz.) sprawa
behave : behave : (czas.) postępować | : (czas.) prowadzić | : (czas.) zachowywać
behaviour : behaviour : (rzecz.) postępowanie | : (rzecz.) prowadzenie | : (rzecz.) zachowanie
behavioural : behavioural : (przym.) behawioralny
behaviourism : behaviourism : (rzecz.) behawioryzm
behaviourist : behaviourist : (rzecz.) behawiorysta
beheading : beheading : (rzecz.) ścięcie
beheld : beheld : (czas.) ujrzeć
behest : behest : (rzecz.) życzenie
behind : behind : (przyim.) za | : (rzecz.) siedzenie | : (rzecz.) tyłek
behold : behold : (czas.) spostrzegać | : (czas.) ujrzeć
beholden : beholden : (przym.) dłużny
beholder : beholder : (rzecz.) obserwator | : (rzecz.) widz
behove : behove : (czas.) wypadać
beige : beige : (przym.) beżowy | : (rzecz.) beż
being : being : (rzecz.) byt | : (rzecz.) istnienie | : (rzecz.) istota | : (rzecz.) stworzenie | : (rzecz.) tkwienie
belabour : belabour : (czas.) wymłócić | : (czas.) zaatakować
belated : belated : (przym.) spóźniony
belay : belay : (czas.) cumować | : (czas.) zacumować
belch : belch : (czas.) buchać | : (czas.) wybuchać | : (czas.) wypluwać | : (czas.) wyrzucać | : (rzecz.) beknięcie | : (rzecz.) rozładowanie | : (rzecz.) wybuch
belching : belching : (rzecz.) odbijanie
beldam : beldam : (rzecz.) babsztyl | : (rzecz.) jędza
beleaguer : beleaguer : (czas.) oblegać
belemnite : belemnite : (rzecz.) belemnit
belfry : belfry : (rzecz.) dzwonnica
belie : belie : (czas.) dementować | : (czas.) przeczyć | : (czas.) zaprzeczać | : (czas.) zdementować
belief : belief : (rzecz.) pogląd | : (rzecz.) przekonanie | : (rzecz.) światopogląd | : (rzecz.) wiara | : (rzecz.) wierzenie | : (rzecz.) zaufanie | : (rzecz.) zdanie
beliefs : beliefs : (rzecz.) przekonania
believable : believable : (przym.) wiarygodny
believe : believe : (czas.) myśleć | : (czas.) przypuszczać | : (czas.) sądzić | : (czas.) uważać | : (czas.) uwierzyć | : (czas.) wierzyć
believer : believer : (rzecz.) wyznawca | : (rzecz.) zwolennik
believing : believing : (czas.) domniemywać | : (czas.) sądzić
belike : belike : (przysł.) zapewne
belittle : belittle : (czas.) bagatelizować | : (czas.) pomniejszać | : (czas.) umniejszać | : (czas.) uwłaczać
belittling : belittling : (rzecz.) bagatelizowanie
bell : bell : (rzecz.) dzwon | : (rzecz.) dzwonek
bell-flower : bell-flower : (rzecz.) dzwonek | : (rzecz.) kampanula
bell-founder : bell-founder : (rzecz.) ludwisarz
bell-foundry : bell-foundry : (rzecz.) ludwisarnia
bell-mouthed : bell-mouthed : (przym.) lejkowaty
bell-ringer : bell-ringer : (rzecz.) dzwonnik
bell-shaped : bell-shaped : (przym.) dzwonowaty | : (przym.) dzwonowy | : (przym.) kloszowy
bell-tinkling : bell-tinkling : (rzecz.) podzwanianie
belladonna : belladonna : (rzecz.) atropina | : (rzecz.) belladona
belle : belle : (rzecz.) piękność
belles : belles : (rzecz.) beletrystyka
belles-letters : belles-letters : (rzecz.) beletrystyka
belles-lettres : belles-lettres : (rzecz.) beletrystyka
belletrist : belletrist : (rzecz.) beletrysta
bellflower : bellflower : (rzecz.) dzwonek | : (rzecz.) kampanula
bellicose : bellicose : (przym.) antypokojowy | : (przym.) bojowy | : (przym.) nieprzyjacielski | : (przym.) wojowniczy
bellicosity : bellicosity : (rzecz.) bojowość | : (rzecz.) wojowniczość
belligerence : belligerence : (rzecz.) agresywność | : (rzecz.) wojowniczość
belligerency : belligerency : (rzecz.) wojna | : (rzecz.) wojowniczość
belligerent : belligerent : (przym.) bojowy | : (przym.) napastliwy | : (przym.) wojowniczy
belligerently : belligerently : (przysł.) wojowniczo
bellman : bellman : (rzecz.) herold
bellow : bellow : (czas.) ryczeć | : (czas.) wyć | : (czas.) wydzierać | : (rzecz.) miech | : (rzecz.) mieszek | : (rzecz.) wydzieranie
bellows : bellows : (rzecz.) dmuchawka | : (rzecz.) miech | : (rzecz.) mieszek
bellwether : bellwether : (rzecz.) baran | : (rzecz.) herszt | : (rzecz.) wodzirej
belly : belly : (rzecz.) bandzior | : (rzecz.) brzuch | : (rzecz.) brzusiec | : (rzecz.) pot | : (rzecz.) wybrzuszenie | : (rzecz.) żarłoczność
bellyaching : bellyaching : (rzecz.) rżnięcie
bellyband : bellyband : (rzecz.) popręg
bellyful : bellyful : (rzecz.) sytość
belong : belong : (czas.) dotyczyć | : (czas.) należeć | : (czas.) odnosić | : (czas.) pochodzić | : (czas.) tyczyć
belonged : belonged : (przym.) należny | : (rzecz.) należenie
belonging : belonging : (rzecz.) dobytek | : (rzecz.) mienie
belongings : belongings : (rzecz.) dobytek | : (rzecz.) mienie | : (rzecz.) rzeczy
beloved : beloved : (przym.) drogi | : (przym.) kochany | : (przym.) luby
below : below : (przyim.) pod
belt : belt : (rzecz.) ładownica | : (rzecz.) opasanie | : (rzecz.) pas | : (rzecz.) pasek | : (rzecz.) strefa | : (rzecz.) taśma
belting : belting : (rzecz.) pas | : (rzecz.) pasy
beltway : beltway : (rzecz.) obwodnica
belying : belying : (rzecz.) dementowanie
bemire : bemire : (czas.) zabłocić
bemoan : bemoan : (czas.) lamentować | : (czas.) opłakiwać
bemuse : bemuse : (czas.) odurzać | : (czas.) ogłupiać | : (czas.) oszałamiać
bemusement : bemusement : (rzecz.) speszenie
bench : bench : (rzecz.) kanapa | : (rzecz.) ława | : (rzecz.) ławka | : (rzecz.) sąd | : (rzecz.) sądownictwo | : (rzecz.) taras | : (rzecz.) warsztat
benched : benched : (przym.) ławkowy
benching : benching : (rzecz.) schodkowanie | : (rzecz.) tarasowanie
benchmark : benchmark : (rzecz.) kryterium | : (rzecz.) miara | : (rzecz.) sprawdzian | : (rzecz.) wzorzec
benchmarking : benchmarking : (rzecz.) komparatystyka
bend : bend : (czas.) giąć | : (czas.) krzywić | : (czas.) pochylać | : (czas.) schylać | : (czas.) skręcać | : (czas.) uginać | : (czas.) wychylać | : (czas.) wygiąć | : (czas.) wyginać | : (czas.) zgarbić | : (czas.) zgiąć | : (czas.) zginać | : (rzecz.) kolano | : (rzecz.) nagięcie | : (rzecz.) pochył | : (rzecz.) skłon | : (rzecz.) skręt | : (rzecz.) wygięcie | : (rzecz.) zakole | : (rzecz.) zakręt | : (rzecz.) zakrzywienie | : (rzecz.) zgięcie
bendable : bendable : (przym.) zginalny
bender : bender : (rzecz.) giętarka | : (rzecz.) zginacz
bendiness : bendiness : (rzecz.) krzywoliniowość
bending : bending : (rzecz.) gięcie | : (rzecz.) skrzywienie | : (rzecz.) uginanie | : (rzecz.) wychylanie | : (rzecz.) wyginanie | : (rzecz.) zagięcie | : (rzecz.) zgięcie | : (rzecz.) zginanie
bends : bends : (rzecz.) wyginanie
beneath : beneath : (przyim.) pod
benediction : benediction : (rzecz.) błogosławieństwo
benefaction : benefaction : (rzecz.) dobrodziejstwo
benefactor : benefactor : (rzecz.) dobroczyńca | : (rzecz.) dobrodziej | : (rzecz.) fundator | : (rzecz.) ofiarodawca
benefactors : benefactors : (rzecz.) dobrodziej
benefice : benefice : (rzecz.) beneficjum | : (rzecz.) dochód | : (rzecz.) probostwo
beneficence : beneficence : (rzecz.) dobroczynność
beneficent : beneficent : (przym.) dobroczynny | : (przym.) wspaniałomyślny
beneficial : beneficial : (przym.) dobroczynny | : (przym.) korzystny | : (przym.) pożyteczny | : (przym.) zbawienny
beneficiary : beneficiary : (rzecz.) beneficjant | : (rzecz.) beneficjent | : (rzecz.) spadkobierca
benefit : benefit : (czas.) korzystać | : (czas.) pomagać | : (czas.) skorzystać | : (rzecz.) benefis | : (rzecz.) dobrodziejstwo | : (rzecz.) korzyść | : (rzecz.) pożytek | : (rzecz.) przywilej | : (rzecz.) świadczenie | : (rzecz.) zasiłek
benefiting : benefiting : (rzecz.) korzystanie
benevolence : benevolence : (rzecz.) dobroczynność | : (rzecz.) życzliwość
benevolent : benevolent : (przym.) dobroczynny | : (przym.) dobrotliwy | : (przym.) łaskawy | : (przym.) życzliwy
benighted : benighted : (przym.) ciemny
benign : benign : (przym.) dobroczynny | : (przym.) dobry | : (przym.) łagodny | : (przym.) niezłośliwy | : (przym.) zbawienny | : (przym.) życzliwy
benignant : benignant : (przym.) dobrotliwy | : (przym.) łagodny | : (przym.) życzliwy
benison : benison : (rzecz.) błogosławieństwo
bent : bent : (przym.) nieuczciwy | : (przym.) przekupny | : (przym.) trefny | : (rzecz.) burzan | : (rzecz.) mietlica | : (rzecz.) napięcie | : (rzecz.) ramownica | : (rzecz.) rygiel | : (rzecz.) sitowie | : (rzecz.) skłonność | : (rzecz.) zacięcie | : (rzecz.) zakręt | : (rzecz.) zgięcie | : (rzecz.) żyłka
bent-grass : bent-grass : (rzecz.) mietlica
benthic : benthic : (przym.) bentoniczny | : (przym.) bentosowy | : (przym.) denny
benumb : benumb : (czas.) drętwieć | : (czas.) obezwładniać | : (czas.) odrętwieć | : (czas.) oszałamiać | : (czas.) oszołomić | : (czas.) porazić | : (czas.) sparaliżować
benzene : benzene : (rzecz.) benzen | : (rzecz.) benzol
benzoate : benzoate : (rzecz.) benzoesan
benzoic : benzoic : (przym.) benzoesowy
benzyl : benzyl : (rzecz.) benzyl
bequeath : bequeath : (czas.) przekazać | : (czas.) przekazywać | : (czas.) testować | : (czas.) zapisać | : (czas.) zapisywać
bequest : bequest : (rzecz.) legat | : (rzecz.) zapis
bereave : bereave : (czas.) osierocić | : (czas.) pozbawiać | : (czas.) pozbawić | : (czas.) zabrać
bereavement : bereavement : (rzecz.) osierocenie | : (rzecz.) żałoba
bereft : bereft : (czas.) osierocić
beret : beret : (rzecz.) beret
berg : berg : (rzecz.) góra
bergamot : bergamot : (rzecz.) bergamota
berkelium : berkelium : (rzecz.) berkel
berry : berry : (rzecz.) jagoda
berth : berth : (rzecz.) koja | : (rzecz.) kuszetka | : (rzecz.) łóżko | : (rzecz.) prycza | : (rzecz.) stanowisko
beryl : beryl : (rzecz.) beryl
beryllium : beryllium : (rzecz.) beryl
beseech : beseech : (czas.) błagać | : (czas.) poprosić | : (czas.) prosić
beseem : beseem : (czas.) wypadać
beseeming : beseeming : (przym.) stosowny
beset : beset : (czas.) dręczyć | : (czas.) oblegać | : (czas.) okrążyć | : (czas.) otaczać | : (czas.) otoczyć | : (czas.) zagradzać
besetment : besetment : (rzecz.) oblężenie | : (rzecz.) obsesja
beside : beside : (przyim.) oprócz | : (przyim.) przy
besides : besides : (przyim.) oprócz | : (przyim.) prócz | : (przyim.) przy | : (przysł.) nadto | : (przysł.) zresztą
besiege : besiege : (czas.) nagabywać | : (czas.) napastować | : (czas.) oblegać | : (czas.) otaczać
besieging : besieging : (rzecz.) obleganie
besmear : besmear : (czas.) posmarować | : (czas.) powalać | : (czas.) zababrać | : (czas.) zabrudzić
besmirch : besmirch : (czas.) oczerniać | : (czas.) zabrudzać
besom : besom : (rzecz.) miotła
bespatter : bespatter : (czas.) obsypywać | : (czas.) opryskać
bespeak : bespeak : (czas.) świadczyć | : (czas.) zamawiać | : (czas.) zamówić
besprinkle : besprinkle : (czas.) pokropić | : (czas.) posypywać | : (czas.) rozsypać | : (czas.) skrapiać
best : best : (przym.) najlepszy | : (przysł.) optymalnie
bestead : bestead : (czas.) pomagać
bestial : bestial : (przym.) bestialski | : (przym.) zwierzęcy
bestiality : bestiality : (rzecz.) bestializm | : (rzecz.) bestialstwo | : (rzecz.) sodomia
bestiary : bestiary : (rzecz.) bestiariusz
bestir : bestir : (czas.) rozruszać | : (czas.) ruszać
bestirring : bestirring : (rzecz.) rozruszanie
bestow : bestow : (czas.) nadawać | : (czas.) obdarzać | : (czas.) okazywać | : (czas.) przydzielić | : (czas.) przyznawać | : (czas.) użyczyć
bestowal : bestowal : (rzecz.) dar | : (rzecz.) nadanie | : (rzecz.) nadawanie
bestowing : bestowing : (rzecz.) dar | : (rzecz.) nadanie | : (rzecz.) nadawanie
bestowment : bestowment : (rzecz.) dar | : (rzecz.) nadanie
bestride : bestride : (czas.) siąść
bestseller : bestseller : (rzecz.) bestseller | : (rzecz.) szlagier
bet : bet : (czas.) obstawiać | : (czas.) obstawić | : (czas.) postawić | : (czas.) zakładać | : (rzecz.) umowa | : (rzecz.) zakład
beta-active : beta-active : (przym.) beta-promieniotwórczy
beta-radioactive : beta-radioactive : (przym.) beta-promieniotwórczy | : (przym.) beta-radioaktywny
betake : betake : (czas.) udawać
betel : betel : (rzecz.) kant | : (rzecz.) ścięcie | : (rzecz.) ukos
bethel : bethel : (rzecz.) betel
bethink : bethink : (czas.) rozmyślać
betimes : betimes : (przysł.) wcześnie | : (przysł.) zawczasu
betoken : betoken : (czas.) oznaczać | : (czas.) oznajmiać | : (czas.) potwierdzać | : (czas.) potwierdzić
betray : betray : (czas.) oszukać | : (czas.) oszukiwać | : (czas.) ujawniać | : (czas.) zawieść | : (czas.) zawodzić | : (czas.) zdradzać | : (czas.) zwodzić
betrayal : betrayal : (rzecz.) ujawnienie | : (rzecz.) zdrada
betrayer : betrayer : (rzecz.) zdrajca
betraying : betraying : (rzecz.) zdradzenie
betroth : betroth : (czas.) zaręczyć
betrothal : betrothal : (rzecz.) zaręczyny
better : better : (czas.) polepszyć | : (przym.) lepszy | : (rzecz.) dobroć | : (rzecz.) poprawność | : (rzecz.) ulepszanie
bettering : bettering : (rzecz.) poprawianie
betterment : betterment : (rzecz.) polepszenie | : (rzecz.) poprawa
betting : betting : (rzecz.) stawianie | : (rzecz.) zakładanie | : (rzecz.) zakłady
between : between : (przyim.) między | : (przyim.) pomiędzy | : (przysł.) pomiędzy | : (przysł.) pośrodku
bevel : bevel : (przym.) skośny | : (rzecz.) skos | : (rzecz.) stożek | : (rzecz.) ukos
bevelling : bevelling : (rzecz.) fazowanie | : (rzecz.) ukosowanie
beverage : beverage : (rzecz.) napitek | : (rzecz.) napój | : (rzecz.) trunek
bevy : bevy : (rzecz.) gromada | : (rzecz.) grono | : (rzecz.) stado
bewail : bewail : (czas.) baczyć | : (czas.) opłakiwać | : (czas.) starzeć | : (czas.) użalać
bewailing : bewailing : (rzecz.) opłakiwanie
beware : beware : (czas.) wystrzegać
bewilder : bewilder : (czas.) oszałamiać | : (czas.) oszołomić | : (czas.) zadziwiać | : (czas.) zmieszać
bewildered : bewildered : (czas.) połapać
bewilderment : bewilderment : (rzecz.) dezorientacja | : (rzecz.) osłupienie | : (rzecz.) oszołomienie | : (rzecz.) zamęt
bewitch : bewitch : (czas.) czarować | : (czas.) oczarować | : (czas.) oczarowywać | : (czas.) urzekać | : (czas.) zaczarować | : (czas.) zakląć
bewitchment : bewitchment : (rzecz.) czar | : (rzecz.) urzeczenie
beyond : beyond : (przyim.) oprócz | : (przyim.) pomimo | : (przyim.) ponad | : (rzecz.) poza
bezel : bezel : (rzecz.) listwa | : (rzecz.) obejma
bezique : bezique : (rzecz.) bezik
bi-direction : bi-direction : (rzecz.) dwukierunkowość
bias : bias : (rzecz.) inklinacja | : (rzecz.) kierunek | : (rzecz.) odchylenie | : (rzecz.) pochylenie | : (rzecz.) polaryzacja | : (rzecz.) przychylność | : (rzecz.) skłonność | : (rzecz.) spadzistość | : (rzecz.) stronniczość | : (rzecz.) ukos | : (rzecz.) uprzedzenie
bias-temperature : bias-temperature : (rzecz.) polaryzacja-temperatura
biathlon : biathlon : (przym.) biatlonowy | : (rzecz.) biatlon | : (rzecz.) dwubój
bib : bib : (rzecz.) napierśnik | : (rzecz.) podbródek | : (rzecz.) śliniak
bibber : bibber : (rzecz.) pijak
bibbing : bibbing : (rzecz.) chlanie
bibelot : bibelot : (rzecz.) bibelot | : (rzecz.) cacko
bible : bible : (rzecz.) biblia | : (rzecz.) książka
biblical : biblical : (przym.) biblijny
bibliographer : bibliographer : (rzecz.) bibliograf
bibliographic : bibliographic : (przym.) bibliograficzny
bibliographical : bibliographical : (przym.) bibliograficzny
bibliographically : bibliographically : (przysł.) bibliograficznie
bibliography : bibliography : (rzecz.) bibliografia | : (rzecz.) księgoznawstwo
bibliomaniac : bibliomaniac : (rzecz.) biblioman
bibliophile : bibliophile : (rzecz.) bibliofil
bibliophilism : bibliophilism : (rzecz.) bibliofilstwo
bibliophilist : bibliophilist : (rzecz.) bibliofil
bibulous : bibulous : (przym.) chłonny | : (przym.) pijacki
bicarbonate : bicarbonate : (rzecz.) dwuwęglan | : (rzecz.) wodorowęglan
biceps : biceps : (rzecz.) biceps
bicker : bicker : (czas.) czubić | : (czas.) kłócić | : (czas.) sprzeczać | : (czas.) wadzić | : (rzecz.) kłótnia | : (rzecz.) ujadanie
bickering : bickering : (rzecz.) kłótnia
biconcave : biconcave : (przym.) dwuwklęsły
biconvex : biconvex : (przym.) dwuwypukły
bicycle : bicycle : (rzecz.) rower
bicycling : bicycling : (rzecz.) pedałowanie
bicyclist : bicyclist : (rzecz.) kolarz | : (rzecz.) rowerzysta
bid : bid : (czas.) kazać | : (czas.) licytować | : (czas.) oferować | : (czas.) ofiarować | : (czas.) rozkazać | : (czas.) wezwać | : (czas.) zanieść | : (czas.) zaofiarować | : (czas.) zaofiarowywać | : (czas.) życzyć | : (rzecz.) kandydatura | : (rzecz.) licytacja | : (rzecz.) licytowanie | : (rzecz.) odzywka | : (rzecz.) oferta | : (rzecz.) stawka
bidder : bidder : (rzecz.) licytant | : (rzecz.) licytowanie | : (rzecz.) oferent | : (rzecz.) reflektant
bidding : bidding : (rzecz.) licytacja
biddy : biddy : (rzecz.) kurczak
bide : bide : (czas.) zaczekać
bidirectional : bidirectional : (przym.) dwukierunkowy
bier : bier : (rzecz.) karawan | : (rzecz.) katafalk | : (rzecz.) mara
biff : biff : (czas.) walnąć | : (rzecz.) szturchaniec
bifid : bifid : (przym.) dwudzielny | : (przym.) rozpołowiony
bifilar : bifilar : (przym.) bifilarny | : (przym.) dwunitkowy
bifocal : bifocal : (przym.) dwuogniskowy
bifurcate : bifurcate : (czas.) rozdwajać | : (czas.) rozwidlać | : (czas.) rozwidlić
bifurcated : bifurcated : (przym.) widelcowaty
bifurcation : bifurcation : (rzecz.) bifurkacja | : (rzecz.) rozdwojenie | : (rzecz.) rozgałęzienie | : (rzecz.) rozstaj
big : big : (przym.) brzemienny | : (przym.) dorosły | : (przym.) duży | : (przym.) gruby | : (przym.) obszerny | : (przym.) ważny | : (przym.) wielki | : (przym.) wysoki | : (przym.) znaczny
big-eared : big-eared : (przym.) wielkouchy
bigamist : bigamist : (rzecz.) bigamista
bigamous : bigamous : (przym.) bigamiczny
bigamy : bigamy : (rzecz.) bigamia | : (rzecz.) dwużeństwo
biggie : biggie : (rzecz.) drobiazg | : (rzecz.) drobnostka | : (rzecz.) olbrzym | : (rzecz.) szczegół
bighead : bighead : (rzecz.) zarozumialec
bight : bight : (rzecz.) zatoka
bigot : bigot : (rzecz.) dogmatyk | : (rzecz.) świętoszek
bigoted : bigoted : (przym.) bigoteryjny
bigotry : bigotry : (rzecz.) bigoteria | : (rzecz.) dewocja | : (rzecz.) zajadłość
bijou : bijou : (rzecz.) cacko | : (rzecz.) klejnot
bike : bike : (rzecz.) motocykl | : (rzecz.) rower
biker : biker : (rzecz.) motocyklista | : (rzecz.) rowerzysta
bikini : bikini : (rzecz.) bikini
bilateral : bilateral : (przym.) bilateralny | : (przym.) obustronny
bilaterally : bilaterally : (przysł.) dwustronnie | : (przysł.) obustronnie
bilberry : bilberry : (rzecz.) borówka | : (rzecz.) czernica
bile : bile : (rzecz.) gorycz | : (rzecz.) zgorzkniałość | : (rzecz.) zgryźliwość | : (rzecz.) żółć
bilge : bilge : (rzecz.) dno | : (rzecz.) zęza | : (rzecz.) zezowanie
bilinear : bilinear : (przym.) bilinearny | : (przym.) dwuliniowy
bilingual : bilingual : (przym.) dwujęzyczny
bilingualism : bilingualism : (rzecz.) dwujęzyczność
bilious : bilious : (przym.) popędliwy | : (przym.) zgryźliwy | : (przym.) żółciowy
bilk : bilk : (czas.) oszukać | : (czas.) wykiwać | : (czas.) wyłudzać | : (czas.) wyłudzić
bill : bill : (czas.) ogłaszać | : (rzecz.) afisz | : (rzecz.) banknot | : (rzecz.) konosament | : (rzecz.) kwit | : (rzecz.) plakat | : (rzecz.) poświadczenie | : (rzecz.) projekt | : (rzecz.) przekaz | : (rzecz.) rachunek | : (rzecz.) spis | : (rzecz.) ulotka | : (rzecz.) weksel | : (rzecz.) zestawienie
billet : billet : (czas.) kwaterować | : (czas.) zakwaterować | : (rzecz.) kęs | : (rzecz.) kwatera | : (rzecz.) kwaterunek | : (rzecz.) zakwaterowanie
billfold : billfold : (rzecz.) portfel
billiard : billiard : (przym.) bilardowy
billiard-ball : billiard-ball : (rzecz.) bila
billiards : billiards : (rzecz.) bilard
billing : billing : (rzecz.) biling | : (rzecz.) dziób | : (rzecz.) fakturowanie
billion : billion : (rzecz.) bilion | : (rzecz.) miliard
billionaire : billionaire : (rzecz.) miliarder
billon : billon : (rzecz.) stop
billow : billow : (czas.) falować | : (czas.) piętrzyć | : (czas.) pofalować | : (rzecz.) bałwan | : (rzecz.) fala | : (rzecz.) grzywacz
billows : billows : (rzecz.) kipiel
bimanual : bimanual : (przym.) oburęczny
bimetal : bimetal : (rzecz.) bimetal
bimetallic : bimetallic : (przym.) bimetaliczny | : (przym.) bimetalowy | : (przym.) dwumetaliczny
bimetallism : bimetallism : (rzecz.) bimetalizm
bimolecular : bimolecular : (przym.) dwucząsteczkowy
bimonthly : bimonthly : (rzecz.) dwumiesięcznik
bin : bin : (rzecz.) kosz | : (rzecz.) kubeł | : (rzecz.) paka | : (rzecz.) pojemnik | : (rzecz.) skrytka | : (rzecz.) skrzynia
binary : binary : (przym.) binarny | : (przym.) dwójkowy
binary-decimal : binary-decimal : (przym.) dwójkowo-dziesiętny
binary-to-decimal : binary-to-decimal : (przym.) dwójkowo-dziesiętny
binary-to-hexadecimal : binary-to-hexadecimal : (przym.) dwójkowo-szesnastkowy
binary-to-octal : binary-to-octal : (przym.) dwójkowo-ósemkowy
binate : binate : (przym.) zdwojony
binaural : binaural : (przym.) dwuuszny
bind : bind : (czas.) dowiązać | : (czas.) opatrywać | : (czas.) oprawiać | : (czas.) przywiązać | : (czas.) przywiązywać | : (czas.) stwardnieć | : (czas.) wiązać | : (czas.) zobowiązywać | : (czas.) związać | : (rzecz.) utrudnienie | : (rzecz.) wiązanie | : (rzecz.) zobowiązywanie
binder : binder : (rzecz.) introligator | : (rzecz.) okładka | : (rzecz.) segregator | : (rzecz.) snopowiązałka | : (rzecz.) spoiwo | : (rzecz.) teczka
bindery : bindery : (rzecz.) introligatornia
binding : binding : (rzecz.) bindowanie | : (rzecz.) introligatorstwo | : (rzecz.) obszycie | : (rzecz.) opatrunek | : (rzecz.) oprawa | : (rzecz.) oprawianie | : (rzecz.) oprawienie | : (rzecz.) wiązanie
bindweed : bindweed : (rzecz.) powój
binge : binge : (rzecz.) hulanka
bingo : bingo : (rzecz.) bingo | : (rzecz.) loteryjka
binnacle : binnacle : (rzecz.) naktuz
binocular : binocular : (przym.) dwuobiektywowy | : (przym.) dwuoczny | : (przym.) obuoczny | : (rzecz.) lorneta | : (rzecz.) lornetka
binoculars : binoculars : (rzecz.) lorneta | : (rzecz.) lornetka
binomial : binomial : (przym.) binominalny | : (rzecz.) dwumian
biocatalyst : biocatalyst : (rzecz.) biokatalizator
biochemical : biochemical : (przym.) biochemiczny
biochemist : biochemist : (rzecz.) biochemik
biochemistry : biochemistry : (rzecz.) biochemia
bioclimatology : bioclimatology : (rzecz.) bioklimatologia
biodegradation : biodegradation : (rzecz.) biodegradacja
biodiversity : biodiversity : (rzecz.) bioróżnorodność
bioelectric : bioelectric : (przym.) bioelektryczny
bioelectronics : bioelectronics : (rzecz.) bioelektronika
bioenergetics : bioenergetics : (rzecz.) bioenergetyka
bioengineering : bioengineering : (rzecz.) bioinżynieria
bioethics : bioethics : (rzecz.) bioetyka
biogas : biogas : (rzecz.) biogaz
biogenesis : biogenesis : (rzecz.) biogeneza
biogenic : biogenic : (przym.) biogeniczny | : (przym.) biogenny
biogeochemistry : biogeochemistry : (rzecz.) biogeochemia
biogeography : biogeography : (rzecz.) biogeografia
biographer : biographer : (rzecz.) biograf | : (rzecz.) biografka
biographic : biographic : (przym.) biograficzny
biographical : biographical : (przym.) biograficzny
biography : biography : (rzecz.) biografia
biologic : biologic : (przym.) biologiczny
biological : biological : (przym.) biologiczny
biologically : biologically : (przysł.) biologicznie
biologist : biologist : (rzecz.) biolog
biology : biology : (rzecz.) biologia
bioluminescence : bioluminescence : (rzecz.) bioluminescencja
biomass : biomass : (rzecz.) biomasa
biomechanics : biomechanics : (rzecz.) biomechanika
biomedical : biomedical : (przym.) biomedyczny
biomedicine : biomedicine : (rzecz.) biomedycyna
biometeorology : biometeorology : (rzecz.) biometeorologia
biometric : biometric : (przym.) biometryczny
biometrics : biometrics : (rzecz.) biometria | : (rzecz.) biometryka
biometry : biometry : (rzecz.) biometria
bionics : bionics : (rzecz.) bionika
biophysical : biophysical : (przym.) biofizyczny
biophysicist : biophysicist : (rzecz.) biofizyk | : (rzecz.) biofizyka
biophysics : biophysics : (rzecz.) biofizyk | : (rzecz.) biofizyka
biopsy : biopsy : (rzecz.) biopsja
biorhythm : biorhythm : (rzecz.) biorytm
biosphere : biosphere : (rzecz.) biosfera
biosynthesis : biosynthesis : (rzecz.) biosynteza
biota : biota : (rzecz.) kleks | : (rzecz.) plama | : (rzecz.) wada
biotechnological : biotechnological : (przym.) biotechnologiczny
biotechnology : biotechnology : (rzecz.) biotechnika | : (rzecz.) biotechnologia
biotic : biotic : (przym.) biotyczny
biotin : biotin : (rzecz.) biotyna
biotope : biotope : (rzecz.) biotop
biotype : biotype : (rzecz.) biotyp
bipartite : bipartite : (przym.) dwudzielny
bipartition : bipartition : (rzecz.) dwudzielność
bipedal : bipedal : (przym.) dwunożny
biplane : biplane : (rzecz.) dwupłat | : (rzecz.) dwupłatowiec
bipod : bipod : (rzecz.) dwójnóg
bipolar : bipolar : (przym.) bipolarny | : (przym.) dwubiegunowy
bipolarity : bipolarity : (rzecz.) dwubiegunowość
birch : birch : (rzecz.) brzezina | : (rzecz.) brzoza | : (rzecz.) brzózka | : (rzecz.) rózga
birch-rod : birch-rod : (rzecz.) rózga
bird : bird : (rzecz.) ptak
bird-cage : bird-cage : (rzecz.) klatka
bird-fancier : bird-fancier : (rzecz.) ptasznik
bird-seed : bird-seed : (rzecz.) siemię
birdie : birdie : (rzecz.) kociak | : (rzecz.) ptaszyna
birds : birds : (rzecz.) ptactwo | : (rzecz.) ptak
birdseed : birdseed : (rzecz.) ciemnota | : (rzecz.) głupota | : (rzecz.) nonsens | : (rzecz.) siemię
birefringence : birefringence : (rzecz.) dwójłomność
biretta : biretta : (rzecz.) biret
biro : biro : (rzecz.) długopis
birr : birr : (czas.) warkotać | : (rzecz.) pęd | : (rzecz.) warkot
birth : birth : (przym.) porodowy | : (przym.) rodny | : (rzecz.) narodzenie | : (rzecz.) narodziny | : (rzecz.) pochodzenie | : (rzecz.) początek | : (rzecz.) poród | : (rzecz.) ród | : (rzecz.) rodzenie | : (rzecz.) rozwiązanie | : (rzecz.) urodzenie | : (rzecz.) źródło
birth-certificate : birth-certificate : (rzecz.) metryka
birthday : birthday : (rzecz.) urodziny
birthdays : birthdays : (rzecz.) urodziny
birthmark : birthmark : (rzecz.) pieprzyk | : (rzecz.) znamię
birthplace : birthplace : (rzecz.) kolebka
birthright : birthright : (rzecz.) pierworództwo
births : births : (rzecz.) narodziny
biscuit : biscuit : (rzecz.) biskwit | : (rzecz.) biszkopt | : (rzecz.) ciastko | : (rzecz.) herbatnik | : (rzecz.) suchar | : (rzecz.) sucharek
biscuits : biscuits : (rzecz.) herbatniki
bisect : bisect : (czas.) dzielić | : (czas.) przepoławiać | : (czas.) przepołowić
bisection : bisection : (rzecz.) przepołowienie
bisector : bisector : (rzecz.) dwusieczna | : (rzecz.) symetralna
bisexual : bisexual : (przym.) biseksualny | : (przym.) obojnaczy
bisexuality : bisexuality : (rzecz.) biseksualizm
bishop : bishop : (rzecz.) biskup | : (rzecz.) goniec | : (rzecz.) kruszon | : (rzecz.) laufer
bishopric : bishopric : (rzecz.) biskupstwo | : (rzecz.) diecezja
bishops : bishops : (rzecz.) arcypasterz
bismuth : bismuth : (rzecz.) bizmut
bison : bison : (rzecz.) bizon | : (rzecz.) tur | : (rzecz.) żubr
bisque : bisque : (rzecz.) biskwit | : (rzecz.) furia | : (rzecz.) gniew
bissextile : bissextile : (przym.) przestępny
bistort : bistort : (rzecz.) wężownik
bistro : bistro : (rzecz.) bistro
bistros : bistros : (rzecz.) bistr
bit : bit : (rzecz.) bicie | : (rzecz.) bit | : (rzecz.) cząstka | : (rzecz.) część | : (rzecz.) kąsek | : (rzecz.) kategoria | : (rzecz.) kawałek | : (rzecz.) kęs | : (rzecz.) odrobina | : (rzecz.) ostrze | : (rzecz.) płytka | : (rzecz.) świder | : (rzecz.) trochę | : (rzecz.) wędzidło | : (rzecz.) wiertło
bitch : bitch : (rzecz.) dziwka | : (rzecz.) kobieta | : (rzecz.) suczka | : (rzecz.) suka | : (rzecz.) wydra
bitchy : bitchy : (przym.) kąśliwy
bite : bite : (czas.) chwytać | : (czas.) gryźć | : (czas.) kąsać | : (czas.) nagryzać | : (czas.) odgryźć | : (czas.) pogryźć | : (czas.) pokąsać | : (czas.) szczypać | : (czas.) ugryźć | : (czas.) ukąsić | : (czas.) zagryźć | : (czas.) zgryźć | : (rzecz.) chwyt | : (rzecz.) gryz | : (rzecz.) kąsek | : (rzecz.) kęs | : (rzecz.) ugryzienie | : (rzecz.) ukąszenie | : (rzecz.) zaciśnięcie | : (rzecz.) zgryz
biting : biting : (przym.) gryzący | : (przym.) ostry | : (przym.) szczypiący | : (przym.) uszczypliwy
bitingly : bitingly : (przysł.) gryząco
bitmap : bitmap : (rzecz.) bitmapa | : (rzecz.) mapa | : (rzecz.) odwzorowanie
bitter : bitter : (przym.) goryczkowy | : (przym.) gorzki | : (przym.) piołunowy | : (przym.) przenikliwy
bitterly : bitterly : (przysł.) ciężko | : (przysł.) głęboko | : (przysł.) gorzko | : (przysł.) napastliwie | : (przysł.) silnie | : (przysł.) zajadle | : (przysł.) zawzięcie
bittern : bittern : (rzecz.) bąk
bitterness : bitterness : (rzecz.) ciętość | : (rzecz.) gorycz | : (rzecz.) gorzkość | : (rzecz.) napastliwość | : (rzecz.) rozgoryczenie | : (rzecz.) rozżalenie | : (rzecz.) uraza | : (rzecz.) zawziętość
bitumen : bitumen : (rzecz.) asfalt | : (rzecz.) bitum | : (rzecz.) bitumin | : (rzecz.) smoła
bituminization : bituminization : (rzecz.) bitumizacja
bituminous : bituminous : (przym.) bitumiczny
bivalent : bivalent : (przym.) dwuwartościowy
bivalve : bivalve : (rzecz.) małż | : (rzecz.) skorupiak
bivouac : bivouac : (czas.) biwakować | : (rzecz.) biwak
bivouacking : bivouacking : (rzecz.) biwakowanie
bizarre : bizarre : (przym.) cudaczny | : (przym.) dziwaczny | : (przym.) dziwny | : (przym.) kapryśny | : (przym.) przedziwny
blab : blab : (czas.) gadać | : (czas.) paplać | : (czas.) pleść | : (rzecz.) gadanina | : (rzecz.) gaduła | : (rzecz.) papla | : (rzecz.) plotkarz
blabber : blabber : (rzecz.) papla
blabbermouth : blabbermouth : (rzecz.) gaduła | : (rzecz.) papla
blabbing : blabbing : (rzecz.) chlapanie
black : black : (czas.) bojkotować | : (czas.) czernić | : (czas.) zaczernić | : (przym.) chmurny | : (przym.) czarnorynkowy | : (przym.) czarnoskóry | : (przym.) czarny | : (przym.) murzyński | : (przym.) ponury | : (rzecz.) czerń | : (rzecz.) czernidło | : (rzecz.) murzyn
black-lead : black-lead : (rzecz.) grafit
black-market : black-market : (przym.) czarnorynkowy
black-out : black-out : (rzecz.) zaciemnienie | : (rzecz.) zamroczenie
blackberry : blackberry : (rzecz.) czernica | : (rzecz.) jeżyna | : (rzecz.) ożyna
blackbird : blackbird : (rzecz.) kos | : (rzecz.) kosa
blackboard : blackboard : (rzecz.) tablica
blackbody : blackbody : (rzecz.) ciało
blackcock : blackcock : (rzecz.) cietrzew
blacken : blacken : (czas.) czernić | : (czas.) czernieć | : (czas.) oczerniać | : (czas.) oczernić | : (czas.) pociemnieć
blackener : blackener : (czas.) zaczerniać
blackening : blackening : (rzecz.) ciemnienie | : (rzecz.) czernienie | : (rzecz.) sczernienie | : (rzecz.) zaczernienie
blackguard : blackguard : (przym.) łajdacki | : (przym.) podły | : (rzecz.) łajdak | : (rzecz.) szubrawiec
blackguardly : blackguardly : (przym.) nikczemny
blackhead : blackhead : (rzecz.) wągier | : (rzecz.) wągr | : (rzecz.) zaskórnik
blacking : blacking : (rzecz.) czernidło | : (rzecz.) czernienie | : (rzecz.) grafitowanie | : (rzecz.) łamistrajk | : (rzecz.) szuler
blackjack : blackjack : (rzecz.) dąb | : (rzecz.) maczuga | : (rzecz.) oczko
blackleg : blackleg : (rzecz.) łamistrajk | : (rzecz.) szuler
blackly : blackly : (przysł.) czarno
blackmail : blackmail : (czas.) szantażować | : (rzecz.) szantaż | : (rzecz.) wymuszenie
blackmailer : blackmailer : (rzecz.) szantażysta
blackmailing : blackmailing : (rzecz.) szantażowanie
blackness : blackness : (rzecz.) ciemność | : (rzecz.) czerń
blackout : blackout : (rzecz.) luka | : (rzecz.) zaciemnienie | : (rzecz.) zanik
blacks : blacks : (rzecz.) czernienie
blacksmith : blacksmith : (rzecz.) kowal
blackthorn : blackthorn : (rzecz.) tarnina
bladder : bladder : (rzecz.) dętka | : (rzecz.) pęcherz
bladder-wrack : bladder-wrack : (rzecz.) morszczyn
blade : blade : (rzecz.) antrykot | : (rzecz.) blaszka | : (rzecz.) brzeszczot | : (rzecz.) chwat | : (rzecz.) klinga | : (rzecz.) liść | : (rzecz.) łopatka | : (rzecz.) miecz | : (rzecz.) ostrze | : (rzecz.) piła | : (rzecz.) skrzydło | : (rzecz.) wiór | : (rzecz.) źdźbło
blade-bone : blade-bone : (rzecz.) łopatka
blah : blah : (rzecz.) bujda
blain : blain : (rzecz.) bąbel | : (rzecz.) krosta | : (rzecz.) pęcherzyk
blame : blame : (czas.) ganić | : (czas.) łajać | : (czas.) obwiniać | : (czas.) oskarżać | : (czas.) potępiać | : (czas.) winić | : (rzecz.) nagana | : (rzecz.) obwinienie | : (rzecz.) potępienie | : (rzecz.) wina | : (rzecz.) zarzut
blameless : blameless : (przym.) nienaganny | : (przym.) nieskazitelny | : (przym.) niewinny
blamelessness : blamelessness : (przym.) niewinny | : (rzecz.) niewinność
blameworthy : blameworthy : (przym.) naganny | : (przym.) winny
blaming : blaming : (rzecz.) odpowiedzialność
blanch : blanch : (czas.) bielić | : (czas.) blanszować | : (czas.) pobielić | : (czas.) zblednąć
blanching : blanching : (rzecz.) blanszowanie | : (rzecz.) wybielanie
bland : bland : (przym.) dobrotliwy | : (przym.) łagodny | : (przym.) łaskawy | : (przym.) mdły | : (przym.) miły | : (przym.) nijaki
blandish : blandish : (czas.) pieścić | : (czas.) pochlebiać | : (czas.) schlebiać
blandishment : blandishment : (rzecz.) pochlebstwo | : (rzecz.) przypochlebianie
blandly : blandly : (przysł.) dobrotliwie | : (przysł.) uprzejmie
blandness : blandness : (rzecz.) dobrotliwość | : (rzecz.) uprzejmość
blank : blank : (przym.) bezmyślny | : (przym.) blady | : (przym.) czysty | : (przym.) pusty | : (przym.) ślepy | : (przym.) wygaszony | : (rzecz.) blankiet | : (rzecz.) formularz | : (rzecz.) kratka | : (rzecz.) luka
blanket : blanket : (rzecz.) derka | : (rzecz.) koc | : (rzecz.) kocyk | : (rzecz.) pokrycie | : (rzecz.) pokrywa | : (rzecz.) zasłona
blanking : blanking : (rzecz.) wygaszanie | : (rzecz.) wykrawanie
blankly : blankly : (przysł.) beznamiętnie
blankness : blankness : (rzecz.) pustka | : (rzecz.) pustota
blare : blare : (czas.) grzmieć | : (czas.) huczeć | : (czas.) trąbić | : (rzecz.) huk | : (rzecz.) ryk | : (rzecz.) trąbienie
blarney : blarney : (rzecz.) bajer
blaspheme : blaspheme : (czas.) bluźnić | : (czas.) złorzeczyć
blasphemer : blasphemer : (rzecz.) bluźnierca
blasphemous : blasphemous : (przym.) bluźnierczy
blasphemy : blasphemy : (rzecz.) bluźnierstwo
blast : blast : (czas.) wysadzać | : (czas.) wysadzić | : (rzecz.) burza | : (rzecz.) eksplozja | : (rzecz.) podmuch | : (rzecz.) wybuch | : (rzecz.) zadęcie
blast-furnace : blast-furnace : (przym.) wielkopiecowy
blast-off : blast-off : (rzecz.) odpalenie
blasted : blasted : (przym.) cholerny
blaster : blaster : (przym.) strzałowy | : (rzecz.) nabojnica
blasting : blasting : (przym.) strzałowy
blastoff : blastoff : (rzecz.) odpalenie
blatancy : blatancy : (rzecz.) krzykliwość
blatant : blatant : (przym.) krzykliwy
blatantly : blatantly : (przysł.) krzycząco | : (przysł.) rażąco
blaze : blaze : (czas.) błyszczeć | : (czas.) nacinać | : (czas.) palić | : (czas.) płonąć | : (czas.) świecić | : (czas.) walić | : (rzecz.) blask | : (rzecz.) błysk | : (rzecz.) ogień | : (rzecz.) płomień | : (rzecz.) pożar | : (rzecz.) wybuch
blazer : blazer : (rzecz.) blezer | : (rzecz.) kurtka
blazon : blazon : (rzecz.) herb
blazonry : blazonry : (rzecz.) barwność | : (rzecz.) heraldyk | : (rzecz.) heraldyka
bleach : bleach : (czas.) bielić | : (czas.) rozjaśniać | : (czas.) rozjaśnić | : (czas.) wybielać | : (czas.) wybielić | : (rzecz.) bielenie | : (rzecz.) bielik | : (rzecz.) wybielacz
bleacher : bleacher : (rzecz.) bielnik | : (rzecz.) pracz | : (rzecz.) wybielacz
bleaching : bleaching : (rzecz.) bielenie | : (rzecz.) odbielanie | : (rzecz.) wybielanie
bleak : bleak : (przym.) niewesoły | : (przym.) ponury | : (przym.) pustynny | : (przym.) smutny | : (przym.) zimny
blear : blear : (przym.) niewyraźny
bleary : bleary : (przym.) mętny | : (przym.) niewyraźny
bleat : bleat : (czas.) beczeć | : (rzecz.) beczenie | : (rzecz.) bek | : (rzecz.) biadolenie
bleating : bleating : (rzecz.) beczenie
bleb : bleb : (rzecz.) bańka | : (rzecz.) pęcherzyk
bleed : bleed : (czas.) blaknąć | : (czas.) farbować | : (czas.) krwawić | : (czas.) przeciekać | : (czas.) uchodzić
bleeder : bleeder : (rzecz.) hemofilik | : (rzecz.) spust | : (rzecz.) upust
bleeding : bleeding : (rzecz.) krwawica | : (rzecz.) krwawienie | : (rzecz.) odsączanie | : (rzecz.) przeciekanie | : (rzecz.) przesączanie
bleep : bleep : (rzecz.) dzwonek | : (rzecz.) piknięcie
bleeper : bleeper : (rzecz.) brzęczyk
blemish : blemish : (czas.) plamić | : (czas.) splamić | : (czas.) szpecić | : (czas.) zniekształcać | : (czas.) zniekształcić | : (rzecz.) błąd | : (rzecz.) plama | : (rzecz.) skaza | : (rzecz.) wada | : (rzecz.) zmaza
blench : blench : (czas.) posiwieć | : (czas.) truchleć | : (czas.) wzdrygać | : (czas.) zblednąć
blend : blend : (czas.) łączyć | : (czas.) mieszać | : (czas.) miksować | : (czas.) połączyć | : (czas.) zmieszać | : (rzecz.) metamorfoza | : (rzecz.) mieszanka
blender : blender : (rzecz.) mikser
blending : blending : (rzecz.) melanżowanie | : (rzecz.) pomieszanie
bless : bless : (czas.) błogosławić | : (czas.) pobłogosławić | : (czas.) żegnać
blessed : blessed : (przym.) błogosławiony
blessing : blessing : (rzecz.) błogosławieństwo | : (rzecz.) dobrodziejstwo
blight : blight : (czas.) niszczyć | : (czas.) niweczyć | : (czas.) tłumić | : (czas.) udaremniać | : (rzecz.) rdza | : (rzecz.) śnieć | : (rzecz.) zaraza | : (rzecz.) zniszczenie
blighter : blighter : (rzecz.) nicpoń
blimp : blimp : (rzecz.) grubas | : (rzecz.) sterowiec
blind : blind : (czas.) oślepiać | : (czas.) oślepić | : (czas.) ukryć | : (czas.) zabezpieczyć | : (czas.) zamaskować | : (przym.) bezkrytyczny | : (przym.) niewidomy | : (przym.) ślepy | : (rzecz.) roleta | : (rzecz.) ślepie | : (rzecz.) ślepiec | : (rzecz.) stora | : (rzecz.) żaluzja | : (rzecz.) zasłona
blinder : blinder : (przym.) ślepy | : (rzecz.) ślepota
blindly : blindly : (przysł.) ślepo
blindness : blindness : (rzecz.) oślepnięcie | : (rzecz.) ślepota | : (rzecz.) zaślepienie
blinds : blinds : (rzecz.) żaluzja
blindworm : blindworm : (rzecz.) padalec
blink : blink : (czas.) błyskać | : (czas.) migać | : (czas.) migotać | : (czas.) mrugać | : (czas.) mrużyć | : (czas.) zamrugać | : (rzecz.) błysk | : (rzecz.) mignięcie
blinker : blinker : (rzecz.) migacz
blinking : blinking : (rzecz.) miganie | : (rzecz.) migotanie | : (rzecz.) mruganie | : (rzecz.) mrużenie | : (rzecz.) pulsowanie
blip : blip : (rzecz.) spadek | : (rzecz.) wyskok
bliss : bliss : (rzecz.) błogość | : (rzecz.) radość | : (rzecz.) rozkosz
blissful : blissful : (przym.) błogi | : (przym.) rajski
blissfully : blissfully : (przysł.) błogo
blissfulness : blissfulness : (rzecz.) błogość
blister : blister : (rzecz.) bąbel | : (rzecz.) odcisk | : (rzecz.) odparzenie | : (rzecz.) pęcherz | : (rzecz.) pęcherzyk
blithe : blithe : (przym.) beztroski | : (przym.) wesoły
blithely : blithely : (przysł.) beztrosko | : (przysł.) radośnie
blithering : blithering : (przym.) zupełny
blitz : blitz : (rzecz.) nalot
blitzkrieg : blitzkrieg : (rzecz.) nalot
blizzard : blizzard : (rzecz.) nawałnica | : (rzecz.) zadymka | : (rzecz.) zamieć | : (rzecz.) zawieja
bloat : bloat : (czas.) dymać | : (czas.) nabrzmiewać | : (czas.) nadąć | : (czas.) nadymać | : (czas.) uwędzić
bloated : bloated : (przym.) pyszałkowaty
bloater : bloater : (rzecz.) pikling
blob : blob : (rzecz.) kleks | : (rzecz.) kropelka | : (rzecz.) kropla | : (rzecz.) kulka
bloc : bloc : (rzecz.) blok | : (rzecz.) całość
block : block : (czas.) barykadować | : (czas.) blokować | : (czas.) kłóć | : (czas.) tamować | : (czas.) tarasować | : (czas.) wstrzymywać | : (czas.) zablokować | : (czas.) zasłaniać | : (czas.) zatarasować | : (rzecz.) blok | : (rzecz.) blokada | : (rzecz.) bryła | : (rzecz.) klisza | : (rzecz.) kloc | : (rzecz.) klocek | : (rzecz.) notatnik | : (rzecz.) obstrukcja | : (rzecz.) pień | : (rzecz.) pieniek | : (rzecz.) przeszkoda | : (rzecz.) zablokowanie | : (rzecz.) zamroczenie | : (rzecz.) zapora
blockade : blockade : (czas.) blokować | : (czas.) zablokować | : (rzecz.) blokada | : (rzecz.) zablokowanie
blockage : blockage : (rzecz.) blokada | : (rzecz.) niedrożność | : (rzecz.) przegroda | : (rzecz.) przeszkoda | : (rzecz.) zator
blockbuster : blockbuster : (rzecz.) przebój | : (rzecz.) szlagier
blocked : blocked : (przym.) zapchany
blocker : blocker : (rzecz.) blokada
blockhead : blockhead : (rzecz.) bałwan | : (rzecz.) cep | : (rzecz.) dureń | : (rzecz.) głupiec | : (rzecz.) jełop | : (rzecz.) jołop | : (rzecz.) niezdara | : (rzecz.) tępak | : (rzecz.) tuman
blockhouse : blockhouse : (rzecz.) bunkier
blocking : blocking : (rzecz.) blokowanie | : (rzecz.) pisanie | : (rzecz.) retusz | : (rzecz.) tworzenie | : (rzecz.) zablokowanie
blocks : blocks : (rzecz.) kłócenie
bloke : bloke : (rzecz.) człowiek
blond : blond : (przym.) jasny | : (rzecz.) blond | : (rzecz.) blondyn
blonde : blonde : (przym.) jasny | : (rzecz.) blond | : (rzecz.) blondyn | : (rzecz.) blondynka
blondes : blondes : (rzecz.) blondynek
blood : blood : (rzecz.) krew | : (rzecz.) natura | : (rzecz.) pochodzenie | : (rzecz.) pokrewieństwo | : (rzecz.) posoka
blood-giver : blood-giver : (rzecz.) krwiodawca
blood-stone : blood-stone : (rzecz.) krwawnik
blood-sucker : blood-sucker : (rzecz.) pijawka
blood-thirsty : blood-thirsty : (przym.) krwiożerczy
bloodbath : bloodbath : (rzecz.) masakra | : (rzecz.) rzeź
bloodhound : bloodhound : (rzecz.) ogar | : (rzecz.) posokowiec | : (rzecz.) tropowiec | : (rzecz.) wywiadowca
bloodied : bloodied : (przym.) krwisty
bloodless : bloodless : (przym.) bezkrwawy | : (przym.) niekrwawy
bloodline : bloodline : (rzecz.) krew
bloodshed : bloodshed : (rzecz.) rozlew
bloodstone : bloodstone : (rzecz.) krwawnik
bloodstream : bloodstream : (rzecz.) krwiobieg
bloodsucker : bloodsucker : (rzecz.) pijawka
bloodthirstiness : bloodthirstiness : (rzecz.) krwiożerczość
bloodthirsty : bloodthirsty : (przym.) krwiożerczy
bloody : bloody : (przym.) cholerny | : (przym.) krwawy
bloom : bloom : (czas.) kwitnąć | : (czas.) wykwitać | : (czas.) zakwitać | : (rzecz.) kwiat | : (rzecz.) rozkwit | : (rzecz.) rozkwitnięcie | : (rzecz.) wykwit | : (rzecz.) zakwitnięcie
bloomer : bloomer : (rzecz.) gafa | : (rzecz.) zgniatacz
blossom : blossom : (czas.) kwitnąć | : (czas.) rozkwitać | : (rzecz.) kwiat | : (rzecz.) kwiatostan | : (rzecz.) kwiecie
blot : blot : (czas.) mazać | : (czas.) plamić | : (rzecz.) kleks | : (rzecz.) plama | : (rzecz.) skaza | : (rzecz.) zmaza
blotch : blotch : (rzecz.) krosta | : (rzecz.) plama | : (rzecz.) pryszcz | : (rzecz.) skaza
blotter : blotter : (rzecz.) bibularz | : (rzecz.) suszka
blotting : blotting : (rzecz.) bibuła | : (rzecz.) marzenie
blotting-pad : blotting-pad : (rzecz.) bibularz
blotting-paper : blotting-paper : (rzecz.) bibuła
blouse : blouse : (rzecz.) bluza | : (rzecz.) bluzka
blow : blow : (czas.) dąć | : (czas.) dmuchać | : (czas.) kwitnąć | : (czas.) nadmuchać | : (czas.) nawiać | : (czas.) podmuchiwać | : (czas.) powiewać | : (czas.) przepalać | : (czas.) przewiać | : (czas.) wiać | : (czas.) zadąć | : (rzecz.) cios | : (rzecz.) ciosanie | : (rzecz.) dęcie | : (rzecz.) nadmuch | : (rzecz.) podmuch | : (rzecz.) powiewanie | : (rzecz.) rękoczyn | : (rzecz.) rozkwit | : (rzecz.) rzut | : (rzecz.) sztos | : (rzecz.) uderzenie | : (rzecz.) wyżerka
blow-back : blow-back : (rzecz.) nadmuchiwanie
blow-off : blow-off : (rzecz.) odmulanie | : (rzecz.) zbiornika
blow-out : blow-out : (rzecz.) erupcja | : (rzecz.) gazu | : (rzecz.) przebicie | : (rzecz.) rozerwanie | : (rzecz.) rozsadzenie | : (rzecz.) wytrysk | : (rzecz.) wyżerka
blower : blower : (rzecz.) dmuchacz | : (rzecz.) dmuchawa
blowhole : blowhole : (rzecz.) por | : (rzecz.) pora
blowing : blowing : (rzecz.) dmuchanie | : (rzecz.) powiewanie
blowing-down : blowing-down : (rzecz.) odmulanie | : (rzecz.) przedmuchiwanie
blown : blown : (rzecz.) wdmuchiwanie
blowpipe : blowpipe : (rzecz.) cybuch | : (rzecz.) dmuchawa | : (rzecz.) palnik | : (rzecz.) piszczel
blowtorch : blowtorch : (rzecz.) palnik
blubber : blubber : (czas.) beczeć | : (rzecz.) beczenie | : (rzecz.) płacz | : (rzecz.) tłuszcz | : (rzecz.) tran
blubberer : blubberer : (rzecz.) mazgaj
bludgeon : bludgeon : (czas.) wymuszać | : (rzecz.) maczuga | : (rzecz.) pałka
blue : blue : (czas.) niebieszczeć | : (przym.) bławatkowy | : (przym.) bławatny | : (przym.) błękitny | : (przym.) chabrowy | : (przym.) ciemnoniebieski | : (przym.) granatowy | : (przym.) niebieski | : (przym.) siny | : (przym.) smutny | : (rzecz.) błękit | : (rzecz.) błękitność | : (rzecz.) lazur | : (rzecz.) niebieskość | : (rzecz.) ultramaryna
blue-black : blue-black : (przym.) kruczoczarny
blue-collar : blue-collar : (przym.) fizyczny | : (rzecz.) robotnik
bluebell : bluebell : (rzecz.) dzwonek
blueberry : blueberry : (rzecz.) borówka | : (rzecz.) czernica | : (rzecz.) jagoda
bluebottle : bluebottle : (rzecz.) plujka
blueing : blueing : (rzecz.) czernienie | : (rzecz.) farbkowanie | : (rzecz.) niebieszczenie | : (rzecz.) oksydowanie
bluejacket : bluejacket : (rzecz.) marynarz
blueness : blueness : (rzecz.) błękit
blueprint : blueprint : (rzecz.) fotokopia | : (rzecz.) konspekt | : (rzecz.) odbitka | : (rzecz.) projekt | : (rzecz.) światłodruk | : (rzecz.) światłokopia
blues : blues : (rzecz.) blues | : (rzecz.) chandra | : (rzecz.) splin
bluff : bluff : (czas.) blagować | : (czas.) blefować | : (czas.) bluffować | : (czas.) oszukiwać | : (czas.) zmylać | : (czas.) zmylić | : (przym.) niezgrabny | : (przym.) stromy | : (przym.) szczery | : (przym.) szorstki | : (rzecz.) blaga | : (rzecz.) blef | : (rzecz.) bluff | : (rzecz.) nabieranie | : (rzecz.) oszustwo | : (rzecz.) urwisko
bluffer : bluffer : (rzecz.) blagier | : (rzecz.) blefiarz
bluffing : bluffing : (rzecz.) blefowanie
bluffly : bluffly : (przysł.) rubasznie
bluffness : bluffness : (rzecz.) blefowanie
bluing : bluing : (rzecz.) farbka | : (rzecz.) farbkowanie
bluish : bluish : (przym.) modrawy | : (przym.) niebieskawy
blunder : blunder : (rzecz.) błąd | : (rzecz.) gafa | : (rzecz.) niezręczność | : (rzecz.) omyłka | : (rzecz.) pomyłka | : (rzecz.) przejęzyczenie | : (rzecz.) wpadka
blunderbuss : blunderbuss : (rzecz.) rusznica
blunt : blunt : (czas.) stępiać | : (czas.) stępić | : (przym.) bezceremonialny | : (przym.) dosadny | : (przym.) nieostry | : (przym.) prosty | : (przym.) przytępiony | : (przym.) szorstki | : (przym.) tępy
blunting : blunting : (przym.) bezceremonialny
bluntly : bluntly : (przysł.) dosadnie
bluntness : bluntness : (rzecz.) szczerość
blur : blur : (czas.) plamić | : (czas.) rozmazać | : (czas.) rozmazywać | : (czas.) rozmywać | : (czas.) splamić | : (czas.) wymazać | : (czas.) zacierać | : (czas.) zamazać | : (czas.) zamazywać | : (czas.) zatrzeć | : (rzecz.) niejasność | : (rzecz.) plama | : (rzecz.) rozmycie
blurb : blurb : (rzecz.) prospekt | : (rzecz.) reklama | : (rzecz.) zapowiedź
blurring : blurring : (czas.) rozmyć | : (przym.) mglisty | : (rzecz.) rozmywanie | : (rzecz.) zamazywanie
blurry : blurry : (przym.) mglisty | : (przym.) niewyraźny
blurt : blurt : (czas.) wydać | : (czas.) wygadać | : (czas.) wygadywać | : (czas.) wyrzucać | : (czas.) wyznawać
blush : blush : (czas.) czerwienić | : (czas.) kraśnieć | : (czas.) pąsowieć | : (czas.) poróżowieć | : (czas.) rumienić | : (czas.) zarumienić | : (rzecz.) rumieniec | : (rzecz.) zarumienienie
blusher : blusher : (rzecz.) róż
blushing : blushing : (przym.) różowy
bluster : bluster : (czas.) rozbijać | : (czas.) szaleć | : (czas.) wygrażać | : (rzecz.) awantura | : (rzecz.) hałaśliwość | : (rzecz.) łoskot | : (rzecz.) rozbicie | : (rzecz.) szaleństwo
blusterer : blusterer : (rzecz.) agresor | : (rzecz.) zabijak | : (rzecz.) zabijaka
blustering : blustering : (przym.) czupurny
blusterous : blusterous : (przym.) buńczuczny | : (przym.) wrzaskliwy
blustery : blustery : (przym.) porywisty | : (przym.) wietrzny
boa : boa : (rzecz.) boa
boar : boar : (rzecz.) dzik | : (rzecz.) knur | : (rzecz.) odyniec | : (rzecz.) wieprz
board : board : (czas.) dylować | : (czas.) futrować | : (czas.) oszalować | : (czas.) stołować | : (czas.) wsiadać | : (czas.) wsiąść | : (czas.) zatrudniać | : (rzecz.) burta | : (rzecz.) decha | : (rzecz.) deska | : (rzecz.) kolacja | : (rzecz.) kolegium | : (rzecz.) komisja | : (rzecz.) komitet | : (rzecz.) plansza | : (rzecz.) płyta | : (rzecz.) płytka | : (rzecz.) pokład | : (rzecz.) rada | : (rzecz.) stół | : (rzecz.) szachownica | : (rzecz.) tablica | : (rzecz.) tektura | : (rzecz.) wikt | : (rzecz.) wsiadanie | : (rzecz.) wyżywienie | : (rzecz.) zarząd
boarder : boarder : (rzecz.) mieszkaniec | : (rzecz.) pensjonariusz | : (rzecz.) stołownik
boarding : boarding : (rzecz.) cembrowina | : (rzecz.) deskowanie | : (rzecz.) szalowanie | : (rzecz.) wyżywienie
boarding-house : boarding-house : (rzecz.) internat | : (rzecz.) pensjonat
boarding-school : boarding-school : (rzecz.) internat
boardroom : boardroom : (rzecz.) dyrekcja | : (rzecz.) zarząd
boardwalk : boardwalk : (rzecz.) promenada
boast : boast : (czas.) chełpić | : (czas.) chwalić | : (czas.) łgać | : (czas.) pochwalać | : (czas.) pochwalić | : (rzecz.) samochwalstwo
boaster : boaster : (rzecz.) chwalipięta | : (rzecz.) samochwał | : (rzecz.) samochwała
boastful : boastful : (przym.) chełpliwy | : (przym.) samochwalczy
boastfulness : boastfulness : (rzecz.) chełpliwość | : (rzecz.) samochwalstwo
boasting : boasting : (rzecz.) chwalba | : (rzecz.) przechwalanie
boat : boat : (rzecz.) barkarz | : (rzecz.) czółenko | : (rzecz.) czółno | : (rzecz.) łódka | : (rzecz.) łódź | : (rzecz.) lodżia | : (rzecz.) statek | : (rzecz.) tratwa
boat-hook : boat-hook : (rzecz.) bosak | : (rzecz.) osęka
boatbuilding : boatbuilding : (rzecz.) szkutnictwo
boater : boater : (rzecz.) kanotier
boathook : boathook : (rzecz.) bosak | : (rzecz.) drąg | : (rzecz.) osęka
boathouse : boathouse : (rzecz.) przystań
boating : boating : (rzecz.) przejażdżka | : (rzecz.) wodniactwo | : (rzecz.) żeglarstwo
boatman : boatman : (rzecz.) przewoźnik
boatswain : boatswain : (rzecz.) bosman
bob : bob : (czas.) balansować | : (czas.) huśtać | : (czas.) podskakiwać | : (rzecz.) ciężarek | : (rzecz.) dyg | : (rzecz.) obciążnik | : (rzecz.) podskakiwanie | : (rzecz.) spławik | : (rzecz.) szyling | : (rzecz.) wahadło | : (rzecz.) wisiorek
bob-sled : bob-sled : (rzecz.) bobslej
bob-sleigh : bob-sleigh : (rzecz.) bobslej
bobbin : bobbin : (rzecz.) bobina | : (rzecz.) cewka | : (rzecz.) szpula | : (rzecz.) szpulka
bobby : bobby : (rzecz.) konstabl | : (rzecz.) policjant
bobbysoxer : bobbysoxer : (rzecz.) podlotek
bobsled : bobsled : (rzecz.) bobslej
bobsledder : bobsledder : (rzecz.) bobsleista
bobsleigh : bobsleigh : (rzecz.) bobslej | : (rzecz.) saneczkarstwo
bobsleighing : bobsleighing : (rzecz.) bobslej
bobstay : bobstay : (rzecz.) watersztag
bock : bock : (rzecz.) bomba
bode : bode : (czas.) wróżyć | : (czas.) zapowiadać
bodice : bodice : (rzecz.) kaftan | : (rzecz.) stanik
bodiless : bodiless : (przym.) bezcielesny | : (przym.) niematerialny
bodily : bodily : (przym.) cielesny | : (przym.) fizjologiczny | : (przysł.) cieleśnie | : (przysł.) fizjologicznie | : (przysł.) gremialnie
bodkin : bodkin : (rzecz.) szydło
body : body : (rzecz.) ciałko | : (rzecz.) ciało | : (rzecz.) gremium | : (rzecz.) grupa | : (rzecz.) kadłub | : (rzecz.) karoseria | : (rzecz.) kolegium | : (rzecz.) korpus | : (rzecz.) kulturysta | : (rzecz.) nadbudowa | : (rzecz.) nadwozie | : (rzecz.) oddział | : (rzecz.) organ | : (rzecz.) organizm | : (rzecz.) ścierwo | : (rzecz.) treść | : (rzecz.) tułów | : (rzecz.) zwłoki
body-builder : body-builder : (rzecz.) kulturysta
body-building : body-building : (rzecz.) kulturystyka
bodybuilder : bodybuilder : (rzecz.) kulturysta
bodybuilding : bodybuilding : (rzecz.) kulturystyka
bodyguard : bodyguard : (rzecz.) obstawa | : (rzecz.) ochrona | : (rzecz.) ochroniarz | : (rzecz.) strażnik
bodywork : bodywork : (rzecz.) karoseria | : (rzecz.) nadwozie
boffin : boffin : (rzecz.) specjalista
bog : bog : (rzecz.) bagno | : (rzecz.) błotnistość | : (rzecz.) grządka | : (rzecz.) moczary | : (rzecz.) trzęsawisko
bogey : bogey : (rzecz.) smark | : (rzecz.) strach | : (rzecz.) straszydło | : (rzecz.) szatan | : (rzecz.) zmora
bogeyman : bogeyman : (rzecz.) licho
boggle : boggle : (czas.) uchylać | : (czas.) wzdragać | : (rzecz.) zawahanie
boggling : boggling : (rzecz.) ślęczenie
boggy : boggy : (przym.) bagnisty | : (przym.) grząski | : (przym.) moczarowaty
bogie : bogie : (rzecz.) straszydło
bogus : bogus : (przym.) fałszywy | : (przym.) fikcyjny | : (przym.) oszukańczy
bogy : bogy : (rzecz.) strach | : (rzecz.) straszydło | : (rzecz.) szatan | : (rzecz.) zmora
bohemia : bohemia : (rzecz.) bohema
bohemians : bohemians : (rzecz.) bohema | : (rzecz.) cyganeria
boil : boil : (czas.) gotować | : (czas.) kipieć | : (czas.) przegotować | : (czas.) wrzeć | : (czas.) wygotować | : (czas.) wykipieć | : (czas.) zagotować | : (czas.) zakipieć | : (rzecz.) czyrak | : (rzecz.) pryszcz | : (rzecz.) wrzenie
boiler : boiler : (rzecz.) bojler | : (rzecz.) bulier | : (rzecz.) cukrownik | : (rzecz.) kocioł | : (rzecz.) kotłownia | : (rzecz.) warnik
boiler-maker : boiler-maker : (rzecz.) kotlarz
boiler-making : boiler-making : (rzecz.) kotlarstwo
boiler-room : boiler-room : (rzecz.) kotłownia
boiler-smith : boiler-smith : (rzecz.) kotlarz
boilermaker : boilermaker : (rzecz.) kotlarz
boiling : boiling : (rzecz.) gotowanie | : (rzecz.) wrzenie | : (rzecz.) wywarzenie
boiling-off : boiling-off : (rzecz.) odklejanie
boisterous : boisterous : (przym.) burzliwy | : (przym.) gwałtowny | : (przym.) hałaśliwy | : (przym.) niesforny | : (przym.) porywisty | : (przym.) zawadiacki
boisterousness : boisterousness : (rzecz.) burzliwość | : (rzecz.) gwałtowność | : (rzecz.) hałaśliwość | : (rzecz.) niesforność | : (rzecz.) zawadiactwo
bold : bold : (przym.) krzykliwy | : (przym.) odważny | : (przym.) półgruby | : (przym.) śmiały | : (przym.) tłusty | : (przym.) ufny | : (przym.) wyraźny | : (przym.) zuchwały
boldly : boldly : (przysł.) śmiało | : (przysł.) zuchwale
boldness : boldness : (rzecz.) śmiałość | : (rzecz.) zuchwałość
bole : bole : (rzecz.) bolus | : (rzecz.) pień | : (rzecz.) pulment | : (rzecz.) strzała
bolero : bolero : (rzecz.) bolero
boletus : boletus : (rzecz.) borowik | : (rzecz.) prawdziwek
bollard : bollard : (rzecz.) pachoł | : (rzecz.) pachołek | : (rzecz.) poler | : (rzecz.) słupek
bologna : bologna : (rzecz.) kiełbasa
bolometer : bolometer : (rzecz.) bolometr
boloney : boloney : (rzecz.) bolonek
bolshevism : bolshevism : (rzecz.) bolszewizm
bolster : bolster : (czas.) podpierać | : (rzecz.) oparcie | : (rzecz.) podgłówek | : (rzecz.) podkładka | : (rzecz.) podparcie | : (rzecz.) podpora | : (rzecz.) podtrzymka | : (rzecz.) poduszka | : (rzecz.) zagłówek
bolt : bolt : (czas.) czmychnąć | : (czas.) pytlować | : (czas.) rozbrykać | : (czas.) rzucać | : (czas.) rzucić | : (czas.) wpaść | : (czas.) wypaść | : (czas.) zaryglować | : (czas.) zasuwać | : (rzecz.) antaba | : (rzecz.) bolec | : (rzecz.) drapak | : (rzecz.) drapnięcie | : (rzecz.) rygiel | : (rzecz.) strzała | : (rzecz.) sworzeń | : (rzecz.) ucieczka | : (rzecz.) wypad | : (rzecz.) zasuwa | : (rzecz.) zasuwka
bolt-rope : bolt-rope : (rzecz.) liklina
bolter : bolter : (rzecz.) przesiewacz | : (rzecz.) pytel | : (rzecz.) sito
bolting : bolting : (rzecz.) odsiewanie | : (rzecz.) przesiewanie | : (rzecz.) pytlowanie
bomb : bomb : (czas.) bombardować | : (czas.) zbombardować | : (rzecz.) bomba | : (rzecz.) pocisk
bomb-shell : bomb-shell : (rzecz.) szrapnel
bomb-shelter : bomb-shelter : (rzecz.) schron
bombard : bombard : (czas.) bombardować | : (czas.) ostrzeliwać | : (czas.) zarzucać
bombardier : bombardier : (rzecz.) bombardier
bombardment : bombardment : (rzecz.) bombardowanie
bombast : bombast : (rzecz.) napuszoność | : (rzecz.) patetyczność
bombastic : bombastic : (przym.) bombastyczny | : (przym.) pompatyczny
bomber : bomber : (rzecz.) bombowiec | : (rzecz.) szturmowiec | : (rzecz.) zamachowiec
bombing : bombing : (rzecz.) bombardowanie
bombshell : bombshell : (rzecz.) bomba | : (rzecz.) seksbomba | : (rzecz.) sensacja | : (rzecz.) szrapnel
bona-fide : bona-fide : (przym.) prawdziwy | : (przym.) szczery
bonanza : bonanza : (rzecz.) pomyślność | : (rzecz.) szczęście
bonbon : bonbon : (rzecz.) cukierek | : (rzecz.) czekoladka
bond : bond : (czas.) spajać | : (rzecz.) bon | : (rzecz.) cyrograf | : (rzecz.) kajdany | : (rzecz.) kaucja | : (rzecz.) obligacja | : (rzecz.) weksel | : (rzecz.) wiązanie | : (rzecz.) więź | : (rzecz.) zastaw | : (rzecz.) złącze | : (rzecz.) zobowiązanie | : (rzecz.) związek
bondage : bondage : (rzecz.) niewola | : (rzecz.) niewolnictwo
bonded : bonded : (przym.) wolnocłowy
bonder : bonder : (rzecz.) składowisko
bonding : bonding : (rzecz.) klejenie | : (rzecz.) łączenie | : (rzecz.) spajanie | : (rzecz.) wiązanie
bondsman : bondsman : (rzecz.) gwarant | : (rzecz.) niewolnik | : (rzecz.) poręczyciel
bone : bone : (rzecz.) gnat | : (rzecz.) kość | : (rzecz.) ość | : (rzecz.) szpik
bone-shaker : bone-shaker : (rzecz.) gruchot
bonehead : bonehead : (rzecz.) bałwan | : (rzecz.) głupiec | : (rzecz.) tępak
boneless : boneless : (przym.) bezkostny
boner : boner : (rzecz.) gafa
boneshaker : boneshaker : (rzecz.) gruchot
bonfire : bonfire : (rzecz.) ognisko | : (rzecz.) sobótka | : (rzecz.) stos
bonhomie : bonhomie : (rzecz.) dobroduszność
boning : boning : (rzecz.) filetowanie
bonnet : bonnet : (rzecz.) czapka | : (rzecz.) czepek | : (rzecz.) maska | : (rzecz.) nakładka | : (rzecz.) osłona | : (rzecz.) pokrywa
bonny : bonny : (przym.) piękny | : (przym.) powabny | : (przym.) sympatyczny | : (przym.) urodziwy
bonnyclabber : bonnyclabber : (rzecz.) twaróg
bono : bono : (rzecz.) piękność
bonus : bonus : (rzecz.) dodatek | : (rzecz.) premia | : (rzecz.) tantiema
bony : bony : (przym.) kościsty | : (przym.) ościsty
bonze : bonze : (rzecz.) bonza
boob : boob : (rzecz.) cycek | : (rzecz.) głupek | : (rzecz.) głupstwo | : (rzecz.) prostak | : (rzecz.) wpadka
booby : booby : (rzecz.) cymbał | : (rzecz.) dureń | : (rzecz.) głupek | : (rzecz.) prostak | : (rzecz.) tępak
booby-trap : booby-trap : (rzecz.) pułapka
boodle : boodle : (rzecz.) forsa
booed : booed : (przym.) wygwizdany
boohoo : boohoo : (czas.) buczeć
booing : booing : (czas.) szykanować | : (czas.) wygwizdywać | : (rzecz.) wygwizdanie
book : book : (czas.) księgować | : (czas.) rezerwować | : (czas.) zapisywać | : (czas.) zarezerwować | : (rzecz.) egzemplarz | : (rzecz.) książka | : (rzecz.) księga | : (rzecz.) notatnik
book-keeping : book-keeping : (rzecz.) buchalteria | : (rzecz.) księgowość | : (rzecz.) rachunkowość
book-lover : book-lover : (rzecz.) bibliofil
book-mark : book-mark : (rzecz.) zakładka
book-rest : book-rest : (rzecz.) pulpit
book-shop : book-shop : (rzecz.) księgarnia
bookbinder : bookbinder : (rzecz.) introligator
bookbindery : bookbindery : (rzecz.) introligatornia | : (rzecz.) introligatorstwo
bookbinding : bookbinding : (rzecz.) bindowanie | : (rzecz.) introligatorstwo
bookcase : bookcase : (rzecz.) biblioteczka | : (rzecz.) szafa
booking : booking : (rzecz.) bukowanie | : (rzecz.) przedsprzedaż | : (rzecz.) rezerwacja | : (rzecz.) rezerwowanie | : (rzecz.) zarezerwowanie
bookish : bookish : (przym.) książkowy | : (przym.) naukowy
bookkeeper : bookkeeper : (rzecz.) buchalter
bookkeeping : bookkeeping : (rzecz.) buchalteria | : (rzecz.) księgowość | : (rzecz.) rachunkowość
booklet : booklet : (rzecz.) broszura | : (rzecz.) pamflet
bookmaker : bookmaker : (rzecz.) bukmacher | : (rzecz.) pośrednik
bookmark : bookmark : (rzecz.) zakładka
bookplate : bookplate : (rzecz.) ekslibris
bookseller : bookseller : (rzecz.) księgarz
bookselling : bookselling : (rzecz.) księgarstwo
bookshelf : bookshelf : (rzecz.) półka | : (rzecz.) regał
bookshop : bookshop : (rzecz.) antykwariat | : (rzecz.) księgarnia
bookstall : bookstall : (rzecz.) kiosk
bookstand : bookstand : (rzecz.) regał
bookstore : bookstore : (rzecz.) księgarnia
boom : boom : (rzecz.) bariera | : (rzecz.) bom | : (rzecz.) buczenie | : (rzecz.) grzmot | : (rzecz.) hossa | : (rzecz.) huk | : (rzecz.) łoskot | : (rzecz.) maszt | : (rzecz.) ożywienie | : (rzecz.) podłużnica | : (rzecz.) pogłos | : (rzecz.) rozkwit | : (rzecz.) wysięgnik | : (rzecz.) wzrost
boomerang : boomerang : (rzecz.) bumerang
booming : booming : (przym.) gromki
boon : boon : (przym.) miły | : (rzecz.) dar | : (rzecz.) łaska
boor : boor : (rzecz.) cham | : (rzecz.) gbur | : (rzecz.) grubianin | : (rzecz.) ordynus | : (rzecz.) prostak
boorish : boorish : (przym.) chamski | : (przym.) gburowaty | : (przym.) grubiański | : (przym.) prostacki
boorishness : boorishness : (rzecz.) chamstwo | : (rzecz.) gburowatość
boos : boos : (rzecz.) wygwizdanie
boost : boost : (czas.) forsować | : (czas.) ożywić | : (czas.) pobudzać | : (czas.) pobudzić | : (czas.) podnosić | : (czas.) podsadzać | : (czas.) rozreklamować | : (czas.) stymulować | : (czas.) wzmagać | : (czas.) zwiększać | : (rzecz.) ożywienie | : (rzecz.) pobudzenie | : (rzecz.) wzmożenie | : (rzecz.) wzrost
booster : booster : (rzecz.) buster | : (rzecz.) pobudza | : (rzecz.) przyspieszacz | : (rzecz.) zachwalacz
boot : boot : (czas.) inicjować | : (czas.) ładować | : (rzecz.) bagażnik | : (rzecz.) but | : (rzecz.) inicjowanie | : (rzecz.) koszulka | : (rzecz.) kozaczek
boot-up : boot-up : (rzecz.) rozruch
bootblack : bootblack : (rzecz.) czyścibut | : (rzecz.) pucybut
booth : booth : (rzecz.) budka | : (rzecz.) kabina | : (rzecz.) kram | : (rzecz.) stragan | : (rzecz.) szałas
bootlace : bootlace : (rzecz.) sznurowadło
bootleg : bootleg : (rzecz.) cholewa
bootless : bootless : (przym.) daremny
bootlicker : bootlicker : (rzecz.) lizus
boots : boots : (rzecz.) buty
bootstrap : bootstrap : (rzecz.) inicjowanie | : (rzecz.) ładowanie | : (rzecz.) ładunek
booty : booty : (rzecz.) łup | : (rzecz.) zdobycz | : (rzecz.) zysk
booze : booze : (czas.) chlać | : (czas.) popijać | : (czas.) upić | : (czas.) zakrapiać | : (rzecz.) alkohol | : (rzecz.) gorzała | : (rzecz.) gorzałka | : (rzecz.) trunek
boozer : boozer : (rzecz.) alkoholik | : (rzecz.) knajpa | : (rzecz.) ochlapus | : (rzecz.) oliwa | : (rzecz.) pijus
boozy : boozy : (przym.) alkoholowy
bop : bop : (rzecz.) taniec
borage : borage : (rzecz.) ogórecznik
borate : borate : (rzecz.) boran
borax : borax : (rzecz.) boraks | : (rzecz.) tynkal
borazon : borazon : (rzecz.) borazon
border : border : (czas.) bramować | : (czas.) dziergać | : (czas.) graniczyć | : (czas.) obrastać | : (czas.) obrysować | : (czas.) obrzeżać | : (czas.) okalać | : (czas.) okantować | : (czas.) sąsiadować | : (rzecz.) banda | : (rzecz.) bramowanie | : (rzecz.) brzeg | : (rzecz.) granica | : (rzecz.) kordon | : (rzecz.) kraniec | : (rzecz.) krawędź | : (rzecz.) lamówka | : (rzecz.) miedza | : (rzecz.) oblamowanie | : (rzecz.) obramowanie | : (rzecz.) obrzeże | : (rzecz.) obwódka | : (rzecz.) ograniczenie | : (rzecz.) rabata | : (rzecz.) rąbek | : (rzecz.) rubież | : (rzecz.) skraj
borderer : borderer : (rzecz.) kresowiec | : (rzecz.) ogranicznik | : (rzecz.) sąsiad
borderland : borderland : (rzecz.) kres | : (rzecz.) pogranicze
borderline : borderline : (rzecz.) granica | : (rzecz.) światło | : (rzecz.) wiercenie
bore : bore : (czas.) drążyć | : (czas.) dziurawić | : (czas.) nawiercić | : (czas.) nudzić | : (czas.) odwiercić | : (czas.) świdrować | : (czas.) wiercić | : (czas.) zamęczać | : (czas.) zanudzać | : (rzecz.) niedźwiedź | : (rzecz.) nudziarstwo | : (rzecz.) nudziarz | : (rzecz.) odwiert | : (rzecz.) otwór | : (rzecz.) wiercenie
bore-hole : bore-hole : (rzecz.) odwiert
boreal : boreal : (przym.) borealny | : (przym.) północny
bored : bored : (czas.) nudzić | : (przym.) znudzony
boredom : boredom : (rzecz.) nuda | : (rzecz.) nudzenie | : (rzecz.) zblazowanie | : (rzecz.) znudzenie
borehole : borehole : (czas.) przewietrzać | : (rzecz.) odwiert
borer : borer : (rzecz.) kornik | : (rzecz.) świder | : (rzecz.) wiertacz | : (rzecz.) wytaczarka
boric : boric : (przym.) borny | : (przym.) borowy
boride : boride : (rzecz.) borek
boring : boring : (przym.) nudny | : (rzecz.) nudzenie | : (rzecz.) wiercenie | : (rzecz.) zanudzenie
boring-machine : boring-machine : (rzecz.) wiertarka
borings : borings : (przym.) zwierciny
born : born : (czas.) narodzić | : (czas.) urodzić | : (czas.) wykluć | : (przym.) wierutny
boron : boron : (rzecz.) bor
borough : borough : (rzecz.) miasteczko | : (rzecz.) miasto | : (rzecz.) miejscowość
borrow : borrow : (czas.) pożyczać | : (czas.) pożyczyć | : (czas.) wypożyczać | : (czas.) zapożyczać
borrower : borrower : (rzecz.) dłużnik | : (rzecz.) kredytobiorca | : (rzecz.) pożyczkobiorca
borrowing : borrowing : (rzecz.) pożyczanie | : (rzecz.) zapożyczanie | : (rzecz.) zapożyczenie
borsch : borsch : (rzecz.) barszcz
borscht : borscht : (rzecz.) barszcz
borstal : borstal : (rzecz.) poprawczak
boscage : boscage : (rzecz.) gaik | : (rzecz.) gąszcz | : (rzecz.) gęstwina
bosh : bosh : (rzecz.) nonsens
bosom : bosom : (rzecz.) łono | : (rzecz.) pierś | : (rzecz.) zanadrze
bosoms : bosoms : (rzecz.) biust | : (rzecz.) łono
boson : boson : (rzecz.) bozon
boss : boss : (czas.) dominować | : (czas.) kierować | : (czas.) rządzić | : (rzecz.) brosza | : (rzecz.) gospodarz | : (rzecz.) kierownik | : (rzecz.) nadlew | : (rzecz.) piasta | : (rzecz.) pryncypał | : (rzecz.) szef | : (rzecz.) szefostwo | : (rzecz.) wypuklina | : (rzecz.) występ | : (rzecz.) zgrubienie
boss-eyed : boss-eyed : (przym.) zezowaty
bossed : bossed : (przym.) guzowaty
bossy : bossy : (przym.) apodyktyczny | : (przym.) władczy
botanic : botanic : (przym.) botaniczny
botanical : botanical : (przym.) botaniczny
botanically : botanically : (przysł.) botanicznie
botanist : botanist : (rzecz.) botanik | : (rzecz.) botanika
botany : botany : (rzecz.) botanika
botch : botch : (czas.) knocić | : (czas.) sfuszerować | : (czas.) spartaczyć | : (rzecz.) partactwo | : (rzecz.) partanina
botching : botching : (rzecz.) knocenie
both : both : (przysł.) zarówno
bother : bother : (czas.) dręczyć | : (czas.) kłopotać | : (czas.) martwić | : (czas.) molestować | : (czas.) niepokoić | : (czas.) przeszkadzać | : (czas.) trudzić | : (czas.) zawracać | : (rzecz.) dokuczanie | : (rzecz.) fatygowanie | : (rzecz.) kłopot | : (rzecz.) molestowanie | : (rzecz.) naprzykrzanie | : (rzecz.) niepokój | : (rzecz.) przejmowanie | : (rzecz.) przeszkadzanie | : (rzecz.) zmartwienie
bothering : bothering : (rzecz.) nurtowanie | : (rzecz.) trudzenie
bothersome : bothersome : (przym.) dokuczliwy | : (przym.) kłopotliwy
bottle : bottle : (czas.) butelkować | : (rzecz.) bławatek | : (rzecz.) butelka | : (rzecz.) flakon | : (rzecz.) flakonik | : (rzecz.) flaszka | : (rzecz.) manierka | : (rzecz.) szklanka | : (rzecz.) wiązka
bottle-gourd : bottle-gourd : (rzecz.) tykwa
bottleneck : bottleneck : (rzecz.) zator
bottler : bottler : (rzecz.) rozlewacz | : (rzecz.) rozlewnia
bottling : bottling : (rzecz.) butelkowanie | : (rzecz.) rozlewnia
bottom : bottom : (rzecz.) dno | : (rzecz.) dół | : (rzecz.) pupa | : (rzecz.) siedzenie | : (rzecz.) spód | : (rzecz.) szuflada | : (rzecz.) tyłek | : (rzecz.) wylew
bottom-up : bottom-up : (przym.) oddolny | : (przym.) wstępujący
bottoming : bottoming : (rzecz.) dno | : (rzecz.) dół
bottomless : bottomless : (przym.) bezdenny | : (przym.) niezgłębiony
botulism : botulism : (rzecz.) botulizm
boudoir : boudoir : (rzecz.) buduar
bough : bough : (rzecz.) broń | : (rzecz.) gałąź | : (rzecz.) konar
bouillon : bouillon : (rzecz.) bulion | : (rzecz.) rosół
boulder : boulder : (rzecz.) głaz | : (rzecz.) okrąglak | : (rzecz.) otoczak
boulevard : boulevard : (rzecz.) bulwar | : (rzecz.) ulica
bounce : bounce : (czas.) blagować | : (czas.) odbijać | : (czas.) odskoczyć | : (czas.) podrzucać | : (czas.) podskakiwać | : (czas.) wlatywać | : (rzecz.) chełpliwość | : (rzecz.) energia | : (rzecz.) odbicie
bouncer : bouncer : (rzecz.) blagier | : (rzecz.) bramka | : (rzecz.) bramkarz | : (rzecz.) wykidajło
bouncing : bouncing : (przym.) energiczny | : (przym.) krzepki | : (przym.) żywy
bouncy : bouncy : (przym.) energiczny
bound : bound : (czas.) dziabać | : (czas.) odskakiwać | : (czas.) ograniczać | : (czas.) ograniczyć | : (czas.) skakać | : (czas.) związać | : (przym.) oprawny | : (rzecz.) granica | : (rzecz.) odskok | : (rzecz.) skok | : (rzecz.) związanie
boundary : boundary : (rzecz.) granica | : (rzecz.) rubież
bounded : bounded : (przym.) odgraniczony | : (przym.) ograniczony
bounder : bounder : (rzecz.) kanalia
bounding : bounding : (rzecz.) podskakiwanie
boundless : boundless : (przym.) bezgraniczny | : (przym.) bezkresny | : (przym.) nieograniczony | : (przym.) niezmierny
boundlessly : boundlessly : (przysł.) bezgranicznie
boundlessness : boundlessness : (rzecz.) bezkres | : (rzecz.) bezmiar | : (rzecz.) nieograniczoność
bounds : bounds : (rzecz.) miedza
bounteous : bounteous : (przym.) hojny | : (przym.) obfity | : (przym.) szczodry
bountiful : bountiful : (przym.) hojny | : (przym.) obfity
bounty : bounty : (rzecz.) dar | : (rzecz.) hojność | : (rzecz.) laska | : (rzecz.) premia | : (rzecz.) szczodrość
bouquet : bouquet : (rzecz.) bukiet | : (rzecz.) wiązka
bourgeois : bourgeois : (przym.) burżuazyjny | : (rzecz.) burgos | : (rzecz.) burżuj
bourgeoisie : bourgeoisie : (rzecz.) burżuazja | : (rzecz.) mieszczaństwo
bourn : bourn : (rzecz.) granica | : (rzecz.) meta | : (rzecz.) potok
bourse : bourse : (rzecz.) giełda
bout : bout : (rzecz.) atak | : (rzecz.) napad
boutique : boutique : (rzecz.) butik | : (rzecz.) sklep
boutonniere : boutonniere : (rzecz.) butonierka
bovine : bovine : (przym.) bydlęcy | : (przym.) powolny | : (przym.) wolowaty | : (przym.) wołowy
bow : bow : (czas.) chylić | : (czas.) czapkować | : (czas.) kłaniać | : (czas.) pokłonić | : (czas.) skłaniać | : (czas.) ugiąć | : (czas.) ukłonić | : (czas.) zginać | : (rzecz.) dziób | : (rzecz.) kabłąk | : (rzecz.) kokarda | : (rzecz.) łuk | : (rzecz.) pałąk | : (rzecz.) pokłon | : (rzecz.) smyczek | : (rzecz.) ukłon | : (rzecz.) wygięcie
bow-legged : bow-legged : (przym.) krzywonogi | : (przym.) pałąkowaty
bow-tie : bow-tie : (rzecz.) muszka
bowdlerize : bowdlerize : (czas.) okrajać
bowel : bowel : (rzecz.) jelito | : (rzecz.) kiszka
bowels : bowels : (rzecz.) trzewia | : (rzecz.) wnętrzności
bower : bower : (rzecz.) altana | : (rzecz.) dacza | : (rzecz.) łucznik
bowing : bowing : (rzecz.) chylenie | : (rzecz.) nachylanie | : (rzecz.) schylanie | : (rzecz.) schylenie
bowknot : bowknot : (rzecz.) kokarda
bowl : bowl : (czas.) toczyć | : (czas.) zaserwować | : (rzecz.) czara | : (rzecz.) czarka | : (rzecz.) donica | : (rzecz.) flakon | : (rzecz.) kula | : (rzecz.) lulka | : (rzecz.) miednica | : (rzecz.) misa | : (rzecz.) miseczka | : (rzecz.) miska | : (rzecz.) panew | : (rzecz.) puchar | : (rzecz.) salaterka | : (rzecz.) stadion | : (rzecz.) waza | : (rzecz.) wazon
bowlegged : bowlegged : (przym.) pałąkowaty
bowler : bowler : (rzecz.) gracz | : (rzecz.) kręglarz | : (rzecz.) melonik | : (rzecz.) zawodnik
bowline : bowline : (rzecz.) bulina
bowling : bowling : (rzecz.) kręgiel | : (rzecz.) kręgielnia
bowman : bowman : (rzecz.) łucznik
bowsprit : bowsprit : (rzecz.) bukszpryt | : (rzecz.) dziobnik
bowstring : bowstring : (rzecz.) cięciwa | : (rzecz.) ściąg
bowtie : bowtie : (rzecz.) muszka
bowyer : bowyer : (rzecz.) łucznik
box : box : (czas.) boksować | : (czas.) odosobnić | : (czas.) uderzać | : (rzecz.) boks | : (rzecz.) buda | : (rzecz.) bukszpan | : (rzecz.) loża | : (rzecz.) pudełeczko | : (rzecz.) pudełko | : (rzecz.) pudło | : (rzecz.) puzderko | : (rzecz.) ramka | : (rzecz.) skrzynia | : (rzecz.) skrzynka | : (rzecz.) uderzenie
box-office : box-office : (rzecz.) kasa
box-pleat : box-pleat : (rzecz.) kontrafałda
boxcar : boxcar : (rzecz.) fura | : (rzecz.) furgon
boxer : boxer : (rzecz.) bokser | : (rzecz.) kasiarz | : (rzecz.) pięściarz
boxes : boxes : (rzecz.) boksowanie | : (rzecz.) przełącznica
boxful : boxful : (rzecz.) pudełko
boxing : boxing : (rzecz.) boks | : (rzecz.) pięściarstwo
boxwood : boxwood : (rzecz.) bukszpan
boy : boy : (rzecz.) chłopak | : (rzecz.) chłopczyk | : (rzecz.) chłopiec | : (rzecz.) malec | : (rzecz.) piesek | : (rzecz.) syn
boyar : boyar : (rzecz.) bojar
boycott : boycott : (czas.) bojkotować | : (czas.) zbojkotować | : (rzecz.) bojkot
boyfriend : boyfriend : (rzecz.) chłopak | : (rzecz.) chłopiec | : (rzecz.) kolega | : (rzecz.) przyjaciel | : (rzecz.) sympatia
boyhood : boyhood : (rzecz.) chłopięctwo
boyish : boyish : (przym.) chłopięcy
bozo : bozo : (rzecz.) małpolud
bra : bra : (rzecz.) biustonosz | : (rzecz.) stanik
brace : brace : (czas.) kotwić | : (czas.) przytwierdzać | : (czas.) spiąć | : (czas.) wzmacniać | : (czas.) zabetonować | : (rzecz.) klamerka | : (rzecz.) klamra | : (rzecz.) nawias | : (rzecz.) podpora | : (rzecz.) stadło | : (rzecz.) świder | : (rzecz.) wiązadło
bracelet : bracelet : (rzecz.) bransoleta | : (rzecz.) bransoletka
braces : braces : (rzecz.) szelki
brachial : brachial : (przym.) barkowy | : (przym.) ramieniowy | : (przym.) ramienny
brachium : brachium : (rzecz.) konar
bracing : bracing : (przym.) rześki | : (rzecz.) obetonowanie | : (rzecz.) usztywnianie | : (rzecz.) wzmacnianie
bracken : bracken : (rzecz.) wspornik
bracket : bracket : (rzecz.) kinkiet | : (rzecz.) klamra | : (rzecz.) konsola | : (rzecz.) kroksztyn | : (rzecz.) nawias | : (rzecz.) podpórka | : (rzecz.) wspornik
brad : brad : (rzecz.) sztyft
bradawl : bradawl : (rzecz.) szydło
brae : brae : (rzecz.) stok
brag : brag : (czas.) chełpić | : (czas.) chwalić | : (czas.) łgać | : (czas.) obszywać | : (czas.) przechwalać | : (czas.) splatać | : (rzecz.) plecionka | : (rzecz.) przechwałka | : (rzecz.) samochwalstwo | : (rzecz.) sznur | : (rzecz.) warkocz
braggart : braggart : (rzecz.) blagier | : (rzecz.) chwalipięta | : (rzecz.) samochwała
bragging : bragging : (rzecz.) chełpienie | : (rzecz.) przechwalanie | : (rzecz.) samochwalstwo
braid : braid : (czas.) galonować | : (czas.) oplatać | : (czas.) splatać | : (czas.) szamerować | : (czas.) wplatać | : (rzecz.) oplot | : (rzecz.) splot | : (rzecz.) szamerowanie | : (rzecz.) szamerunek | : (rzecz.) warkocz
braider : braider : (rzecz.) oplatarka
braiding : braiding : (rzecz.) oplatanie | : (rzecz.) oplot | : (rzecz.) plecenie
brail : brail : (rzecz.) gejtawa | : (rzecz.) orczyk
brain : brain : (czas.) rozwalać | : (rzecz.) móżdżek | : (rzecz.) mózg | : (rzecz.) mózgowie | : (rzecz.) mózgownica | : (rzecz.) rozum | : (rzecz.) umysł
brainless : brainless : (przym.) bałwański | : (przym.) bezgłowy | : (przym.) bezmózgi | : (przym.) idiotyczny
brains : brains : (rzecz.) rozum
brainstorm : brainstorm : (rzecz.) zaćmienie
brainwash : brainwash : (czas.) nakłaniać | : (czas.) perswadować | : (czas.) skłaniać | : (czas.) skłonić
brainwave : brainwave : (rzecz.) natchnienie | : (rzecz.) olśnienie
brainy : brainy : (przym.) bystry | : (przym.) mądry | : (przym.) rozgarnięty
braise : braise : (czas.) dusić
braised : braised : (przym.) duszony
brake : brake : (czas.) hamować | : (czas.) wyhamować | : (rzecz.) gęstwa | : (rzecz.) hamulec | : (rzecz.) międlica | : (rzecz.) ograniczenie
braking : braking : (rzecz.) hamowanie
bramble : bramble : (rzecz.) jeżyna
bran : bran : (rzecz.) otręby
branch : branch : (czas.) odgałęziać | : (czas.) rozchodzić | : (czas.) rozgałęziać | : (czas.) rozwidlać | : (rzecz.) ajencja | : (rzecz.) branża | : (rzecz.) dyscyplina | : (rzecz.) dział | : (rzecz.) ekspozytura | : (rzecz.) filia | : (rzecz.) gałąź | : (rzecz.) gałązka | : (rzecz.) konar | : (rzecz.) latorośl | : (rzecz.) oddział | : (rzecz.) odgałęzienie | : (rzecz.) odnoga | : (rzecz.) ramię | : (rzecz.) skok
branch-joint : branch-joint : (rzecz.) rozgałęźnik | : (rzecz.) rozwidlacz
branching : branching : (rzecz.) odgałęzienie | : (rzecz.) rozgałęzienie
branchy : branchy : (przym.) gałęzisty | : (przym.) rosochaty | : (przym.) rozłożysty
brand : brand : (czas.) napiętnować | : (czas.) piętnować | : (czas.) wryć | : (czas.) wypalać | : (czas.) znakować | : (rzecz.) gatunek | : (rzecz.) głownia | : (rzecz.) niedopałek | : (rzecz.) odmiana | : (rzecz.) ożóg | : (rzecz.) piętno | : (rzecz.) pochodnia | : (rzecz.) rodzaj | : (rzecz.) żagiew | : (rzecz.) zwarzenie
brand-name : brand-name : (przym.) markowy
branding : branding : (rzecz.) cechowanie | : (rzecz.) piętnowanie
brandish : brandish : (czas.) wymachiwać | : (czas.) wywijać
brandy : brandy : (rzecz.) Brendy | : (rzecz.) koniak | : (rzecz.) winiak | : (rzecz.) wódka
brash : brash : (przym.) arogancki | : (przym.) chełpliwy
brashness : brashness : (rzecz.) śmiałość | : (rzecz.) zuchwalstwo
brass : brass : (rzecz.) czelność | : (rzecz.) grosiwo | : (rzecz.) mosiądz | : (rzecz.) spiż
brassard : brassard : (rzecz.) naramiennik | : (rzecz.) odznaka | : (rzecz.) opaska
brassiere : brassiere : (rzecz.) biustonosz | : (rzecz.) stanik
brassy : brassy : (przym.) metaliczny | : (przym.) miedziany
brat : brat : (rzecz.) bachor | : (rzecz.) berbeć | : (rzecz.) dzieciak
brattice : brattice : (rzecz.) przegroda | : (rzecz.) przepierzenie
bravado : bravado : (rzecz.) brawura | : (rzecz.) ryzykanctwo | : (rzecz.) zuchwałość
brave : brave : (czas.) wyzywać | : (przym.) chrobry | : (przym.) dzielny | : (przym.) mężny | : (przym.) odważny | : (przym.) śmiały | : (przym.) waleczny | : (rzecz.) junak | : (rzecz.) wojownik
bravely : bravely : (przysł.) dzielnie | : (przysł.) nieustraszenie
bravery : bravery : (rzecz.) dzielność | : (rzecz.) męstwo | : (rzecz.) odwaga | : (rzecz.) śmiałość | : (rzecz.) waleczność
bravura : bravura : (rzecz.) brawura
brawl : brawl : (czas.) awanturować | : (czas.) chuliganić | : (czas.) rozrabiać | : (czas.) szaleć | : (czas.) warcholić | : (rzecz.) awantura | : (rzecz.) bijatyka | : (rzecz.) bitka | : (rzecz.) bójka | : (rzecz.) brewerie | : (rzecz.) burda | : (rzecz.) kłótnia | : (rzecz.) rozróba | : (rzecz.) rozróbka
brawler : brawler : (rzecz.) awanturnik | : (rzecz.) warchoł | : (rzecz.) zawadiaka
brawling : brawling : (rzecz.) rozrabianie | : (rzecz.) warcholstwo
brawn : brawn : (rzecz.) krzepa | : (rzecz.) salceson | : (rzecz.) tężyzna
brawny : brawny : (przym.) krzepki | : (przym.) mięsisty | : (przym.) muskularny | : (przym.) silny
bray : bray : (czas.) ryczeć | : (rzecz.) ryk
braying : braying : (rzecz.) ryk
braze : braze : (czas.) brązować | : (czas.) lutować
brazen : brazen : (przym.) bezczelny | : (przym.) bezwstydny | : (przym.) brązowy | : (przym.) mosiężny | : (przym.) możny | : (przym.) nachalny | : (przym.) spiżowy
brazen-faced : brazen-faced : (przym.) bezczelny | : (przym.) bezwstydny
brazenfaced : brazenfaced : (przym.) bezczelny | : (przym.) bezwstydny
brazenness : brazenness : (rzecz.) bezczelność | : (rzecz.) cynizm
brazier : brazier : (rzecz.) koksiak | : (rzecz.) kotlarz | : (rzecz.) mosiężnik
breach : breach : (czas.) naruszać | : (czas.) przełamywać | : (rzecz.) luka | : (rzecz.) naruszenie | : (rzecz.) pogwałcenie | : (rzecz.) przekroczenie | : (rzecz.) rozbrat | : (rzecz.) rozłam | : (rzecz.) wyłom | : (rzecz.) wyrwa | : (rzecz.) zerwanie | : (rzecz.) złamanie
breaching : breaching : (rzecz.) naruszenie | : (rzecz.) wyskakiwanie
bread : bread : (rzecz.) chleb | : (rzecz.) pieczywo | : (rzecz.) utrzymanie
bread-crumb : bread-crumb : (rzecz.) miękisz
bread-winner : bread-winner : (rzecz.) żywiciel
breadboard : breadboard : (rzecz.) deska | : (rzecz.) makieta
breadbox : breadbox : (rzecz.) chlebak
breadcrumb : breadcrumb : (rzecz.) miękisz
breadth : breadth : (rzecz.) rozmach | : (rzecz.) rozpiętość | : (rzecz.) szerokość
breadwinner : breadwinner : (rzecz.) chlebodawca | : (rzecz.) żywiciel
break : break : (czas.) łamać | : (czas.) nałamać | : (czas.) naruszyć | : (czas.) odłamać | : (czas.) odzwyczaić | : (czas.) pogruchotać | : (czas.) połamać | : (czas.) popsuć | : (czas.) porozbijać | : (czas.) przebić | : (czas.) przerywać | : (czas.) przetrącić | : (czas.) rozbić | : (czas.) rozbijać | : (czas.) rozmienić | : (czas.) rozrywać | : (czas.) skruszyć | : (czas.) tłuc | : (czas.) ujeździć | : (czas.) włamać | : (czas.) wyłamać | : (czas.) wyrwać | : (czas.) zdekompletować | : (czas.) zepsuć | : (czas.) złamać | : (czas.) zrywać | : (rzecz.) brek | : (rzecz.) bryczka | : (rzecz.) ferie | : (rzecz.) mutowanie | : (rzecz.) pauza | : (rzecz.) przejaśnienie | : (rzecz.) przerwa | : (rzecz.) przerwanie | : (rzecz.) rozbicie | : (rzecz.) rozbrat | : (rzecz.) stłuc | : (rzecz.) urlop | : (rzecz.) wyłom | : (rzecz.) wytchnienie | : (rzecz.) załam | : (rzecz.) załamanie | : (rzecz.) zerwanie | : (rzecz.) złamanie
break-down : break-down : (rzecz.) defekt
break-in : break-in : (rzecz.) docieranie | : (rzecz.) włamanie | : (rzecz.) wtargnięcie
break-over : break-over : (rzecz.) przełączenie | : (rzecz.) przerzut
break-up : break-up : (rzecz.) rozdrabnianie | : (rzecz.) rozdrobnienie | : (rzecz.) rozpad | : (rzecz.) upadek | : (rzecz.) zakończenie
breakable : breakable : (przym.) kruchy | : (przym.) łamliwy
breakage : breakage : (rzecz.) burzenie | : (rzecz.) łamanie | : (rzecz.) stłuczka | : (rzecz.) złamanie
breakdown : breakdown : (rzecz.) awaria | : (rzecz.) klęska | : (rzecz.) niepowodzenie | : (rzecz.) przebicie | : (rzecz.) rozpad | : (rzecz.) upadek | : (rzecz.) załamanie | : (rzecz.) zerwanie | : (rzecz.) zestawienie
breaker : breaker : (rzecz.) łamacz | : (rzecz.) przerywacz | : (rzecz.) wyłącznik
breakfast : breakfast : (rzecz.) śniadanie
breakfasting : breakfasting : (rzecz.) śniadanie
breaking : breaking : (rzecz.) dyftongizacja | : (rzecz.) łamanie | : (rzecz.) naruszenie | : (rzecz.) przerywanie | : (rzecz.) rozbicie | : (rzecz.) rozbijanie | : (rzecz.) rozrywanie | : (rzecz.) targ | : (rzecz.) urabianie | : (rzecz.) włamanie | : (rzecz.) żyłowanie
breakneck : breakneck : (przym.) karkołomny | : (przym.) zawrotny
breakout : breakout : (rzecz.) przełamanie | : (rzecz.) wyrzucie | : (rzecz.) wyrzut
breakthrough : breakthrough : (rzecz.) przebicie | : (rzecz.) przecinka | : (rzecz.) przełom | : (rzecz.) wyłom
breakwater : breakwater : (rzecz.) falochron | : (rzecz.) molo
bream : bream : (rzecz.) leszcz
breast : breast : (rzecz.) biust | : (rzecz.) pierś | : (rzecz.) przodek | : (rzecz.) sutek | : (rzecz.) sutka
breast-bone : breast-bone : (rzecz.) mostek
breast-stroke : breast-stroke : (rzecz.) żabka
breastbone : breastbone : (rzecz.) mostek
breasts : breasts : (rzecz.) biust
breaststroke : breaststroke : (rzecz.) żabka
breastwork : breastwork : (rzecz.) balustrada | : (rzecz.) parapet | : (rzecz.) przedpiersie
breath : breath : (rzecz.) dech | : (rzecz.) oddech | : (rzecz.) powiew | : (rzecz.) tchnięcie | : (rzecz.) tchnienie | : (rzecz.) zadyszenie
breathalyser : breathalyser : (rzecz.) alkomat
breathalyzer : breathalyzer : (rzecz.) alkomat
breathe : breathe : (czas.) chuchać | : (czas.) dychać | : (czas.) oddychać | : (czas.) tchnąć | : (czas.) wdychać
breather : breather : (rzecz.) odpowietrznik
breathing : breathing : (rzecz.) oddech | : (rzecz.) oddychanie | : (rzecz.) westchnienie
breathing-space : breathing-space : (rzecz.) pauza | : (rzecz.) przerwa
breathless : breathless : (przym.) zdyszany
breathlessness : breathlessness : (rzecz.) nierównowaga | : (rzecz.) zadyszka
breech : breech : (rzecz.) pośladek | : (rzecz.) siedzenie | : (rzecz.) tyłek | : (rzecz.) zamek
breech-block : breech-block : (rzecz.) zamek
breeches : breeches : (rzecz.) bryczesy | : (rzecz.) spodnie
breed : breed : (czas.) hodować | : (czas.) plenić | : (czas.) rodzić | : (czas.) rozmnażać | : (rzecz.) rasa
breeder : breeder : (rzecz.) hodowca | : (rzecz.) reproduktor
breeding : breeding : (rzecz.) chów | : (rzecz.) hodowanie | : (rzecz.) hodowla | : (rzecz.) kojarzenie | : (rzecz.) powielanie | : (rzecz.) rozpłód | : (rzecz.) wychowanie
breeze : breeze : (rzecz.) bąk | : (rzecz.) bryza | : (rzecz.) łatwizna | : (rzecz.) powiew | : (rzecz.) wiaterek | : (rzecz.) wicherek | : (rzecz.) wietrzyk
breeze^ : breeze^ : (rzecz.) wietrzyk
breezeblock : breezeblock : (rzecz.) pustak
breeziness : breeziness : (rzecz.) animusz | : (rzecz.) wietrzność
breezy : breezy : (przym.) wietrzny | : (przym.) żwawy
brevet : brevet : (rzecz.) awans | : (rzecz.) mianowanie
breveted : breveted : (czas.) awansować | : (czas.) promować | : (rzecz.) awans
breviary : breviary : (rzecz.) brewiarz
brevity : brevity : (rzecz.) krótkość | : (rzecz.) krótkotrwałość | : (rzecz.) skrót | : (rzecz.) treściwość | : (rzecz.) zwięzłość
brew : brew : (czas.) parzyć | : (czas.) warzyć | : (rzecz.) browar | : (rzecz.) napar | : (rzecz.) piwo
brewer : brewer : (rzecz.) piwowar
brewery : brewery : (rzecz.) browar
brewing : brewing : (rzecz.) browarnictwo | : (rzecz.) piwowarstwo | : (rzecz.) warzenie | : (rzecz.) wywar
briar : briar : (rzecz.) wrzosiec
bribe : bribe : (czas.) korumpować | : (czas.) podkupić | : (czas.) przekupić | : (czas.) przekupywać | : (rzecz.) łapówka
briber : briber : (rzecz.) łapówkarz
bribery : bribery : (rzecz.) łapówkarstwo | : (rzecz.) łapownictwo | : (rzecz.) przekupstwo
bribing : bribing : (rzecz.) łapownictwo
bric-a-brac : bric-a-brac : (rzecz.) bibelot | : (rzecz.) starzyzna
brick : brick : (rzecz.) cegła | : (rzecz.) przyjaciel
brick-field : brick-field : (rzecz.) cegielnia
brick-red : brick-red : (przym.) ceglasty
brick-yard : brick-yard : (rzecz.) cegielnia
brickfield : brickfield : (rzecz.) cegielnia
bricklayer : bricklayer : (rzecz.) murarz
bricklayer's : bricklayer's : (przym.) murarski
bricklaying : bricklaying : (rzecz.) murarstwo | : (rzecz.) murowanie
brickwork : brickwork : (rzecz.) mur | : (rzecz.) murarstwo
brickyard : brickyard : (rzecz.) cegielnia
brickyards : brickyards : (rzecz.) cegielnia
bridal : bridal : (przym.) ślubny | : (przym.) weselny
bride : bride : (rzecz.) oblubienica
bridegroom : bridegroom : (rzecz.) nowożeniec | : (rzecz.) oblubieniec
bridesmaid : bridesmaid : (rzecz.) druhna | : (rzecz.) drużka
bridge : bridge : (rzecz.) brydż | : (rzecz.) kładka | : (rzecz.) most | : (rzecz.) mostek | : (rzecz.) pomost
bridgehead : bridgehead : (rzecz.) przyczółek
bridging : bridging : (przym.) pomostowy | : (rzecz.) mostkowanie | : (rzecz.) niwelowanie | : (rzecz.) pokonywanie
bridle : bridle : (czas.) kiełznać | : (czas.) okiełznać | : (czas.) pohamować | : (czas.) powstrzymać | : (rzecz.) cugle | : (rzecz.) uzda | : (rzecz.) wędzidełko
brief : brief : (przym.) krótki | : (przym.) zwięzły | : (rzecz.) akta | : (rzecz.) krótkotrwałość | : (rzecz.) podsumowanie | : (rzecz.) streszczenie
brief-case : brief-case : (rzecz.) teka
briefcase : briefcase : (rzecz.) aktówka | : (rzecz.) neseser | : (rzecz.) teczka | : (rzecz.) teka | : (rzecz.) walizka
briefer : briefer : (przym.) krótki | : (przym.) niski
briefing : briefing : (rzecz.) odprawa | : (rzecz.) pouczenie
briefly : briefly : (przysł.) krótko | : (przysł.) lakonicznie | : (przysł.) pokrótce | : (przysł.) szybko
briefness : briefness : (rzecz.) lakoniczność | : (rzecz.) zwięzłość
briefs : briefs : (rzecz.) majtki | : (rzecz.) slipki | : (rzecz.) slipy | : (rzecz.) spodenki
brig : brig : (rzecz.) bryg
brigade : brigade : (rzecz.) brygada
brigadier : brigadier : (rzecz.) brygadier
brigand : brigand : (rzecz.) bandyta | : (rzecz.) rozbójnik | : (rzecz.) zbój
brigandage : brigandage : (rzecz.) nożownictwo | : (rzecz.) zbójectwo | : (rzecz.) zbójnictwo
brigantine : brigantine : (rzecz.) brygantyna | : (rzecz.) szkuner-bryg
bright : bright : (przym.) błyskotliwy | : (przym.) bystry | : (przym.) inteligentny | : (przym.) jaskrawy | : (przym.) jasny | : (przym.) pogodny | : (przym.) promienny | : (przym.) światły | : (przym.) świetlany | : (przym.) świetlisty | : (przym.) wesoły | : (przym.) zdolny | : (przym.) żwawy | : (przym.) żywy
bright-yellow : bright-yellow : (przym.) kanarkowy
brighten : brighten : (czas.) oczyszczać | : (czas.) ożywiać | : (czas.) ożywić | : (czas.) pojaśnieć | : (czas.) rozjaśniać | : (czas.) rozjaśnić | : (czas.) rozpogadzać | : (czas.) rozweselać | : (czas.) upiększać | : (czas.) wypolerować
brightener : brightener : (rzecz.) wybłyszczacz
brighteners : brighteners : (rzecz.) rozjaśniacz
brightly : brightly : (przysł.) bystro | : (przysł.) jaskrawo | : (przysł.) jasno | : (przysł.) pogodnie
brightness : brightness : (rzecz.) blask | : (rzecz.) flara | : (rzecz.) jaskrawość | : (rzecz.) jasność | : (rzecz.) świetlistość
brilliance : brilliance : (rzecz.) blask | : (rzecz.) błyskotliwość | : (rzecz.) efektowność | : (rzecz.) luminancja | : (rzecz.) połyskiwanie | : (rzecz.) połyskliwość | : (rzecz.) świetlistość | : (rzecz.) świetność
brilliancy : brilliancy : (rzecz.) błyskotliwość | : (rzecz.) jasność
brilliant : brilliant : (przym.) błyskotliwy | : (przym.) błyszczący | : (przym.) cudowny | : (przym.) efektowny | : (przym.) fantastyczny | : (przym.) genialny | : (przym.) inteligentny | : (przym.) jaskrawy | : (przym.) jasny | : (przym.) kapitalny | : (przym.) olśniewający | : (przym.) znakomity | : (rzecz.) brylant
brilliantine : brilliantine : (rzecz.) brylantyna
brilliantly : brilliantly : (przysł.) błyskotliwie | : (przysł.) znakomicie
brim : brim : (rzecz.) brzeg | : (rzecz.) krawędź | : (rzecz.) rondo
brim-full : brim-full : (rzecz.) przepełnienie
brimful : brimful : (przym.) pełen
brimming : brimming : (przym.) pełny
brindled : brindled : (przym.) moręgowaty
brine : brine : (rzecz.) solanka
bring : bring : (czas.) przynieść | : (czas.) przynosić | : (czas.) przyprowadzać | : (czas.) przyprowadzić | : (czas.) przywieść | : (czas.) sprowadzać | : (czas.) wprawić | : (czas.) wwieźć | : (czas.) wwozić | : (czas.) wytoczyć
bringing : bringing : (rzecz.) donoszenie | : (rzecz.) doprowadzanie | : (rzecz.) dowiezienie | : (rzecz.) niesienie | : (rzecz.) przynoszenie | : (rzecz.) przyprowadzenie | : (rzecz.) przywiezienie | : (rzecz.) wnoszenie | : (rzecz.) zanoszenie
brining : brining : (rzecz.) solankowanie
brink : brink : (rzecz.) brzeg | : (rzecz.) krawędź | : (rzecz.) skraj
brinkmanship : brinkmanship : (rzecz.) ryzykanctwo
briny : briny : (rzecz.) morze
briquette : briquette : (rzecz.) brykiet
brisance : brisance : (rzecz.) kruszność
brisk : brisk : (przym.) dynamiczny | : (przym.) dziarski | : (przym.) energiczny | : (przym.) fertyczny | : (przym.) hoży | : (przym.) rączy | : (przym.) raźny | : (przym.) rześki | : (przym.) skoczny | : (przym.) zamaszysty | : (przym.) żwawy | : (przym.) żywy
brisket : brisket : (rzecz.) mostek | : (rzecz.) szponder
briskly : briskly : (przysł.) energicznie | : (przysł.) raźnie | : (przysł.) szybko | : (przysł.) żwawo | : (przysł.) żywo
briskness : briskness : (rzecz.) ożywienie | : (rzecz.) rześkość
bristle : bristle : (czas.) jeżyć | : (czas.) najeżyć | : (czas.) napuszyć | : (czas.) zjeżać | : (czas.) zjeżyć | : (rzecz.) szczecina
bristles : bristles : (rzecz.) szczecina
bristly : bristly : (przym.) szczeciniasty
bristol : bristol : (rzecz.) brystol
brittle : brittle : (przym.) kruchy | : (przym.) łamliwy
brittleness : brittleness : (rzecz.) kruchość | : (rzecz.) łamliwość
britzka : britzka : (rzecz.) bryczka
bro : bro : (rzecz.) brat
broach : broach : (czas.) nadbierać | : (czas.) napoczynać | : (czas.) obrócić | : (czas.) otworzyć | : (czas.) poruszać | : (czas.) przedstawiać | : (czas.) przedstawić | : (czas.) przedziurawiać | : (czas.) przedziurawić | : (rzecz.) przeciągacz | : (rzecz.) przepychacz | : (rzecz.) rożen | : (rzecz.) szydło
broaching : broaching : (rzecz.) obracanie | : (rzecz.) odciąga | : (rzecz.) rożen | : (rzecz.) wyciąganie | : (rzecz.) wydłużanie
broad : broad : (przym.) łasy | : (przym.) obszerny | : (przym.) ogólny | : (przym.) szeroki | : (przym.) wszechstronny
broad-minded : broad-minded : (przym.) liberalny | : (przym.) tolerancyjny
broad-shouldered : broad-shouldered : (przym.) barczysty
broadaxe : broadaxe : (rzecz.) toporek
broadband : broadband : (przym.) szerokopasmowy
broadcast : broadcast : (czas.) emitować | : (czas.) nadawać | : (czas.) rozprzestrzeniać | : (czas.) rozsypywać | : (czas.) transmitować | : (rzecz.) audycja | : (rzecz.) program | : (rzecz.) rozgłaszanie | : (rzecz.) transmisja
broadcaster : broadcaster : (rzecz.) dziennikarz | : (rzecz.) nadawca | : (rzecz.) prezenter | : (rzecz.) spiker
broadcasting : broadcasting : (przym.) nadawczy | : (przym.) radionadawczy | : (rzecz.) nadawanie | : (rzecz.) radiofonia | : (rzecz.) transmitowanie
broaden : broaden : (czas.) poszerzać | : (czas.) rozszerzać | : (czas.) rozszerzyć | : (czas.) wzmacniać
broadening : broadening : (rzecz.) poszerzanie | : (rzecz.) poszerzenie
broadly : broadly : (przysł.) ogólnie | : (przysł.) rozlegle | : (przysł.) wszechstronnie | : (przysł.) zasadniczo
broadminded : broadminded : (przym.) liberalny | : (przym.) tolerancyjny
broadside : broadside : (rzecz.) burta
broadtail : broadtail : (rzecz.) brajtszwanc
broadways : broadways : (przysł.) wszerz
brocade : brocade : (rzecz.) brokat
brocaded : brocaded : (przym.) brokatowy
broccoli : broccoli : (rzecz.) brokuły
brochure : brochure : (rzecz.) broszura | : (rzecz.) broszurka | : (rzecz.) folder | : (rzecz.) informator
broil : broil : (czas.) opiekać | : (czas.) przypiekać | : (czas.) smażyć | : (rzecz.) awantura | : (rzecz.) hałas | : (rzecz.) kłótnia | : (rzecz.) piec
broiler : broiler : (rzecz.) brojler | : (rzecz.) kurczak
broken : broken : (przym.) rozbity | : (przym.) zepsuty | : (przym.) złamany
brokenly : brokenly : (przysł.) nierówno
broker : broker : (rzecz.) faktor | : (rzecz.) makler | : (rzecz.) pośrednik
broker's : broker's : (przym.) brokerski
brokerage : brokerage : (rzecz.) działalność | : (rzecz.) maklerstwo
broking : broking : (rzecz.) maklerstwo | : (rzecz.) pośrednictwo
brolly : brolly : (rzecz.) parasol
bromide : bromide : (rzecz.) bromek
bromine : bromine : (rzecz.) brom
bronchial : bronchial : (przym.) oskrzelowy
bronchiole : bronchiole : (rzecz.) oskrzelik
bronchitis : bronchitis : (rzecz.) bronchit
bronchus : bronchus : (rzecz.) oskrzele
bronze : bronze : (rzecz.) brąz | : (rzecz.) brązowanie | : (rzecz.) spiż
bronzed : bronzed : (przym.) brązowy
bronzer : bronzer : (rzecz.) samoopalacz
bronzing : bronzing : (rzecz.) brązowanie | : (rzecz.) brązownictwo | : (rzecz.) zbrązowienie
brooch : brooch : (rzecz.) broszka
brooches : brooches : (rzecz.) brosza
brood : brood : (czas.) wylęgać | : (czas.) wysiadywać | : (czas.) zamyślać | : (czas.) zamyślić | : (rzecz.) dziatwa | : (rzecz.) ląg | : (rzecz.) pomiot | : (rzecz.) potomstwo | : (rzecz.) rasa | : (rzecz.) stado | : (rzecz.) wyląg
brooder : brooder : (rzecz.) kwoka | : (rzecz.) nasiadka
brook : brook : (czas.) cierpieć | : (czas.) znosić | : (rzecz.) potok | : (rzecz.) roztoka | : (rzecz.) ruczaj | : (rzecz.) strumień | : (rzecz.) strumyk
broom : broom : (rzecz.) miotła | : (rzecz.) żarnowiec
broom-maker : broom-maker : (rzecz.) miotlarz
broomstick : broomstick : (rzecz.) kij
broth : broth : (rzecz.) bulion | : (rzecz.) polewka | : (rzecz.) rosół
brothel : brothel : (rzecz.) burdel
brother : brother : (rzecz.) braciszek | : (rzecz.) brat | : (rzecz.) szwagier
brother-in-law : brother-in-law : (rzecz.) szwagier
brotherhood : brotherhood : (rzecz.) bractwo | : (rzecz.) braterstwo | : (rzecz.) pobratymstwo
brotherliness : brotherliness : (rzecz.) braterstwo
brotherly : brotherly : (przym.) braterski | : (przym.) bratni
brought : brought : (czas.) przynieść | : (rzecz.) przyprowadzenie
brow : brow : (rzecz.) brew | : (rzecz.) brwi | : (rzecz.) czoło | : (rzecz.) dowierzchnia | : (rzecz.) nadszybie | : (rzecz.) nawis | : (rzecz.) pochylnia
browbeat : browbeat : (czas.) onieśmielać | : (czas.) poniewierać | : (czas.) zastraszać
brown : brown : (czas.) obrumienić | : (czas.) przyrumienić | : (czas.) zasmażać | : (przym.) brązowy | : (przym.) brunatny | : (rzecz.) brąz | : (rzecz.) miedziak
brownie : brownie : (rzecz.) harcerka | : (rzecz.) krasnal | : (rzecz.) krasnolud | : (rzecz.) krasnoludek | : (rzecz.) skrzat
browning : browning : (rzecz.) brązowienie | : (rzecz.) browning | : (rzecz.) czernienie | : (rzecz.) oksydowanie | : (rzecz.) rumienienie
brownish : brownish : (przym.) brązowawy | : (przym.) brunatnawy
brows : brows : (rzecz.) brwi
browse : browse : (czas.) paść | : (czas.) przeglądać | : (czas.) przeszukiwać | : (czas.) rozglądać | : (czas.) wertować
browser : browser : (rzecz.) przeglądarka | : (rzecz.) szperacz
browsing : browsing : (rzecz.) pastwisko | : (rzecz.) pasza | : (rzecz.) szperanie
brucellosis : brucellosis : (rzecz.) bruceloza
bruise : bruise : (czas.) kontuzjować | : (czas.) obijać | : (czas.) odgnieść | : (czas.) posiniaczyć | : (czas.) potłuc | : (czas.) sinieć | : (czas.) śrutować | : (czas.) zadrasnąć | : (rzecz.) guz | : (rzecz.) obicie | : (rzecz.) obtłuczenie | : (rzecz.) potłuczenie | : (rzecz.) siniak | : (rzecz.) siniec | : (rzecz.) stłuczenie | : (rzecz.) zaciek | : (rzecz.) zadraśnięcie
bruiser : bruiser : (rzecz.) osiłek
bruising : bruising : (rzecz.) posiniaczenie
brume : brume : (rzecz.) mgła
brunch : brunch : (rzecz.) przekąska
brunet : brunet : (rzecz.) brunet
brunette : brunette : (rzecz.) brunetka
brunt : brunt : (rzecz.) impet | : (rzecz.) siła
brush : brush : (czas.) czyścić | : (czas.) ocierać | : (czas.) oczyszczać | : (czas.) przeczesać | : (czas.) szczotkować | : (czas.) wyszczotkować | : (czas.) wyszorować | : (czas.) zamiatać | : (czas.) zmieść | : (rzecz.) chrust | : (rzecz.) cyklina | : (rzecz.) froterka | : (rzecz.) kita | : (rzecz.) krzak | : (rzecz.) pędzel | : (rzecz.) potyczka | : (rzecz.) szczotka | : (rzecz.) utarczka | : (rzecz.) zmiotka
brush-wood : brush-wood : (rzecz.) chrust
brushing : brushing : (rzecz.) szczotkowanie
brushwood : brushwood : (rzecz.) chaszcze | : (rzecz.) chrust | : (rzecz.) zarośla
brushy : brushy : (przym.) krzaczasty
brusque : brusque : (przym.) obcesowy | : (przym.) szorstki
brusquely : brusquely : (przysł.) opryskliwie
brusqueness : brusqueness : (rzecz.) obcesowość | : (rzecz.) opryskliwość | : (rzecz.) szorstkość
brut : brut : (przym.) wytrawny
brutal : brutal : (przym.) brutalny | : (przym.) nieuprzejmy
brutalism : brutalism : (rzecz.) brutalizm
brutality : brutality : (rzecz.) brutalność
brutalization : brutalization : (rzecz.) brutalizacja
brutalize : brutalize : (czas.) brutalizować | : (czas.) ogłupiać | : (czas.) ogłupić
brutally : brutally : (przysł.) brutalnie
brute : brute : (przym.) brutalny | : (przym.) bydlęcy | : (przym.) zwierzęcy | : (rzecz.) brutal | : (rzecz.) bydlę | : (rzecz.) cham | : (rzecz.) okrutnik
brutish : brutish : (przym.) brutalny | : (przym.) bydlęcy
brutishness : brutishness : (rzecz.) bestialstwo | : (rzecz.) brutalność
bubble : bubble : (czas.) bulgotać | : (czas.) entuzjazmować | : (czas.) wrzeć | : (rzecz.) bąbel | : (rzecz.) balon | : (rzecz.) balonik | : (rzecz.) bańka | : (rzecz.) pęcherz | : (rzecz.) pęcherzyk
bubbler : bubbler : (rzecz.) bełkotka
bubbling : bubbling : (rzecz.) bulgotanie | : (rzecz.) musowanie
bubbly : bubbly : (przym.) entuzjastyczny
bubo : bubo : (rzecz.) dymienica
bubonic : bubonic : (przym.) morowy
buccaneer : buccaneer : (rzecz.) korsarz | : (rzecz.) pirat
buck : buck : (rzecz.) bubek | : (rzecz.) dandys | : (rzecz.) dolar | : (rzecz.) jeleń | : (rzecz.) kozioł | : (rzecz.) królik | : (rzecz.) samiec
bucked : bucked : (przym.) szczęśliwy
bucket : bucket : (czas.) zegnać | : (rzecz.) ceber | : (rzecz.) kibel | : (rzecz.) komplet | : (rzecz.) kubeł | : (rzecz.) pakiet | : (rzecz.) wiaderko | : (rzecz.) wiadro | : (rzecz.) zawartość
bucketful : bucketful : (rzecz.) wiadro
bucking : bucking : (rzecz.) kozioł
buckish : buckish : (przym.) fircykowaty | : (przym.) koźli | : (przym.) kozłowy
buckle : buckle : (czas.) odkształcać | : (czas.) odkształcić | : (czas.) przypiąć | : (czas.) spinać | : (czas.) zapinać | : (rzecz.) klamerka | : (rzecz.) klamra | : (rzecz.) sprzączka | : (rzecz.) zapięcie | : (rzecz.) zapinka
buckling : buckling : (rzecz.) paczenie | : (rzecz.) wykrzywienie
bucko : bucko : (rzecz.) zawadiaka
buckra : buckra : (rzecz.) pan
buckram : buckram : (rzecz.) klejonka
bucks : bucks : (rzecz.) bryka
buckshee : buckshee : (rzecz.) repeta
buckskin : buckskin : (rzecz.) skóra
buckthorn : buckthorn : (rzecz.) szakłak
buckwheat : buckwheat : (rzecz.) gryka | : (rzecz.) hreczka
bucolic : bucolic : (przym.) bukoliczny | : (przym.) pastoralny | : (rzecz.) bukolika | : (rzecz.) pastorałka | : (rzecz.) sielanka
bucolical : bucolical : (przym.) pastoralny | : (rzecz.) sielanka
bud : bud : (czas.) lęgnąć | : (czas.) oczkować | : (czas.) okulizować | : (czas.) pączkować | : (czas.) rozkwitać | : (rzecz.) pączek | : (rzecz.) pąk | : (rzecz.) zarodek
budding : budding : (rzecz.) okulizacja | : (rzecz.) okulizowanie | : (rzecz.) pączkowanie | : (rzecz.) rozkwitanie | : (rzecz.) zarodkowanie
buddle : buddle : (czas.) płukać | : (czas.) przemywać
buddy : buddy : (rzecz.) kompan | : (rzecz.) kumpel | : (rzecz.) przyjaciel
buddy-buddy : buddy-buddy : (rzecz.) kumpel
budge : budge : (czas.) poruszyć | : (czas.) ruszać
budgerigar : budgerigar : (rzecz.) nierozłączka
budget : budget : (rzecz.) budżet
budgetary : budgetary : (przym.) budżetowy
budgeting : budgeting : (rzecz.) asygnowanie
buff : buff : (czas.) polerować | : (przym.) bawoli | : (przym.) płowożółty | : (przym.) płowy | : (rzecz.) znawca
buffalo : buffalo : (rzecz.) bawół
buffer : buffer : (rzecz.) bufor | : (rzecz.) odbój | : (rzecz.) zderzak
buffer-multiplexer : buffer-multiplexer : (rzecz.) bufor-multiplekser
buffering : buffering : (rzecz.) buforowanie
buffet : buffet : (rzecz.) bufet | : (rzecz.) kredens | : (rzecz.) uderzenie
buffeting : buffeting : (rzecz.) buffeting | : (rzecz.) szturchanie | : (rzecz.) trzepotanie
buffoon : buffoon : (rzecz.) błazen | : (rzecz.) bufon | : (rzecz.) kabotyn | : (rzecz.) pajac
buffoonery : buffoonery : (rzecz.) arlekinada | : (rzecz.) bufonada | : (rzecz.) kabotynizm
bug : bug : (czas.) gryźć | : (czas.) spieprzyć | : (czas.) wkurzać | : (rzecz.) błąd | : (rzecz.) elektron | : (rzecz.) pluskwa | : (rzecz.) podsłuch | : (rzecz.) robak | : (rzecz.) wada | : (rzecz.) wirus
bugaboo : bugaboo : (rzecz.) postrach
bugbear : bugbear : (rzecz.) straszak | : (rzecz.) straszydło
bugger : bugger : (rzecz.) homoseksualista | : (rzecz.) sodomita | : (rzecz.) żart
buggery : buggery : (rzecz.) pederastia | : (rzecz.) sodomia
bugging : bugging : (rzecz.) pluskwa | : (rzecz.) podsłuch
buggy : buggy : (rzecz.) powozik | : (rzecz.) spacerówka | : (rzecz.) wagonik
bugle : bugle : (rzecz.) hejnał | : (rzecz.) róg | : (rzecz.) trąbka
bugler : bugler : (rzecz.) trębacz
bugloss : bugloss : (rzecz.) miodunka
build : build : (czas.) bazować | : (czas.) budować | : (czas.) dobudować | : (czas.) kompilować | : (czas.) konstruować | : (czas.) murować | : (czas.) obudować | : (czas.) opierać | : (czas.) rozbudowywać | : (czas.) skompilować | : (czas.) skonstruować | : (czas.) wbudować | : (czas.) wmurować | : (czas.) wybudować | : (czas.) wymurować | : (czas.) wznieść | : (czas.) wznosić | : (czas.) zabudować | : (czas.) zamurować | : (czas.) zbudować | : (rzecz.) bazowanie | : (rzecz.) budowa | : (rzecz.) budowanie | : (rzecz.) konstrukcja | : (rzecz.) wybudowanie | : (rzecz.) zbudowanie
build-up : build-up : (rzecz.) narastanie | : (rzecz.) powiększanie | : (rzecz.) przyrost | : (rzecz.) rozbudowa | : (rzecz.) wzrost
building : building : (rzecz.) budowa | : (rzecz.) budowla | : (rzecz.) budownictwo | : (rzecz.) budynek | : (rzecz.) gmach | : (rzecz.) podbudowanie | : (rzecz.) wybudowanie | : (rzecz.) zabudowanie
buildings : buildings : (rzecz.) zabudowa | : (rzecz.) zabudowanie
built-in : built-in : (przym.) wbudowany | : (przym.) zintegrowany
bulb : bulb : (rzecz.) bańka | : (rzecz.) bulwa | : (rzecz.) cebula | : (rzecz.) cebulka | : (rzecz.) opuszka | : (rzecz.) żarówka
bulbous : bulbous : (przym.) bulwiasty | : (przym.) cebulasty | : (przym.) cebulkowaty | : (przym.) dyniasty
bulbul : bulbul : (rzecz.) słowik | : (rzecz.) wschodni
bulge : bulge : (czas.) dymać | : (czas.) nabrzmiewać | : (czas.) nadymać | : (czas.) spęcznieć | : (czas.) spuchnąć | : (czas.) wybrzuszać | : (czas.) wybrzuszyć | : (czas.) wydymać | : (rzecz.) nabrzmienie | : (rzecz.) podwyższenie | : (rzecz.) przewaga | : (rzecz.) wybrzuszenie | : (rzecz.) wypukłość | : (rzecz.) wzdęcie
bulging : bulging : (przym.) baniasty | : (przym.) brzuchaty | : (przym.) wyłupiasty
bulgy : bulgy : (przym.) beczkowaty | : (przym.) beczkowy
bulk : bulk : (rzecz.) masa | : (rzecz.) objętość | : (rzecz.) większość | : (rzecz.) wielkość
bulkhead : bulkhead : (rzecz.) grodź | : (rzecz.) gródź | : (rzecz.) grodza | : (rzecz.) przegroda | : (rzecz.) przepierzenie
bulky : bulky : (przym.) duży | : (przym.) gruby | : (przym.) masywny | : (przym.) nieporęczny | : (przym.) objętościowy | : (przym.) przestrzenny | : (przym.) zwalisty
bull : bull : (rzecz.) buhaj | : (rzecz.) bulla | : (rzecz.) byk | : (rzecz.) cielec | : (rzecz.) samiec
bull's : bull's : (przym.) byczy
bull-terrier : bull-terrier : (rzecz.) bulterier
bulldog : bulldog : (rzecz.) bokser | : (rzecz.) buldog
bulldoze : bulldoze : (czas.) kopać | : (czas.) niszczyć | : (czas.) przemieszczać | : (czas.) zastraszać | : (czas.) zniszczyć
bulldozer : bulldozer : (rzecz.) buldożer | : (rzecz.) spychacz | : (rzecz.) spycharka
bullet : bullet : (rzecz.) kula | : (rzecz.) kulka | : (rzecz.) nabój | : (rzecz.) pocisk
bullet-proof : bullet-proof : (przym.) kuloodporny | : (przym.) opancerzony
bulleted : bulleted : (przym.) punktowany
bulletin : bulletin : (rzecz.) biuletyn | : (rzecz.) gazetka | : (rzecz.) komunikat
bullfight : bullfight : (rzecz.) korrida | : (rzecz.) walka
bullfighter : bullfighter : (rzecz.) torreador
bullfinch : bullfinch : (rzecz.) gil
bullhead : bullhead : (rzecz.) piaskownica
bullion : bullion : (rzecz.) kruszec | : (rzecz.) ozdoba | : (rzecz.) złoto
bullish : bullish : (przym.) zwyżkowy
bullock : bullock : (rzecz.) byk | : (rzecz.) wół
bullshit : bullshit : (rzecz.) brednie
bully : bully : (czas.) awanturować | : (czas.) szaleć | : (czas.) terroryzować | : (czas.) znęcać | : (rzecz.) brutal | : (rzecz.) gnój | : (rzecz.) terrorysta | : (rzecz.) tyran | : (rzecz.) zabijaka
bullyrag : bullyrag : (czas.) wyprawiać
bulrush : bulrush : (rzecz.) oczeret | : (rzecz.) sitowie
bulwark : bulwark : (rzecz.) mur | : (rzecz.) nadburcie | : (rzecz.) przedmurze | : (rzecz.) wał
bulwarks : bulwarks : (rzecz.) nadburcie
bum : bum : (rzecz.) przypalenie | : (rzecz.) tyłek | : (rzecz.) włóczęga | : (rzecz.) zadek | : (rzecz.) żebrak
bumble-bee : bumble-bee : (rzecz.) trzmiel
bumblebee : bumblebee : (rzecz.) trzmiel
bump : bump : (czas.) turkotać | : (czas.) uderzać | : (czas.) uderzyć | : (czas.) wpadać | : (czas.) zderzać | : (czas.) zderzyć | : (rzecz.) guz | : (rzecz.) guzek | : (rzecz.) stłuczka | : (rzecz.) uderzenie | : (rzecz.) wybój
bumper : bumper : (rzecz.) ochraniacz | : (rzecz.) puchar | : (rzecz.) zderzak
bumping : bumping : (rzecz.) podskakiwanie | : (rzecz.) rozciąganie | : (rzecz.) wybój
bumpkin : bumpkin : (rzecz.) chłopek | : (rzecz.) gamoń | : (rzecz.) głupek | : (rzecz.) niedojda | : (rzecz.) prostak
bumptiousness : bumptiousness : (rzecz.) przemądrzałość
bumpy : bumpy : (przym.) nierówny | : (przym.) wyboisty
bun : bun : (rzecz.) bułka | : (rzecz.) drożdżówka | : (rzecz.) kok | : (rzecz.) koka | : (rzecz.) szynion
bunch : bunch : (rzecz.) bukiet | : (rzecz.) ferajna | : (rzecz.) grupa | : (rzecz.) kiść | : (rzecz.) pęczek | : (rzecz.) pęk | : (rzecz.) wiązanka | : (rzecz.) wiązka
bund : bund : (rzecz.) grobla | : (rzecz.) nadbrzeże | : (rzecz.) obwałowanie | : (rzecz.) tama
bundle : bundle : (rzecz.) paczka | : (rzecz.) pakunek | : (rzecz.) pęk | : (rzecz.) plik | : (rzecz.) tłumok | : (rzecz.) tobół | : (rzecz.) tobołek | : (rzecz.) węzełek | : (rzecz.) wiązka | : (rzecz.) zawiniątko | : (rzecz.) zwitek
bung : bung : (rzecz.) bujda | : (rzecz.) korek | : (rzecz.) szpunt | : (rzecz.) zatyczka
bungalow : bungalow : (rzecz.) bungalow
bungle : bungle : (czas.) klecić | : (czas.) knocić | : (czas.) partaczyć | : (czas.) paskudzić | : (czas.) patałaszyć | : (czas.) schrzanić | : (czas.) sknocić | : (czas.) spaprać | : (czas.) spartaczyć | : (rzecz.) fuszerka | : (rzecz.) partactwo | : (rzecz.) partanina
bungler : bungler : (rzecz.) bałaganiarz | : (rzecz.) fuszer | : (rzecz.) partacz
bungling : bungling : (rzecz.) fuszerowanie | : (rzecz.) partactwo | : (rzecz.) partaczenie
bunk : bunk : (rzecz.) koja | : (rzecz.) łóżko | : (rzecz.) prycza
bunker : bunker : (rzecz.) bunkier | : (rzecz.) węglownia | : (rzecz.) zasobnia | : (rzecz.) zasobnik
bunkering : bunkering : (rzecz.) bunkrowanie
bunkum : bunkum : (rzecz.) bzdura | : (rzecz.) nonsens | : (rzecz.) pustosłowie | : (rzecz.) zgrywa
bunny : bunny : (rzecz.) królik
bunt : bunt : (rzecz.) wybrzuszenie | : (rzecz.) wywrót
bunting : bunting : (rzecz.) trznadel
buntings : buntings : (rzecz.) trznadel
buoy : buoy : (czas.) podtrzymać | : (czas.) trzymać | : (rzecz.) boja | : (rzecz.) pława
buoyancy : buoyancy : (rzecz.) pływalność | : (rzecz.) prężność
buoyant : buoyant : (przym.) pławny | : (przym.) prężny | : (przym.) radosny | : (przym.) stateczny
bur : bur : (rzecz.) rzep
burble : burble : (czas.) bulgotać | : (czas.) chlipać | : (czas.) mamrotać
burden : burden : (czas.) obarczyć | : (czas.) obciążyć | : (czas.) obładować | : (czas.) uciemiężać | : (czas.) zadłużyć | : (rzecz.) brzemię | : (rzecz.) ciężar | : (rzecz.) obciążenie | : (rzecz.) refren
burdening : burdening : (rzecz.) obarczanie
burdensome : burdensome : (przym.) ciężki | : (przym.) uciążliwy
burdock : burdock : (rzecz.) łopian
bureau : bureau : (rzecz.) biurko | : (rzecz.) biuro | : (rzecz.) prezydium | : (rzecz.) sekretarzyk | : (rzecz.) urząd
bureaucracy : bureaucracy : (rzecz.) biurokracja | : (rzecz.) biurokratyzacja
bureaucrat : bureaucrat : (rzecz.) biurokrata | : (rzecz.) służbista
bureaucratic : bureaucratic : (przym.) biurokratyczny | : (przym.) papierkowy
bureaucratically : bureaucratically : (przysł.) biurokratycznie
bureaucratization : bureaucratization : (rzecz.) biurokratyzacja
burette : burette : (rzecz.) biureta | : (rzecz.) miarówka
burgeon : burgeon : (czas.) pączkować | : (czas.) rozrastać
burger : burger : (rzecz.) burger | : (rzecz.) hamburger
burgess : burgess : (rzecz.) obywatel
burgh : burgh : (rzecz.) miasto
burgher : burgher : (rzecz.) mieszczanin
burglar : burglar : (rzecz.) włamywacz
burglarize : burglarize : (czas.) włamać
burglarizing : burglarizing : (rzecz.) włamywanie
burglary : burglary : (rzecz.) bandytyzm | : (rzecz.) włamanie
burgle : burgle : (czas.) włamać | : (czas.) włamywać
burgomaster : burgomaster : (rzecz.) burmistrz
burgoo : burgoo : (rzecz.) kaszka | : (rzecz.) owsianka
burial : burial : (rzecz.) pochowanie | : (rzecz.) pochówek | : (rzecz.) pogrzeb | : (rzecz.) zakopanie
burial-ground : burial-ground : (rzecz.) cmentarzysko
buried : buried : (czas.) pochować
burin : burin : (rzecz.) rylec
burke : burke : (czas.) unikać
burl : burl : (rzecz.) guz | : (rzecz.) węzełek
burlesque : burlesque : (przym.) burleskowy | : (przym.) komiczny | : (rzecz.) burleska | : (rzecz.) farsa
burliness : burliness : (rzecz.) krzepkość | : (rzecz.) tężyzna
burly : burly : (przym.) krzepki | : (przym.) tęgi
burn : burn : (czas.) gorzeć | : (czas.) napalić | : (czas.) opalać | : (czas.) oparzyć | : (czas.) osmalić | : (czas.) pałać | : (czas.) palić | : (czas.) parzyć | : (czas.) płonąć | : (czas.) podpalać | : (czas.) przypalać | : (czas.) przypalić | : (czas.) rozpalać | : (czas.) spalać | : (czas.) spalić | : (czas.) sparzyć | : (czas.) spopieleć | : (czas.) wypalać | : (czas.) wypalić | : (czas.) zapalać | : (rzecz.) dym | : (rzecz.) oparzelina | : (rzecz.) oparzelizna | : (rzecz.) oparzenie | : (rzecz.) piec | : (rzecz.) poparzenie | : (rzecz.) wypalanie | : (rzecz.) wypalenie
burner : burner : (rzecz.) palnik | : (rzecz.) wypalacz
burnet : burnet : (rzecz.) krwiściąg
burning : burning : (rzecz.) palenie | : (rzecz.) parzenie | : (rzecz.) przypalenie | : (rzecz.) spalanie | : (rzecz.) spalenie | : (rzecz.) spalenizna | : (rzecz.) sparzenie | : (rzecz.) spopielanie | : (rzecz.) wstyd | : (rzecz.) wypalanie | : (rzecz.) wypalenie
burning-on : burning-on : (rzecz.) nadlewanie
burnish : burnish : (czas.) polerować | : (czas.) wypolerować | : (rzecz.) dogniatanie
burnishing : burnishing : (rzecz.) nagniatanie
burnoose : burnoose : (rzecz.) burnus
burnout : burnout : (rzecz.) wycieńczenie | : (rzecz.) wypalenie
burnt : burnt : (przym.) całopalny | : (przym.) palony | : (przym.) spalony | : (przym.) wypalony
burp : burp : (czas.) bekać | : (rzecz.) beknięcie | : (rzecz.) cofka
burr : burr : (rzecz.) osełka | : (rzecz.) rąbek | : (rzecz.) rzep | : (rzecz.) wytłoczka | : (rzecz.) zadzior | : (rzecz.) zalewka | : (rzecz.) zendrówka
burr-drill : burr-drill : (rzecz.) wiertło
burro : burro : (rzecz.) osioł
burrow : burrow : (czas.) ryć | : (rzecz.) dziura | : (rzecz.) hałda | : (rzecz.) jama | : (rzecz.) nora | : (rzecz.) wysypisko
bursa : bursa : (rzecz.) torebka
bursar : bursar : (rzecz.) kwestor
bursary : bursary : (rzecz.) kwestura | : (rzecz.) stypendium
burst : burst : (czas.) pękać | : (czas.) przebijać | : (czas.) rozerwać | : (czas.) rozlecieć | : (czas.) rozsadzać | : (czas.) wtargnąć | : (czas.) wybuchać | : (czas.) wylatywać | : (rzecz.) huragan | : (rzecz.) pęknięcie | : (rzecz.) porcja | : (rzecz.) rozerwanie | : (rzecz.) rozprysk | : (rzecz.) wybuch | : (rzecz.) zryw
burst-up : burst-up : (rzecz.) bankructwo | : (rzecz.) upadek
bursting : bursting : (rzecz.) pęknięcie | : (rzecz.) rozsadzenie
burthen : burthen : (czas.) obarczyć | : (czas.) obciążyć | : (czas.) obładować | : (czas.) uciemiężać | : (rzecz.) brzemię | : (rzecz.) ciężar | : (rzecz.) obciążenie | : (rzecz.) refren
bury : bury : (czas.) chować | : (czas.) grzebać | : (czas.) pochować | : (czas.) zakopać | : (czas.) zakopywać
burying : burying : (rzecz.) pochowanie | : (rzecz.) pogrzebanie | : (rzecz.) zagrzebanie | : (rzecz.) zakopanie
bus : bus : (rzecz.) autobus | : (rzecz.) magistrala | : (rzecz.) szyna
bus-bars : bus-bars : (rzecz.) magistrala
bush : bush : (rzecz.) busz | : (rzecz.) gąszcz | : (rzecz.) krzak | : (rzecz.) krzew | : (rzecz.) panew | : (rzecz.) tuleja | : (rzecz.) tulejka | : (rzecz.) zarośla
bushel : bushel : (rzecz.) buszel | : (rzecz.) korzec
bushing : bushing : (rzecz.) tulejka
bushy : bushy : (przym.) bujny | : (przym.) gęsty | : (przym.) krzaczasty | : (przym.) sumiasty
busily : busily : (przysł.) pracowicie | : (przysł.) skrzętnie
business : business : (rzecz.) biznes | : (rzecz.) branża | : (rzecz.) firma | : (rzecz.) interes | : (rzecz.) mikroekonomia | : (rzecz.) przedsiębiorstwo | : (rzecz.) sprawa | : (rzecz.) transakcja | : (rzecz.) zajęcie
business-like : business-like : (przym.) dokładny | : (przym.) rzeczowy | : (przym.) solidny
businesslike : businesslike : (przym.) dokładny | : (przym.) konkretny | : (przym.) praktyczny | : (przym.) rzeczowy | : (przym.) solidny
businessman : businessman : (rzecz.) biznesmen | : (rzecz.) handlowiec | : (rzecz.) kupiec | : (rzecz.) przedsiębiorca | : (rzecz.) przemysłowiec
businesswoman : businesswoman : (rzecz.) businesswoman
busker : busker : (rzecz.) grajek
buskin : buskin : (rzecz.) koturn
buskined : buskined : (przym.) koturnowy
busman : busman : (rzecz.) konduktor
buss : buss : (czas.) całować | : (rzecz.) całus
bust : bust : (czas.) pryskać | : (czas.) rozsadzać | : (czas.) rwać | : (czas.) splajtować | : (rzecz.) biust | : (rzecz.) popiersie
bustard : bustard : (rzecz.) drop
buster : buster : (rzecz.) popiersie
bustle : bustle : (rzecz.) bieganina | : (rzecz.) krzątanina | : (rzecz.) latanina | : (rzecz.) rozgardiasz | : (rzecz.) zgiełk
bustling : bustling : (przym.) gwarny | : (przym.) rojny | : (przym.) skrzętny | : (rzecz.) uwijanie
busy : busy : (przym.) czynny | : (przym.) rojny | : (przym.) ruchliwy | : (przym.) skrzętny | : (przym.) zajęty
but : but : (przyim.) oprócz | : (przysł.) tylko | : (przysł.) zaledwie | : (spójnik) ale | : (spójnik) jednak | : (spójnik) jednakże | : (spójnik) lecz
butadiene : butadiene : (rzecz.) butadien
butane : butane : (rzecz.) butan
butcher : butcher : (czas.) mordować | : (czas.) wyrzynać | : (czas.) zarzynać | : (rzecz.) masarz | : (rzecz.) mordowanie | : (rzecz.) oprawca | : (rzecz.) rzeźnik | : (rzecz.) wyrzynanie
butcher's : butcher's : (rzecz.) rzeźnia
butchery : butchery : (rzecz.) masakra | : (rzecz.) rzeź | : (rzecz.) rzeźnia | : (rzecz.) rzeźnictwo | : (rzecz.) ubój
butcher’s : butcher’s : (rzecz.) masarnia
butler : butler : (rzecz.) kamerdyner | : (rzecz.) lokaj
butt : butt : (czas.) uderzać | : (czas.) walić | : (rzecz.) dupa | : (rzecz.) kolba | : (rzecz.) krupon | : (rzecz.) kulochwyt | : (rzecz.) niedopałek | : (rzecz.) odziomek | : (rzecz.) rękojeść | : (rzecz.) tarcza
butte : butte : (rzecz.) wzgórze
butter : butter : (czas.) maścić | : (rzecz.) masło | : (rzecz.) omasta
butter-dish : butter-dish : (rzecz.) maselniczka
buttercup : buttercup : (rzecz.) jaskier | : (rzecz.) jaskra
butterfingered : butterfingered : (przym.) ślamazarny | : (przym.) ślimakowaty
butterfingers : butterfingers : (rzecz.) fajtłapa | : (rzecz.) niezgraba | : (rzecz.) ślamazara
butterfly : butterfly : (rzecz.) motyl | : (rzecz.) motylek | : (rzecz.) przepustnica
buttermilk : buttermilk : (rzecz.) maślanka
butterscotch : butterscotch : (rzecz.) karmel
buttery : buttery : (rzecz.) spiżarnia
butthead : butthead : (rzecz.) matoł
buttock : buttock : (rzecz.) pośladek | : (rzecz.) zad | : (rzecz.) zadek
buttocks : buttocks : (rzecz.) dupa | : (rzecz.) pośladek | : (rzecz.) zad
button : button : (czas.) dopinać | : (czas.) zapinać | : (rzecz.) guz | : (rzecz.) guzik | : (rzecz.) przycisk
buttonhole : buttonhole : (rzecz.) butonierka | : (rzecz.) dziurka
buttons : buttons : (rzecz.) pikolak
buttonwood : buttonwood : (rzecz.) platan
buttress : buttress : (czas.) podeprzeć | : (czas.) podpierać | : (czas.) podtrzymywać | : (czas.) wzmacniać | : (rzecz.) podpora | : (rzecz.) przypora | : (rzecz.) skarpa
butyl : butyl : (rzecz.) butyl
butyric : butyric : (przym.) masłowy
buxom : buxom : (przym.) dorodny | : (przym.) hoży
buy : buy : (czas.) dokupić | : (czas.) kupić | : (czas.) kupować | : (czas.) nabyć | : (czas.) nasprowadzać | : (czas.) odkupić | : (czas.) okupić | : (czas.) okupywać | : (czas.) skupować | : (czas.) wykupić | : (czas.) zakupić | : (czas.) zaopatrywać | : (rzecz.) abonament | : (rzecz.) kupno | : (rzecz.) kupowanie | : (rzecz.) zakup
buyback : buyback : (czas.) wykupić | : (czas.) wykupywać
buyer : buyer : (rzecz.) klient | : (rzecz.) kupiec | : (rzecz.) nabywca
buying : buying : (rzecz.) kupno | : (rzecz.) kupowanie | : (rzecz.) wykupienie
buyout : buyout : (rzecz.) wykup
buzz : buzz : (czas.) brzęczeć | : (czas.) burczeć | : (czas.) bzyczeć | : (czas.) bzykać | : (czas.) furczeć | : (czas.) furkać | : (czas.) naprzykrzać | : (rzecz.) brzęczenie | : (rzecz.) buczenie | : (rzecz.) furkot | : (rzecz.) gwar | : (rzecz.) pulsowanie
buzzard : buzzard : (rzecz.) myszołów
buzzer : buzzer : (rzecz.) brzęczyk | : (rzecz.) syrena
buzzing : buzzing : (rzecz.) brzęczenie | : (rzecz.) szum
buzzword : buzzword : (rzecz.) bełkot | : (rzecz.) mowa-trawa
by : by : (przyim.) do | : (przyim.) przed | : (przyim.) przez | : (przyim.) przy | : (przyim.) za | : (przysł.) blisko | : (przysł.) około | : (przysł.) poprzez
by-pass : by-pass : (czas.) obchodzić | : (czas.) omijać | : (rzecz.) bocznik | : (rzecz.) obejście | : (rzecz.) objazd | : (rzecz.) obwodnica
by-passing : by-passing : (przym.) objazdowy
byelaw : byelaw : (rzecz.) regulamin | : (rzecz.) statut
bygone : bygone : (przym.) miniony | : (przym.) przeszły
bylaw : bylaw : (rzecz.) regulamin | : (rzecz.) statut | : (rzecz.) zarządzenie
bypass : bypass : (czas.) obchodzić | : (czas.) objechać | : (czas.) objeżdżać | : (czas.) omijać | : (rzecz.) obejście | : (rzecz.) objazd | : (rzecz.) obwodnica
byre : byre : (rzecz.) obora | : (rzecz.) oboranie
bystander : bystander : (rzecz.) obserwator | : (rzecz.) świadek | : (rzecz.) widz
bystreet : bystreet : (rzecz.) uliczka
byte : byte : (rzecz.) bajt
byte-serial : byte-serial : (przym.) bajtowy
byway : byway : (rzecz.) skrót
byword : byword : (rzecz.) porzekadło | : (rzecz.) powiedzenie | : (rzecz.) powiedzonko | : (rzecz.) przysłowie
