indie : Indie : (rzecz.) India
internet : Internet : (rzecz.) Internet | : (rzecz.) net
irena : Irena : (rzecz.) Irene
iris : Iris : (rzecz.) iris
izabella : Izabella : (rzecz.) Isabel
i : i : (spójnik) and
ibis : ibis : (rzecz.) ibis
ichtiolog : ichtiolog : (rzecz.) ichthyologist
ichtiologia : ichtiologia : (rzecz.) ichthyology
ichtiozaur : ichtiozaur : (rzecz.) ichthyosaurus
idea : idea : (rzecz.) idea
ideacja : ideacja : (rzecz.) ideation
idealista : idealista : (rzecz.) idealist
idealistycznie : idealistycznie : (przysł.) idealistically
idealistyczny : idealistyczny : (przym.) idealistic
idealizacja : idealizacja : (rzecz.) idealization
idealizm : idealizm : (rzecz.) idealism
idealizowac : idealizować : (czas.) idealize | : (czas.) sublimate
idealnie : idealnie : (przysł.) ideally | : (przysł.) perfectly | : (przysł.) superbly
idealny : idealny : (przym.) ideal | : (przym.) perfect
ideal : ideał : (rzecz.) ideal
identycznie : identycznie : (przysł.) identically
identycznosc : identyczność : (rzecz.) identity | : (rzecz.) sameness
identyczny : identyczny : (przym.) identical | : (przym.) same | : (przym.) uniform
identyfikacja : identyfikacja : (rzecz.) authentication | : (rzecz.) identification | : (rzecz.) recognition | : (rzecz.) traceability
identyfikacyjny : identyfikacyjny : (przym.) id
identyfikator : identyfikator : (rzecz.) id | : (rzecz.) identifier
identyfikowanie : identyfikowanie : (rzecz.) identifying
identyfikowac : identyfikować : (czas.) identify
ideograficzny : ideograficzny : (przym.) ideographic
ideogram : ideogram : (rzecz.) ideogram | : (rzecz.) ideograph
ideolog : ideolog : (rzecz.) ideologist | : (rzecz.) ideologue
ideologia : ideologia : (rzecz.) ideology
ideologicznie : ideologicznie : (przysł.) ideologically
ideologiczny : ideologiczny : (przym.) ideological
ideowiec : ideowiec : (rzecz.) ideologist
ideowy : ideowy : (przym.) ideational | : (przym.) ideological
idiom : idiom : (rzecz.) idiom
idiomatycznie : idiomatycznie : (przysł.) idiomatically
idiomatyczny : idiomatyczny : (przym.) idiomatic | : (przym.) idiomatical
idiosynkrazja : idiosynkrazja : (rzecz.) dislike | : (rzecz.) idiosyncrasy
idiota : idiota : (rzecz.) dope | : (rzecz.) idiot | : (rzecz.) oaf | : (rzecz.) prick | : (rzecz.) twerp | : (rzecz.) yuk
idiotycznie : idiotycznie : (przysł.) idiotically
idiotycznosc : idiotyczność : (rzecz.) idiocy
idiotyczny : idiotyczny : (przym.) absurd | : (przym.) asinine | : (przym.) brainless | : (przym.) crass | : (przym.) dumb | : (przym.) idiotic | : (przym.) senseless
idiotyzm : idiotyzm : (rzecz.) idiocy | : (rzecz.) idiotism | : (rzecz.) stupidity
idol : idol : (rzecz.) hero | : (rzecz.) idol
idylla : idylla : (rzecz.) idyll
idylliczny : idylliczny : (przym.) idyllic
igielnik : igielnik : (rzecz.) needle-case | : (rzecz.) pincushion
igielkowaty : igiełkowaty : (przym.) needle-shaped
iglasty : iglasty : (przym.) acicular | : (przym.) aciform | : (przym.) coniferous
iglica : iglica : (rzecz.) aglet | : (rzecz.) nipple | : (rzecz.) peak | : (rzecz.) spear | : (rzecz.) spire | : (rzecz.) steeple | : (rzecz.) stylus
iglicznia : iglicznia : (rzecz.) pipefish
ignitron : ignitron : (rzecz.) ignitron
ignorancja : ignorancja : (rzecz.) ignorance | : (rzecz.) innocence
ignorancki : ignorancki : (przym.) ignorant
ignorant : ignorant : (rzecz.) ignoramus
ignorowac : ignorować : (czas.) disregard | : (czas.) ignore
igraszka : igraszka : (rzecz.) frolic | : (rzecz.) trifle
igrac : igrać : (czas.) play | : (czas.) toy
igrzyska : igrzyska : (rzecz.) game
igla : igła : (rzecz.) needle | : (rzecz.) pin | : (rzecz.) stylus
ikona : ikona : (rzecz.) icon
ikonografia : ikonografia : (rzecz.) iconography
ikonograficzny : ikonograficzny : (przym.) iconographic
ikonoklasta : ikonoklasta : (rzecz.) iconoclast
ikonoklazm : ikonoklazm : (rzecz.) iconoclasm
ikonoskop : ikonoskop : (rzecz.) iconoscope
ikra : ikra : (rzecz.) eggs | : (rzecz.) roe | : (rzecz.) spat | : (rzecz.) spawn | : (rzecz.) spunk
ikrzenie : ikrzenie : (rzecz.) eggs | : (rzecz.) spawning
ikrzyc : ikrzyć : (czas.) spawn
ilasty : ilasty : (przym.) loamy
ile : ile : (przysł.) while
iloczas : iloczas : (rzecz.) quantity
iloczyn : iloczyn : (rzecz.) product
iloraz : iloraz : (rzecz.) quotient
ilosciowo : ilościowo : (przysł.) quantitatively
ilosciowy : ilościowy : (przym.) quantitative
ilosc : ilość : (rzecz.) amount | : (rzecz.) average | : (rzecz.) deal | : (rzecz.) number | : (rzecz.) quantity | : (rzecz.) volume
iluminacja : iluminacja : (rzecz.) illumination
iluminator : iluminator : (rzecz.) porthole
iluminowac : iluminować : (czas.) floodlight | : (czas.) flood-light | : (czas.) illuminate | : (czas.) illumine
ilustracja : ilustracja : (rzecz.) figure | : (rzecz.) illustration | : (rzecz.) image | : (rzecz.) picture | : (rzecz.) setting
ilustracyjny : ilustracyjny : (przym.) illustrative
ilustrator : ilustrator : (rzecz.) illustrator
ilustrowany : ilustrowany : (przym.) glossy | : (przym.) pictorial
ilustrowac : ilustrować : (czas.) exemplify | : (czas.) illustrate | : (czas.) show
ilustrujacy : ilustrujący : (przym.) illustrative
iluzja : iluzja : (rzecz.) delusion | : (rzecz.) illusion
iluzjonista : iluzjonista : (rzecz.) conjurer | : (rzecz.) conjuror | : (rzecz.) dreamer | : (rzecz.) illusionist | : (rzecz.) magician
iluzorycznosc : iluzoryczność : (rzecz.) fiction
iluzoryczny : iluzoryczny : (przym.) delusive | : (przym.) delusory | : (przym.) illusive | : (przym.) illusory
imadlo : imadło : (rzecz.) clamp | : (rzecz.) jaw | : (rzecz.) jig | : (rzecz.) vice
imaginacja : imaginacja : (rzecz.) imagination
imaginacyjny : imaginacyjny : (przym.) imaginary | : (przym.) imaginative
imak : imak : (rzecz.) gripper
imbecyl : imbecyl : (rzecz.) imbecile
imbecylizm : imbecylizm : (rzecz.) imbecility
imbir : imbir : (rzecz.) ginger
imbirowy : imbirowy : (przym.) gingery
imbryk : imbryk : (rzecz.) kettle | : (rzecz.) teakettle | : (rzecz.) teapot | : (rzecz.) tea-pot
imieniny : imieniny : (rzecz.) name-day | : (rzecz.) name-days
imiennik : imiennik : (rzecz.) nameplate | : (rzecz.) namesake
imienny : imienny : (przym.) nominal | : (przym.) personal
imieslowowy : imiesłowowy : (przym.) participial
imieslow : imiesłów : (rzecz.) participle
imigracja : imigracja : (rzecz.) immigration
imigrant : imigrant : (rzecz.) immigrant
imigrowac : imigrować : (czas.) immigrate
imitacja : imitacja : (rzecz.) clone | : (rzecz.) dummy | : (rzecz.) imitation | : (rzecz.) look-alike
imitator : imitator : (rzecz.) simulator
imitowanie : imitowanie : (rzecz.) emulation
imitowac : imitować : (czas.) emit | : (czas.) imitate | : (czas.) simulate
imie : imię : (rzecz.) appellation | : (rzecz.) forename | : (rzecz.) name
immanentnie : immanentnie : (przysł.) immanently
immanentnosc : immanentność : (rzecz.) immanence
immanentny : immanentny : (przym.) immanent
immatrykulacja : immatrykulacja : (rzecz.) matriculation
immatrykulowac : immatrykulować : (czas.) matriculate
immersja : immersja : (rzecz.) immersion
immunitet : immunitet : (rzecz.) immunity | : (rzecz.) privilege
immunizacja : immunizacja : (rzecz.) immunization
immunizowac : immunizować : (czas.) immunize
immunoglobulina : immunoglobulina : (rzecz.) immunoglobulin
immunolog : immunolog : (rzecz.) immunologist
immunologia : immunologia : (rzecz.) immunology
immunologiczny : immunologiczny : (przym.) immune | : (przym.) immunological
immunoterapia : immunoterapia : (rzecz.) immunotherapy
impas : impas : (rzecz.) deadlock | : (rzecz.) impasse | : (rzecz.) nonplus | : (rzecz.) standoff
impedancja : impedancja : (rzecz.) impedance
imperator : imperator : (rzecz.) emperor
imperatorski : imperatorski : (przym.) imperatorial
imperatyw : imperatyw : (rzecz.) imperative
imperatywny : imperatywny : (przym.) imperatival | : (przym.) imperative
imperialista : imperialista : (rzecz.) imperialist
imperialistyczny : imperialistyczny : (przym.) imperialistic
imperializm : imperializm : (rzecz.) imperialism
imperialny : imperialny : (przym.) imperial
imperium : imperium : (rzecz.) empire
impertynencja : impertynencja : (rzecz.) backchat | : (rzecz.) impertinence | : (rzecz.) impertinency | : (rzecz.) sauce
impertynencki : impertynencki : (przym.) flippant | : (przym.) impertinent | : (przym.) sassy | : (przym.) saucy
impertynencko : impertynencko : (przysł.) impertinently | : (przysł.) pertly
impertynent : impertynent : (rzecz.) whippersnapper
impet : impet : (rzecz.) brunt | : (rzecz.) impetus | : (rzecz.) momentum
implantacja : implantacja : (rzecz.) implantation
implementacja : implementacja : (rzecz.) implementation
implementowac : implementować : (czas.) implement
implikacja : implikacja : (rzecz.) implication | : (rzecz.) overtone
implikowac : implikować : (czas.) implicate | : (czas.) imply | : (czas.) presuppose
implodowac : implodować : (czas.) implode
implozja : implozja : (rzecz.) implosion
imponowanie : imponowanie : (rzecz.) splurge
imponowac : imponować : (czas.) impose | : (czas.) impress | : (czas.) prepossess
imponujacy : imponujący : (przym.) grand | : (przym.) imposing | : (przym.) striking
import : import : (rzecz.) import
importer : importer : (rzecz.) importer
importowanie : importowanie : (rzecz.) importation
importowac : importować : (czas.) import
importowy : importowy : (przym.) importable
impotencja : impotencja : (rzecz.) impotence
impregnacja : impregnacja : (rzecz.) impregnation
impregnowany : impregnowany : (przym.) impregnated
impregnowac : impregnować : (czas.) bark | : (czas.) impregnate | : (czas.) pad | : (czas.) saturate
impresario : impresario : (rzecz.) impresario
impresja : impresja : (rzecz.) impression
impresjonista : impresjonista : (rzecz.) impressionist
impresjonistyczny : impresjonistyczny : (przym.) impressionistic
impresjonizm : impresjonizm : (rzecz.) impressionism
impreza : impreza : (rzecz.) carousal | : (rzecz.) event | : (rzecz.) fixture | : (rzecz.) party | : (rzecz.) spree
improwizacja : improwizacja : (rzecz.) improvisation
improwizator : improwizator : (rzecz.) improviser
improwizatorski : improwizatorski : (przym.) improvisational
improwizowany : improwizowany : (przym.) impromptu | : (przym.) offhand
improwizowac : improwizować : (czas.) adlib | : (czas.) ad-lib | : (czas.) extemporize | : (czas.) improvise
impuls : impuls : (rzecz.) impetus | : (rzecz.) impulse | : (rzecz.) impulsion | : (rzecz.) propulsion | : (rzecz.) pulse
impulsywnie : impulsywnie : (przysł.) impulsively
impulsywnosc : impulsywność : (rzecz.) impulsiveness
impulsywny : impulsywny : (przym.) impulsive
imputowanie : imputowanie : (rzecz.) imputing
imputowac : imputować : (czas.) imputable | : (czas.) impute
inauguracja : inauguracja : (rzecz.) inauguration | : (rzecz.) opening
inauguracyjny : inauguracyjny : (przym.) inaugural
inaugurowac : inaugurować : (czas.) inaugurate | : (czas.) open
incydent : incydent : (rzecz.) incident
incydentalny : incydentalny : (przym.) incidental
ind : ind : (rzecz.) indium | : (rzecz.) lascar
indagacja : indagacja : (rzecz.) interrogatory
indagowac : indagować : (czas.) interrogate
indeks : indeks : (rzecz.) index | : (rzecz.) list
indeksacja : indeksacja : (rzecz.) index | : (rzecz.) indexation
indemnizacja : indemnizacja : (rzecz.) indemnification | : (rzecz.) indemnity
inden : inden : (rzecz.) indene
indoktrynacja : indoktrynacja : (rzecz.) indoctrination
indoktrynowac : indoktrynować : (czas.) indoctrinate
indolencja : indolencja : (rzecz.) indolence
indor : indor : (rzecz.) gobbler | : (rzecz.) turkey-cock
indos : indos : (rzecz.) endorsement
indosat : indosat : (rzecz.) endorsee
indosowac : indosować : (czas.) endorse | : (czas.) indorse
indukcja : indukcja : (rzecz.) induction
indukcyjnie : indukcyjnie : (przysł.) inductively
indukcyjnosc : indukcyjność : (rzecz.) inductance | : (rzecz.) inductances
indukcyjnosc-pojemnosc : indukcyjność-pojemność : (rzecz.) inductance-capacitance
indukcyjny : indukcyjny : (przym.) inductive
indukowac : indukować : (czas.) induce
induktor : induktor : (rzecz.) coil | : (rzecz.) inducer | : (rzecz.) inductor | : (rzecz.) magneto
industrializacja : industrializacja : (rzecz.) industrialization
industrializm : industrializm : (rzecz.) industrialism
indygo : indygo : (rzecz.) indigo
indyk : indyk : (rzecz.) turkey
indykator : indykator : (rzecz.) indicator
indywidualista : indywidualista : (rzecz.) individualist | : (rzecz.) maverick
indywidualistyczny : indywidualistyczny : (przym.) individualistic
indywidualizacja : indywidualizacja : (rzecz.) individualisation | : (rzecz.) individualization
indywidualizm : indywidualizm : (rzecz.) individualism
indywidualizowac : indywidualizować : (czas.) customize | : (czas.) individualize | : (czas.) individuate
indywidualnie : indywidualnie : (przysł.) individually | : (przysł.) severally
indywidualnosc : indywidualność : (rzecz.) individuality | : (rzecz.) personality
indywidualny : indywidualny : (przym.) individual | : (przym.) personal | : (przym.) respective | : (przym.) separate | : (przym.) singular
indywiduum : indywiduum : (rzecz.) individual | : (rzecz.) person
inercja : inercja : (rzecz.) inertia
inercjalny : inercjalny : (przym.) inertial
inercyjny : inercyjny : (przym.) inert | : (przym.) inertial
infamia : infamia : (rzecz.) infamy
infantylizm : infantylizm : (rzecz.) infantilism
infantylny : infantylny : (przym.) childish | : (przym.) infantile | : (przym.) infantine | : (przym.) puerile
infekcja : infekcja : (rzecz.) infection
infekcyjny : infekcyjny : (przym.) infectious | : (przym.) infective
infekowac : infekować : (czas.) infect
infiltracja : infiltracja : (rzecz.) compromise | : (rzecz.) infiltration | : (rzecz.) intrusion
infiltrowac : infiltrować : (czas.) infiltrate
infirmeria : infirmeria : (rzecz.) infirmary
inflacja : inflacja : (rzecz.) inflation
inflacyjny : inflacyjny : (przym.) inflationary
influenca : influenca : (rzecz.) influence
informacja : informacja : (rzecz.) communication | : (rzecz.) data | : (rzecz.) guidance | : (rzecz.) info | : (rzecz.) information | : (rzecz.) intelligence | : (rzecz.) poop
informacyjny : informacyjny : (przym.) informational | : (przym.) informative
informator : informator : (rzecz.) brochure | : (rzecz.) capper | : (rzecz.) communicant | : (rzecz.) handbook | : (rzecz.) indicator | : (rzecz.) informant | : (rzecz.) informer | : (rzecz.) inquirer | : (rzecz.) newsletter
informatycznego : informatycznego : (rzecz.) corpus
informatyk : informatyk : (rzecz.) hardware
informatyka : informatyka : (rzecz.) computing | : (rzecz.) informatics | : (rzecz.) programmer
informatyzacja : informatyzacja : (rzecz.) computerization
informowanie : informowanie : (rzecz.) information | : (rzecz.) informing
informowac : informować : (czas.) apprise | : (czas.) educate | : (czas.) inform | : (czas.) instruct | : (czas.) misinformed
infradzwiek : infradźwięk : (rzecz.) infrasound
infradzwiekowy : infradźwiękowy : (przym.) infrasonic | : (przym.) subsonic
infrastruktura : infrastruktura : (rzecz.) fabric | : (rzecz.) infrastructure | : (rzecz.) instrumentation | : (rzecz.) warp
infrastrukturalny : infrastrukturalny : (przym.) infrastructural
infuzja : infuzja : (rzecz.) infusion
infula : infuła : (rzecz.) mitre
ingerencja : ingerencja : (rzecz.) interference | : (rzecz.) intervention
ingerowac : ingerować : (czas.) interfere | : (czas.) intervene
ingrediencja : ingrediencja : (rzecz.) ingredient
inhalacja : inhalacja : (rzecz.) inhalation
inhalacyjny : inhalacyjny : (przym.) inhalant
inhalator : inhalator : (rzecz.) inhaler
inhalowac : inhalować : (czas.) inhale
inhibicja : inhibicja : (rzecz.) inhibition
inicjacja : inicjacja : (rzecz.) initiation
inicjalizacja : inicjalizacja : (rzecz.) initialization
inicjalizowac : inicjalizować : (czas.) initialize
inicjator : inicjator : (rzecz.) initiator | : (rzecz.) originator
inicjatywa : inicjatywa : (rzecz.) affair | : (rzecz.) enterprise | : (rzecz.) gumption | : (rzecz.) initiative | : (rzecz.) motion
inicjatywnosc : inicjatywność : (rzecz.) initiative
inicjal : inicjał : (rzecz.) drop-cap | : (rzecz.) initial
inicjaly : inicjały : (rzecz.) initials
inicjowanie : inicjowanie : (rzecz.) boot | : (rzecz.) bootstrap | : (rzecz.) initialization | : (rzecz.) initiate | : (rzecz.) initiating
inicjowac : inicjować : (czas.) boot | : (czas.) initialize | : (czas.) initiate
iniekcja : iniekcja : (rzecz.) injection
iniektor : iniektor : (rzecz.) injector
inkarnacja : inkarnacja : (rzecz.) incarnation
inkarnat : inkarnat : (rzecz.) damask
inkasent : inkasent : (rzecz.) collector
inkaso : inkaso : (rzecz.) collection
inkasowanie : inkasowanie : (rzecz.) collection
inkasowac : inkasować : (czas.) cash | : (czas.) collect
inklinacja : inklinacja : (rzecz.) bias | : (rzecz.) inclination | : (rzecz.) propensity
inklinometr : inklinometr : (rzecz.) inclinometer
inkluzja : inkluzja : (rzecz.) enclave | : (rzecz.) inclusion | : (rzecz.) intercalation
inkoherencja : inkoherencja : (rzecz.) incoherence | : (rzecz.) incoherency
inkorporacja : inkorporacja : (rzecz.) incorporation
inkorporowac : inkorporować : (czas.) incorporate
inkrementacja : inkrementacja : (rzecz.) increment | : (rzecz.) incrementing
inkrustacja : inkrustacja : (rzecz.) incrustation | : (rzecz.) inlay | : (rzecz.) tit
inkrustowac : inkrustować : (czas.) encrust | : (czas.) incrust | : (czas.) inlay
inkryminowac : inkryminować : (czas.) incriminate
inkubacja : inkubacja : (rzecz.) incubation
inkubator : inkubator : (rzecz.) incubator
inkunabul : inkunabuł : (rzecz.) incunabula | : (rzecz.) incunabulum
inkwizycja : inkwizycja : (rzecz.) inquisition
inkwizycyjny : inkwizycyjny : (przym.) inquisitional
inkwizytor : inkwizytor : (rzecz.) inquisitor
inkwizytorski : inkwizytorski : (przym.) inquisitorial
inlet : inlet : (rzecz.) ticking
innowacja : innowacja : (rzecz.) innovation | : (rzecz.) novelty
innowacyjnosc : innowacyjność : (rzecz.) innovation
innowacyjny : innowacyjny : (przym.) innovative
innowator : innowator : (rzecz.) innovator
innowierca : innowierca : (rzecz.) dissenter | : (rzecz.) infidel
innowierczy : innowierczy : (przym.) heterodox
innowierstwo : innowierstwo : (rzecz.) heresy | : (rzecz.) heterodoxy
innosc : inność : (rzecz.) disaccord
inny : inny : (przym.) alternative | : (przym.) another | : (przym.) different | : (przym.) new | : (przym.) other | : (przym.) variant
inokulacja : inokulacja : (rzecz.) inoculation
inscenizacja : inscenizacja : (rzecz.) selling | : (rzecz.) setting | : (rzecz.) staging
inscenizacyjny : inscenizacyjny : (przym.) producer's
inscenizator : inscenizator : (rzecz.) producer | : (rzecz.) stage-manager
inscenizowac : inscenizować : (czas.) stage
insekt : insekt : (rzecz.) insect
insektycyd : insektycyd : (rzecz.) insecticide
inseminacja : inseminacja : (rzecz.) insemination
inskrypcja : inskrypcja : (rzecz.) inscription
inspekcja : inspekcja : (rzecz.) inspection | : (rzecz.) survey
inspekcyjny : inspekcyjny : (przym.) inspective
inspekt : inspekt : (rzecz.) hotbed
inspektor : inspektor : (rzecz.) inspector | : (rzecz.) surveyor
inspektorat : inspektorat : (rzecz.) inspectorate
inspiracja : inspiracja : (rzecz.) inspiration
inspirator : inspirator : (rzecz.) impeller | : (rzecz.) inspector
inspirowac : inspirować : (czas.) inspire
instalacja : instalacja : (rzecz.) installation | : (rzecz.) plant | : (rzecz.) plumbing
instalacyjny : instalacyjny : (przym.) installing
instalator : instalator : (rzecz.) engineer | : (rzecz.) fitter | : (rzecz.) installer
instalatorstwo : instalatorstwo : (rzecz.) plumbing
instalowanie : instalowanie : (rzecz.) installing
instalowac : instalować : (czas.) install | : (czas.) load | : (czas.) plumb | : (czas.) settle
instancja : instancja : (rzecz.) authority | : (rzecz.) instance
instrukcja : instrukcja : (rzecz.) instruction | : (rzecz.) manual | : (rzecz.) statement
instrukcyjny : instrukcyjny : (przym.) instructional
instruktaz : instruktaż : (rzecz.) instruction | : (rzecz.) training
instruktazowy : instruktażowy : (przym.) informative
instruktor : instruktor : (rzecz.) instructor | : (rzecz.) preceptor | : (rzecz.) trainer
instruktywny : instruktywny : (przym.) instructive
instrument : instrument : (rzecz.) instrument | : (rzecz.) tool
instrumentacja : instrumentacja : (rzecz.) fishing | : (rzecz.) instrumentation
instrumentalista : instrumentalista : (rzecz.) instrumentalist
instrumentalnie : instrumentalnie : (przysł.) instrumentally
instrumentalny : instrumentalny : (przym.) instrumental | : (przym.) instrumentals
instrumentarium : instrumentarium : (rzecz.) instruments | : (rzecz.) orchestra
instrumentowac : instrumentować : (czas.) fish
instruowanie : instruowanie : (rzecz.) instruction
instruowac : instruować : (czas.) instruct
instynkt : instynkt : (rzecz.) instinct
instynktownie : instynktownie : (przysł.) instinctively
instynktowny : instynktowny : (przym.) instinctive | : (przym.) instinctual | : (przym.) unconditioned
instynktowy : instynktowy : (przym.) instinctive
instytucja : instytucja : (rzecz.) establishment | : (rzecz.) institution | : (rzecz.) organisation
instytucjonalizacja : instytucjonalizacja : (rzecz.) institutionalization
instytucjonalizowac : instytucjonalizować : (czas.) institutionalize
instytucjonalnie : instytucjonalnie : (przysł.) institutionally
instytucjonalny : instytucjonalny : (przym.) institutional
instytut : instytut : (rzecz.) department | : (rzecz.) institute | : (rzecz.) school
insulina : insulina : (rzecz.) insulin
insurekcja : insurekcja : (rzecz.) insurrection | : (rzecz.) uprising
insygnia : insygnia : (rzecz.) ensign | : (rzecz.) insignia | : (rzecz.) regalia
insynuacja : insynuacja : (rzecz.) innuendo | : (rzecz.) insinuation
insynuacyjny : insynuacyjny : (przym.) insinuating
insynuowac : insynuować : (czas.) hint | : (czas.) imply | : (czas.) insinuate
intarsja : intarsja : (rzecz.) inlay | : (rzecz.) intarsia
integracja : integracja : (rzecz.) integration
integralnosc : integralność : (rzecz.) integrity
integralny : integralny : (przym.) integral
integrator : integrator : (rzecz.) integrator
integrowac : integrować : (czas.) integrate
intelekt : intelekt : (rzecz.) intellect
intelektualista : intelektualista : (rzecz.) highbrow | : (rzecz.) intellectual | : (rzecz.) intellectualist
intelektualizowac : intelektualizować : (czas.) intellectualize
intelektualnie : intelektualnie : (przysł.) intellectually
intelektualny : intelektualny : (przym.) cerebral | : (przym.) intellectual
inteligencja : inteligencja : (rzecz.) intelligence | : (rzecz.) intelligentsia | : (rzecz.) mind | : (rzecz.) wit
inteligencki : inteligencki : (przym.) intellectual
inteligent : inteligent : (rzecz.) highbrow | : (rzecz.) intellectual
inteligentnie : inteligentnie : (przysł.) intelligently
inteligentny : inteligentny : (przym.) adaptive | : (przym.) bright | : (przym.) brilliant | : (przym.) clever | : (przym.) intelligent
intencja : intencja : (rzecz.) intension | : (rzecz.) intention
intendent : intendent : (rzecz.) commissary | : (rzecz.) officer | : (rzecz.) purser | : (rzecz.) steward
intendentura : intendentura : (rzecz.) commissariat | : (rzecz.) stewardship
intensyfikacja : intensyfikacja : (rzecz.) intensification
intensyfikowac : intensyfikować : (czas.) intensify
intensywnie : intensywnie : (przysł.) badly | : (przysł.) intensely | : (przysł.) intensively
intensywnosc : intensywność : (rzecz.) intenseness | : (rzecz.) intensity
intensywny : intensywny : (przym.) deep | : (przym.) heavy | : (przym.) intense | : (przym.) intensive | : (przym.) strong
interakcja : interakcja : (rzecz.) interaction | : (rzecz.) interactivity
interakcyjnie : interakcyjnie : (przysł.) interactively
interakcyjny : interakcyjny : (przym.) interactive
interaktywnie : interaktywnie : (przysł.) interactively | : (przysł.) wholly
interaktywnosc : interaktywność : (rzecz.) interactivity
interaktywny : interaktywny : (przym.) interactive
intercyza : intercyza : (rzecz.) marriage
interdykt : interdykt : (rzecz.) ban | : (rzecz.) interdict
interdyscyplinarny : interdyscyplinarny : (przym.) interdisciplinary
interes : interes : (rzecz.) affair | : (rzecz.) bargain | : (rzecz.) business | : (rzecz.) deal | : (rzecz.) interest | : (rzecz.) job | : (rzecz.) shop | : (rzecz.) trade
interesant : interesant : (rzecz.) client
interesowac : interesować : (czas.) concern | : (czas.) interest
interesownosc : interesowność : (rzecz.) interest
interesowny : interesowny : (przym.) mercenary
interesujaco : interesująco : (przysł.) interestingly
interesujacy : interesujący : (przym.) interesting
interfejs : interfejs : (rzecz.) interface | : (rzecz.) interfaced | : (rzecz.) interfacing
interferencja : interferencja : (rzecz.) interference
interferometr : interferometr : (rzecz.) interferometer
interferon : interferon : (rzecz.) interferon
interferowac : interferować : (czas.) interfere
interfon : interfon : (rzecz.) interphone
interglacjalny : interglacjalny : (przym.) interglacial
interkom : interkom : (rzecz.) intercom
interlinearny : interlinearny : (przym.) interlineal | : (przym.) interlinear
interlinia : interlinia : (rzecz.) interline | : (rzecz.) space | : (rzecz.) spacing
interliniowac : interliniować : (czas.) lead
interlokutor : interlokutor : (rzecz.) interlocutor
interludium : interludium : (rzecz.) interlude
intermedium : intermedium : (rzecz.) interlude
internacjonalista : internacjonalista : (rzecz.) internationalist
internacjonalizacja : internacjonalizacja : (rzecz.) internationalization
internacjonalizm : internacjonalizm : (rzecz.) internationalism
internacjonalny : internacjonalny : (przym.) international
internalizacja : internalizacja : (rzecz.) internalisation | : (rzecz.) internalization
internat : internat : (rzecz.) boarding-house | : (rzecz.) boarding-school | : (rzecz.) dormitory | : (rzecz.) hostel
internauta : internauta : (rzecz.) web
internetowy : internetowy : (przym.) electronic
internista : internista : (rzecz.) internist
internowanie : internowanie : (rzecz.) internment
internowac : internować : (czas.) intern | : (czas.) interning
interpelacja : interpelacja : (rzecz.) interpellation
interpelant : interpelant : (rzecz.) questioner
interpersonalny : interpersonalny : (przym.) interpersonal
interpolacja : interpolacja : (rzecz.) interpolation
interpolator : interpolator : (rzecz.) interpolator
interpolowac : interpolować : (czas.) interpolate
interpretacja : interpretacja : (rzecz.) approach | : (rzecz.) interpretation | : (rzecz.) rendering | : (rzecz.) rendition
interpretacyjny : interpretacyjny : (przym.) interpretative | : (przym.) interpretive
interpretator : interpretator : (rzecz.) exponent | : (rzecz.) interpreter
interpreter : interpreter : (rzecz.) interpreter
interpretowac : interpretować : (czas.) construe | : (czas.) interpret | : (czas.) misinterpret | : (czas.) read
interpretujacy : interpretujący : (przym.) interpretive
interpunkcja : interpunkcja : (rzecz.) punctuation
intertyp : intertyp : (rzecz.) intertype
interwal : interwał : (rzecz.) compartment | : (rzecz.) interval | : (rzecz.) space
interwencja : interwencja : (rzecz.) intervention
interwencjonizm : interwencjonizm : (rzecz.) intervention
interwenient : interwenient : (rzecz.) intervener
interweniowac : interweniować : (czas.) intercede | : (czas.) interfere | : (czas.) intervene
interwent : interwent : (rzecz.) intervener
intoksykacja : intoksykacja : (rzecz.) intoxication
intonacja : intonacja : (rzecz.) cadence | : (rzecz.) intonation
intonowac : intonować : (czas.) intone
intranet : intranet : (rzecz.) intranet
intratnosc : intratność : (rzecz.) gain
intratny : intratny : (przym.) cushy | : (przym.) lucrative
introdukcja : introdukcja : (rzecz.) introduction
introligator : introligator : (rzecz.) binder | : (rzecz.) bookbinder
introligatornia : introligatornia : (rzecz.) bindery | : (rzecz.) bookbindery
introligatorstwo : introligatorstwo : (rzecz.) binding | : (rzecz.) bookbindery | : (rzecz.) bookbinding
intronizacja : intronizacja : (rzecz.) enthronement
intronizowac : intronizować : (czas.) enthrone
introspekcja : introspekcja : (rzecz.) introspection
introspekcyjny : introspekcyjny : (przym.) introspective
introspektywny : introspektywny : (przym.) indrawn | : (przym.) introspective
introwersja : introwersja : (rzecz.) introversion
introwersyjny : introwersyjny : (przym.) introverted
introwertyk : introwertyk : (rzecz.) introvert
intruz : intruz : (rzecz.) interloper | : (rzecz.) interrupter | : (rzecz.) intruder | : (rzecz.) trespasser
intruzja : intruzją : (rzecz.) intrusion
intryga : intryga : (rzecz.) cabal | : (rzecz.) intrigue | : (rzecz.) plot | : (rzecz.) schema | : (rzecz.) scheme
intrygancki : intrygancki : (przym.) intriguing
intrygant : intrygant : (rzecz.) intriguer | : (rzecz.) mischief-maker | : (rzecz.) plotter | : (rzecz.) schemer | : (rzecz.) stirrer | : (rzecz.) troublemaker
intrygowanie : intrygowanie : (rzecz.) machination
intrygowac : intrygować : (czas.) intrigue | : (czas.) machinate | : (czas.) plot | : (czas.) scheme
intuicja : intuicja : (rzecz.) insight | : (rzecz.) intuition
intuicjonizm : intuicjonizm : (rzecz.) intuitionism
intuicyjnie : intuicyjnie : (przysł.) intuitively
intuicyjny : intuicyjny : (przym.) intuitive
intymnie : intymnie : (przysł.) intimately | : (przysł.) privately
intymnosc : intymność : (rzecz.) intimacy
intymny : intymny : (przym.) intimate
inwalida : inwalida : (rzecz.) cripple | : (rzecz.) invalid
inwalidztwo : inwalidztwo : (rzecz.) disability | : (rzecz.) invalidism
inwar : inwar : (rzecz.) invar
inwariant : inwariant : (rzecz.) invariant
inwazja : inwazja : (rzecz.) inroad | : (rzecz.) invasion
inwazyjny : inwazyjny : (przym.) invasive
inwektywa : inwektywa : (rzecz.) invective
inwencja : inwencja : (rzecz.) creativity | : (rzecz.) invention | : (rzecz.) inventiveness
inwentaryzacja : inwentaryzacja : (rzecz.) inventory | : (rzecz.) stocktaking | : (rzecz.) stock-taking
inwentaryzator : inwentaryzator : (rzecz.) cataloguer
inwentarz : inwentarz : (rzecz.) inventory | : (rzecz.) stock
inwentarzowy : inwentarzowy : (przym.) inventorial
inwersja : inwersja : (rzecz.) inversion
inwertor : inwertor : (rzecz.) inverter
inwestor : inwestor : (rzecz.) developer | : (rzecz.) investor
inwestowanie : inwestowanie : (rzecz.) investment
inwestowac : inwestować : (czas.) invest
inwestycja : inwestycja : (rzecz.) investment
inwestycyjny : inwestycyjny : (przym.) entrepreneurial
inwestytura : inwestytura : (rzecz.) investiture
inwigilacja : inwigilacja : (rzecz.) surveillance
inwigilowac : inwigilować : (czas.) invigilate | : (czas.) superintend | : (czas.) watch
inwit : inwit : (rzecz.) invite
inwokacja : inwokacja : (rzecz.) invocation
inwokacyjny : inwokacyjny : (przym.) invocatory
inwolucja : inwolucja : (rzecz.) involution
inzynier : inżynier : (rzecz.) engineer
inzynieria : inżynieria : (rzecz.) engineering
inzynieryjny : inżynieryjny : (przym.) engineering
ircha : ircha : (rzecz.) chamois | : (rzecz.) deerskin | : (rzecz.) doeskin | : (rzecz.) suede | : (rzecz.) whitleather
ironia : ironia : (rzecz.) irony
ironicznie : ironicznie : (przysł.) ironically
ironiczny : ironiczny : (przym.) dried | : (przym.) driest | : (przym.) dry | : (przym.) ironic | : (przym.) ironical
ironista : ironista : (rzecz.) ironist
irracjonalizm : irracjonalizm : (rzecz.) irrationalism
irracjonalnie : irracjonalnie : (przysł.) irrationally
irracjonalnosc : irracjonalność : (rzecz.) irrationality
irracjonalny : irracjonalny : (przym.) irrational
irradiacja : irradiacja : (rzecz.) irradiation
iryd : iryd : (rzecz.) iridium
irygacja : irygacja : (rzecz.) irrigation
irygacyjny : irygacyjny : (przym.) irrigational
irygator : irygator : (rzecz.) irrigator
irygowac : irygować : (czas.) irrigate
irys : irys : (rzecz.) iris | : (rzecz.) toffee
irytacja : irytacja : (rzecz.) aggravation | : (rzecz.) annoyance | : (rzecz.) exasperation | : (rzecz.) fix | : (rzecz.) huff | : (rzecz.) irritation | : (rzecz.) testiness
irytowac : irytować : (czas.) annoy | : (czas.) chafe | : (czas.) displease | : (czas.) exasperate | : (czas.) irritate | : (czas.) nettle | : (czas.) rile | : (czas.) vex
irytujaco : irytująco : (przysł.) annoyingly
irytujacy : irytujący : (przym.) irritating
ischias : ischias : (rzecz.) sciatica
iskierka : iskierka : (rzecz.) spark | : (rzecz.) sparkle
iskra : iskra : (rzecz.) flake | : (rzecz.) spark | : (rzecz.) sparkle
iskrownik : iskrownik : (rzecz.) magneto
iskrzenie : iskrzenie : (rzecz.) kindling | : (rzecz.) scintillation | : (rzecz.) sparkle | : (rzecz.) sparks | : (rzecz.) twinkle | : (rzecz.) twinkling
iskrzyc : iskrzyć : (czas.) coruscate | : (czas.) kindle | : (czas.) scintillate | : (czas.) spark | : (czas.) sparkle
istnienie : istnienie : (rzecz.) availability | : (rzecz.) being | : (rzecz.) existence | : (rzecz.) subsistence
istniec : istnieć : (czas.) be | : (czas.) exist | : (czas.) subsist
istny : istny : (przym.) rank | : (przym.) real | : (przym.) regular | : (przym.) veritable
istota : istota : (rzecz.) backbone | : (rzecz.) being | : (rzecz.) creature | : (rzecz.) entity | : (rzecz.) essence | : (rzecz.) inbeing | : (rzecz.) inwardness | : (rzecz.) matter | : (rzecz.) spirit | : (rzecz.) stuff | : (rzecz.) substance | : (rzecz.) tenor | : (rzecz.) thing
istotnie : istotnie : (przysł.) actually | : (przysł.) essentially | : (przysł.) indeed | : (przysł.) significantly | : (przysł.) substantially | : (przysł.) substantively | : (przysł.) vitally
istotnosc : istotność : (rzecz.) pertinence | : (rzecz.) significance
istotny : istotny : (przym.) constitutive | : (przym.) essential | : (przym.) fundamental | : (przym.) imperative | : (przym.) intrinsic | : (przym.) quintessential | : (przym.) relevant | : (przym.) significant | : (przym.) substantial | : (przym.) valid | : (przym.) very | : (przym.) vital
iteracja : iteracja : (rzecz.) iteration
iteracyjny : iteracyjny : (przym.) iterative
iteratywny : iteratywny : (przym.) iterative
iterb : iterb : (rzecz.) ytterbium
itr : itr : (rzecz.) yttrium
izarytma : izarytma : (rzecz.) isarithm
izba : izba : (rzecz.) chamber | : (rzecz.) house | : (rzecz.) infirmary | : (rzecz.) room
izbica : izbica : (rzecz.) cutwater | : (rzecz.) ice-apron | : (rzecz.) ice-breaker | : (rzecz.) starling
izdebka : izdebka : (rzecz.) cubby
izobar : izobar : (rzecz.) isobar
izobara : izobara : (rzecz.) isobar
izobaryczny : izobaryczny : (przym.) isobaric
izobuten : izobuten : (rzecz.) isobutene
izochroniczny : izochroniczny : (przym.) isochronal | : (przym.) isochronous
izohalina : izohalina : (rzecz.) isohaline
izolacja : izolacja : (rzecz.) delay | : (rzecz.) detachment | : (rzecz.) insulation | : (rzecz.) isolation | : (rzecz.) privacy | : (rzecz.) recess | : (rzecz.) seclusion
izolacjonista : izolacjonista : (rzecz.) isolationist
izolacjonizm : izolacjonizm : (rzecz.) isolationism
izolacyjnosc : izolacyjność : (rzecz.) insulation
izolacyjny : izolacyjny : (przym.) insulating
izolatka : izolatka : (rzecz.) recess | : (rzecz.) sickroom
izolator : izolator : (rzecz.) insulator | : (rzecz.) isolator | : (rzecz.) non-conductor
izolowanie : izolowanie : (rzecz.) isolation
izolowany : izolowany : (przym.) insulated | : (przym.) isolated
izolowac : izolować : (czas.) insulate | : (czas.) isolate
izomer : izomer : (rzecz.) isomer
izomeria : izomeria : (rzecz.) isomerism
izomeryczny : izomeryczny : (przym.) isomeric
izometryczny : izometryczny : (przym.) isometric
izomorficzny : izomorficzny : (przym.) isomorphic
izomorfizm : izomorfizm : (rzecz.) isomorphism
izooktan : izooktan : (rzecz.) isooctane
izopren : izopren : (rzecz.) isoprene
izopropyl : izopropyl : (rzecz.) isopropyl
izoterma : izoterma : (rzecz.) isotherm
izotermiczny : izotermiczny : (przym.) isothermal
izotoniczny : izotoniczny : (przym.) isotonic
izotop : izotop : (rzecz.) isotope
izotopia : izotopia : (rzecz.) isotope
izotopowy : izotopowy : (przym.) isotopic
izotropia : izotropia : (rzecz.) isotropy
izotropowosc : izotropowość : (rzecz.) isotropy
izotropowy : izotropowy : (przym.) isotropic
il : ił : (rzecz.) clay | : (rzecz.) loam | : (rzecz.) silt
ilowiec : iłowiec : (rzecz.) mudstone
ilolupek : iłołupek : (rzecz.) clump | : (rzecz.) mudstone | : (rzecz.) shale
iscie : iście : (przysł.) really
isc : iść : (czas.) follow | : (czas.) go | : (czas.) retire | : (czas.) sashay | : (czas.) stride | : (czas.) trip | : (czas.) walk
iz : iż : (spójnik) that
