gabriel : Gabriel : (rzecz.) Gabriel
gabrielle : Gabrielle : (rzecz.) Gabriela
george : George : (rzecz.) Jerzy
greek : Greek : (rzecz.) greka
greeks : Greeks : (rzecz.) grek
greenpeace : Greenpeace : (rzecz.) Greenpeace
gregory : Gregory : (rzecz.) Grzegorz
g-load : g-load : (rzecz.) przeciążenie
gab : gab : (czas.) gadać | : (czas.) paplać | : (czas.) pleść | : (rzecz.) gadanie
gabardine : gabardine : (rzecz.) gabardyna
gabble : gabble : (czas.) gęgać | : (rzecz.) mamrotanie
gabbler : gabbler : (rzecz.) gaduła | : (rzecz.) trajkotka
gabby : gabby : (przym.) gadatliwy
gable : gable : (rzecz.) szczyt
gabled : gabled : (przym.) szczytowy
gad : gad : (czas.) szwendać | : (czas.) wałęsać
gadabout : gadabout : (rzecz.) latawica | : (rzecz.) łazęga | : (rzecz.) polatucha | : (rzecz.) powsinoga | : (rzecz.) włóczykij
gadfly : gadfly : (rzecz.) giez
gadget : gadget : (rzecz.) gadżet | : (rzecz.) przyrząd | : (rzecz.) urządzenie
gadolinium : gadolinium : (rzecz.) gadolin
gaff : gaff : (rzecz.) gafel | : (rzecz.) osęka
gaffe : gaffe : (rzecz.) gafa | : (rzecz.) wsypa
gaffer : gaffer : (rzecz.) dziadek | : (rzecz.) hutnik-mistrz | : (rzecz.) kum | : (rzecz.) kumoter
gag : gag : (czas.) kneblować | : (czas.) zakneblować | : (rzecz.) gag | : (rzecz.) knebel
gagallfly : gagallfly : (rzecz.) galasówka
gage : gage : (rzecz.) fant | : (rzecz.) zabezpieczenie | : (rzecz.) zastaw
gaggle : gaggle : (rzecz.) dyskusja | : (rzecz.) gadanina | : (rzecz.) gęganie | : (rzecz.) stado
gaiety : gaiety : (rzecz.) radość | : (rzecz.) wesołość
gaily : gaily : (przysł.) barwnie | : (przysł.) ochoczo | : (przysł.) swobodnie | : (przysł.) wesoło
gain : gain : (czas.) brać | : (czas.) nabrać | : (czas.) osiągać | : (czas.) pozyskać | : (czas.) przytyć | : (czas.) spieszyć | : (czas.) śpieszyć | : (czas.) utargować | : (czas.) uzyskać | : (czas.) uzyskiwać | : (czas.) wygrywać | : (czas.) zaczerpnąć | : (czas.) zarabiać | : (czas.) zdobyć | : (czas.) zdobywać | : (czas.) zdystansować | : (czas.) zyskać | : (czas.) zyskiwać | : (rzecz.) intratność | : (rzecz.) korzyść | : (rzecz.) przyrost | : (rzecz.) uzyskanie | : (rzecz.) uzyskiwanie | : (rzecz.) wrąb | : (rzecz.) wygrana | : (rzecz.) wzmocnienie | : (rzecz.) wzrost | : (rzecz.) zarobek | : (rzecz.) zdobycie | : (rzecz.) zysk | : (rzecz.) zyskanie
gainful : gainful : (przym.) korzystny
gainsay : gainsay : (czas.) zaprzeczyć
gait : gait : (rzecz.) chód | : (rzecz.) krok | : (rzecz.) rodzaj | : (rzecz.) sposób | : (rzecz.) zwyczaj
gaiter : gaiter : (rzecz.) kamasz
gaiters : gaiters : (rzecz.) getry
gal : gal : (rzecz.) panienka
gala : gala : (przym.) galowy | : (rzecz.) festyn
galactic : galactic : (przym.) galaktyczny
galantine : galantine : (rzecz.) galantyna
galaxy : galaxy : (rzecz.) galaktyka | : (rzecz.) plejada
gale : gale : (rzecz.) sztorm | : (rzecz.) wicher | : (rzecz.) wichura | : (rzecz.) zawierucha
galena : galena : (rzecz.) galena | : (rzecz.) galenit
gall : gall : (czas.) zaparzać | : (czas.) zirytować | : (rzecz.) galasówka | : (rzecz.) golizna | : (rzecz.) odgniecenie | : (rzecz.) oparzelina | : (rzecz.) żółć
gall-nut : gall-nut : (rzecz.) galas
gallant : gallant : (przym.) dzielny | : (przym.) miłosny | : (przym.) rycerski | : (przym.) szarmancki | : (przym.) uprzejmy | : (rzecz.) bawidamek | : (rzecz.) galant
gallantly : gallantly : (przysł.) mężnie | : (przysł.) wspaniale
gallantry : gallantry : (rzecz.) brawura | : (rzecz.) dzielność | : (rzecz.) galanteria | : (rzecz.) rycerskość
galleon : galleon : (rzecz.) galeon
gallery : gallery : (rzecz.) balkon | : (rzecz.) empora | : (rzecz.) galeria | : (rzecz.) galeryjka | : (rzecz.) ganek | : (rzecz.) jaskółka | : (rzecz.) krużganek | : (rzecz.) podium | : (rzecz.) przejście | : (rzecz.) sztolnia
galley : galley : (rzecz.) galera | : (rzecz.) galernik | : (rzecz.) galery | : (rzecz.) kambuz | : (rzecz.) organek | : (rzecz.) żółć
galleys : galleys : (rzecz.) kator
gallimaufry : gallimaufry : (rzecz.) bigos | : (rzecz.) mieszanina
gallium : gallium : (rzecz.) gal
gallivant : gallivant : (czas.) flirtować
gallnut : gallnut : (rzecz.) galas | : (rzecz.) galasówka
gallon : gallon : (rzecz.) galon | : (rzecz.) garniec
gallons : gallons : (rzecz.) galon
galloon : galloon : (rzecz.) borta | : (rzecz.) galon | : (rzecz.) naszywka | : (rzecz.) obszywka
gallop : gallop : (czas.) cwałować | : (czas.) galopować | : (czas.) oklepać | : (czas.) przegalopować | : (rzecz.) cwał | : (rzecz.) cwałowanie | : (rzecz.) galop
gallows : gallows : (rzecz.) szubienica
galoot : galoot : (rzecz.) fujara | : (rzecz.) gamoń
galore : galore : (przysł.) pełno
galosh : galosh : (rzecz.) deszczowiec | : (rzecz.) kalosz
galoshes : galoshes : (rzecz.) kalosze | : (rzecz.) śniegowce
galvanic : galvanic : (przym.) galwaniczny
galvanise : galvanise : (rzecz.) galwanizowanie
galvanised : galvanised : (przym.) galwaniczny
galvanising : galvanising : (rzecz.) cynkowanie
galvanism : galvanism : (rzecz.) galwanizm
galvanization : galvanization : (rzecz.) galwanizacja | : (rzecz.) galwanizowanie
galvanize : galvanize : (czas.) galwanizować | : (czas.) ocynkować
galvanizer : galvanizer : (rzecz.) elektrolizer | : (rzecz.) galwanizator
galvanometer : galvanometer : (rzecz.) galwanometr
galvanoscope : galvanoscope : (rzecz.) galwanoskop
gambit : gambit : (rzecz.) gambit
gamble : gamble : (czas.) ryzykować | : (czas.) spekulować | : (rzecz.) autostop | : (rzecz.) hazard | : (rzecz.) ryzyko | : (rzecz.) zakład
gambler : gambler : (rzecz.) gracz | : (rzecz.) hazardzista | : (rzecz.) karciarz | : (rzecz.) ryzykant | : (rzecz.) szuler
gambling : gambling : (rzecz.) hazard
gambol : gambol : (czas.) podskakiwać | : (rzecz.) pląs | : (rzecz.) podskok | : (rzecz.) skok
gambrel : gambrel : (rzecz.) pęcina
game : game : (przym.) dziarski | : (przym.) ochoczy | : (przym.) rezolutny | : (rzecz.) dziczyzna | : (rzecz.) gem | : (rzecz.) gra | : (rzecz.) hulanka | : (rzecz.) igrzyska | : (rzecz.) legumina | : (rzecz.) mecz | : (rzecz.) polowanie | : (rzecz.) rozgrywka | : (rzecz.) rozrywka | : (rzecz.) udawanie | : (rzecz.) zabawa | : (rzecz.) zabawianie | : (rzecz.) zawody | : (rzecz.) zwierzyna
game-drive : game-drive : (rzecz.) nagonka
game-keeper : game-keeper : (przym.) gajowy | : (rzecz.) leśnik
gamekeeper : gamekeeper : (rzecz.) leśnik
gamely : gamely : (przysł.) dzielnie | : (przysł.) ochoczo | : (przysł.) odważnie
gamester : gamester : (rzecz.) gracz
gamete : gamete : (rzecz.) gameta
gamin : gamin : (rzecz.) dzieciak | : (rzecz.) smarkacz | : (rzecz.) ulicznik
gaming : gaming : (rzecz.) hazard
gamma : gamma : (rzecz.) Gamma
gamma-active : gamma-active : (przym.) gamma-aktywny | : (przym.) gamma-promieniotwórczy
gamma-cellulose : gamma-cellulose : (rzecz.) gamma-celuloza
gammadion : gammadion : (rzecz.) swastyka
gammon : gammon : (rzecz.) baleron | : (rzecz.) oszustwo | : (rzecz.) szynka
gamp : gamp : (rzecz.) parasol
gamut : gamut : (rzecz.) gama | : (rzecz.) skala
gander : gander : (rzecz.) gąsior | : (rzecz.) gąsiorek | : (rzecz.) prostak | : (rzecz.) spojrzenie
gang : gang : (rzecz.) banda | : (rzecz.) brygada | : (rzecz.) ekipa | : (rzecz.) gang | : (rzecz.) grupa | : (rzecz.) paczka | : (rzecz.) seria | : (rzecz.) szajka | : (rzecz.) zespół
ganger : ganger : (rzecz.) brygadier | : (rzecz.) brygadzista | : (rzecz.) przodownik
ganglion : ganglion : (rzecz.) ganglion
gangplank : gangplank : (rzecz.) pomost | : (rzecz.) schodnia
gangrene : gangrene : (czas.) gangrenować | : (czas.) zgangrenować | : (rzecz.) gangrena | : (rzecz.) trak | : (rzecz.) zgorzel
gangrenous : gangrenous : (przym.) gangrenowy | : (przym.) zgorzelinowy | : (przym.) zgorzelowy
gangster : gangster : (rzecz.) bandyta | : (rzecz.) bandzior | : (rzecz.) gangster
gangway : gangway : (rzecz.) furta | : (rzecz.) kładka | : (rzecz.) pomost | : (rzecz.) przejście | : (rzecz.) schodnia | : (rzecz.) trap
gannet : gannet : (rzecz.) gap
gantlet : gantlet : (rzecz.) run
gantry : gantry : (rzecz.) brama | : (rzecz.) bramka | : (rzecz.) portal | : (rzecz.) stojak | : (rzecz.) suwnica
gaol : gaol : (czas.) uwięzić | : (rzecz.) więzienie
gaol-bird : gaol-bird : (rzecz.) kryminalista
gaolbird : gaolbird : (rzecz.) kryminalista
gap : gap : (rzecz.) luka | : (rzecz.) odstęp | : (rzecz.) otwór | : (rzecz.) przerwa | : (rzecz.) prześwit | : (rzecz.) różnica | : (rzecz.) szczerba | : (rzecz.) szpara | : (rzecz.) wyłom
gap-toothed : gap-toothed : (przym.) szczerbaty
gape : gape : (czas.) gapić | : (czas.) pękać | : (czas.) ziewać | : (rzecz.) otwór | : (rzecz.) rozwarcie | : (rzecz.) ziewanie
gape-seed : gape-seed : (rzecz.) gapienie | : (rzecz.) powód | : (rzecz.) przedmiot
gaper : gaper : (rzecz.) gawron | : (rzecz.) ziewacz
garage : garage : (czas.) garażować | : (rzecz.) garaż | : (rzecz.) powozownia | : (rzecz.) warsztat
garb : garb : (rzecz.) odzienie | : (rzecz.) odzież | : (rzecz.) strój | : (rzecz.) ubiór
garbage : garbage : (rzecz.) bezużyteczne | : (rzecz.) destruktor | : (rzecz.) odpadek | : (rzecz.) odpadki | : (rzecz.) śmieci | : (rzecz.) szmira | : (rzecz.) tandeta
garbanzo : garbanzo : (rzecz.) cieciorka | : (rzecz.) zakała
garbanzos : garbanzos : (rzecz.) cieciorka
garble : garble : (czas.) przekręcać
garden : garden : (rzecz.) ogród | : (rzecz.) ogródek | : (rzecz.) podwórze | : (rzecz.) sekator
gardener : gardener : (rzecz.) ogrodnik
gardenia : gardenia : (rzecz.) gardenia
gardening : gardening : (rzecz.) ogrodnictwo | : (rzecz.) warzywnictwo
garfish : garfish : (rzecz.) belona
gargantuan : gargantuan : (przym.) ogromny | : (przym.) olbrzymi
gargle : gargle : (czas.) bulgotać | : (czas.) płukać
gargoyle : gargoyle : (rzecz.) gargulec | : (rzecz.) rzygacz
garish : garish : (przym.) jaskrawy
garland : garland : (rzecz.) girlanda | : (rzecz.) wianek
garlic : garlic : (rzecz.) czosnek
garment : garment : (rzecz.) ciuch | : (rzecz.) garderoba | : (rzecz.) odzież | : (rzecz.) przyodziewek | : (rzecz.) strój | : (rzecz.) szata
garner : garner : (rzecz.) przechowywanie | : (rzecz.) spichlerz | : (rzecz.) spichrz | : (rzecz.) zbieranie
garnet : garnet : (rzecz.) granat
garnierite : garnierite : (rzecz.) garnieryt
garnish : garnish : (czas.) garnirować | : (czas.) przybierać | : (czas.) upiększać | : (czas.) zdobić | : (rzecz.) ozdabianie | : (rzecz.) ozdoba | : (rzecz.) przybranie
garniture : garniture : (rzecz.) garnitur
garret : garret : (rzecz.) mansarda | : (rzecz.) poddasze
garrison : garrison : (rzecz.) garnizon
garrotte : garrotte : (rzecz.) zaduszenie
garrulity : garrulity : (rzecz.) gadulstwo | : (rzecz.) szczebiotliwość
garrulous : garrulous : (przym.) rozmowny | : (przym.) szczebiotliwy
garter : garter : (rzecz.) podwiązka
gas : gas : (czas.) gazować | : (rzecz.) benzyna | : (rzecz.) gaz | : (rzecz.) gazownictwo
gas-fitter : gas-fitter : (rzecz.) monter
gas-meter : gas-meter : (rzecz.) gazometr | : (rzecz.) gazomierz
gas-ring : gas-ring : (rzecz.) palnik
gas-tight : gas-tight : (przym.) gazoszczelny
gas-works : gas-works : (rzecz.) gazownia
gaseous : gaseous : (przym.) gazowy | : (przym.) lotny
gasfitter : gasfitter : (rzecz.) monter
gash : gash : (czas.) pokiereszować | : (czas.) przecinać | : (czas.) przeorać | : (czas.) rozcinać | : (rzecz.) nacięcie | : (rzecz.) rana | : (rzecz.) rowek
gasification : gasification : (rzecz.) gazyfikacja | : (rzecz.) zgazowanie | : (rzecz.) zgazowywanie
gasket : gasket : (rzecz.) uszczelka
gasman : gasman : (rzecz.) metaniarz
gasoline : gasoline : (rzecz.) benzyna | : (rzecz.) paliwo
gasp : gasp : (czas.) dyszeć | : (czas.) sapać | : (rzecz.) dyszenie | : (rzecz.) sapanie
gasser : gasser : (rzecz.) fanfaron | : (rzecz.) gaduła
gassing : gassing : (rzecz.) gazowanie
gassy : gassy : (przym.) gazowany | : (przym.) gazowy | : (przym.) zagazowany
gastight : gastight : (przym.) gazoszczelny
gastric : gastric : (przym.) gastryczny | : (przym.) żołądkowy
gastrointestinal : gastrointestinal : (przym.) pokarmowy
gastronome : gastronome : (rzecz.) gastronom | : (rzecz.) smakosz
gastronomy : gastronomy : (rzecz.) gastronomia
gasworks : gasworks : (rzecz.) gazownia
gat : gat : (rzecz.) karabin | : (rzecz.) pistolet | : (rzecz.) rewolwer
gate : gate : (rzecz.) brama | : (rzecz.) bramka | : (rzecz.) furtka | : (rzecz.) szlaban | : (rzecz.) wrota | : (rzecz.) zapora
gate-keeper : gate-keeper : (rzecz.) dróżnik
gatehouse : gatehouse : (rzecz.) portiernia | : (rzecz.) stróżówka
gatekeeper : gatekeeper : (rzecz.) dróżnik | : (rzecz.) portier
gateman : gateman : (rzecz.) dróżnik
gates : gates : (rzecz.) wrota
gateway : gateway : (rzecz.) brama | : (rzecz.) furtka | : (rzecz.) pomost | : (rzecz.) przejście | : (rzecz.) wejście | : (rzecz.) wjazd
gather : gather : (czas.) gromadzić | : (czas.) narwać | : (czas.) zbierać | : (czas.) zgarniać | : (czas.) zrywać | : (rzecz.) gromadzenie | : (rzecz.) nabieranie | : (rzecz.) pobranie | : (rzecz.) porcja | : (rzecz.) wnioskowanie | : (rzecz.) zbieranie | : (rzecz.) zgromadzenie
gatherer : gatherer : (rzecz.) zbieracz
gathering : gathering : (rzecz.) jarzyn | : (rzecz.) nabieranie | : (rzecz.) owocobranie | : (rzecz.) podpisywanie | : (rzecz.) zbiegowisko | : (rzecz.) zbiorowisko | : (rzecz.) zebranie | : (rzecz.) zgromadzenie | : (rzecz.) zlot
gating : gating : (rzecz.) bramkowanie
gauche : gauche : (przym.) nietaktowny | : (przym.) niezręczny
gaucherie : gaucherie : (rzecz.) niezręczność
gaud : gaud : (rzecz.) błyskotka | : (rzecz.) dyszel
gaudiness : gaudiness : (rzecz.) barwność
gaudy : gaudy : (przym.) barwny | : (przym.) błyskotliwy | : (przym.) jaskrawy | : (przym.) krzykliwy | : (przym.) pstrokaty | : (przym.) pstry
gauge : gauge : (czas.) mierzyć | : (rzecz.) gabaryt | : (rzecz.) kaliber | : (rzecz.) manometr | : (rzecz.) miara | : (rzecz.) probierz | : (rzecz.) przymiar | : (rzecz.) skala | : (rzecz.) skrajnia | : (rzecz.) sprawdzian | : (rzecz.) szablon | : (rzecz.) wskaźnik
gaunt : gaunt : (przym.) chudy | : (przym.) nagi | : (przym.) nędzny | : (przym.) nieszczęśliwy
gauntlet : gauntlet : (rzecz.) rękawica
gauntness : gauntness : (rzecz.) chudość
gauss : gauss : (rzecz.) gaus
gauze : gauze : (rzecz.) gaza
gavel : gavel : (rzecz.) młotek | : (rzecz.) pokos
gavelkind : gavelkind : (rzecz.) tenuta
gavotte : gavotte : (rzecz.) gawot
gawk : gawk : (rzecz.) fajtłapa | : (rzecz.) gamoń | : (rzecz.) gawron
gawky : gawky : (przym.) gamoniowaty | : (przym.) niezdarny
gay : gay : (przym.) bezmyślny | : (przym.) homoseksualny | : (przym.) radosny | : (przym.) rozpustny | : (przym.) wesoły | : (przym.) żywy | : (rzecz.) gej | : (rzecz.) homoseksualista | : (rzecz.) pedał
gayness : gayness : (rzecz.) homoseksualizm
gaze : gaze : (czas.) patrzeć | : (czas.) przyglądać | : (czas.) wpatrywać | : (rzecz.) spoglądanie | : (rzecz.) spojrzenie | : (rzecz.) wpatrywanie | : (rzecz.) wzrok
gazelle : gazelle : (rzecz.) gazela
gazette : gazette : (rzecz.) gazeta
gazetteer : gazetteer : (rzecz.) dziennikarz
gear : gear : (rzecz.) bieg | : (rzecz.) hełm | : (rzecz.) łach | : (rzecz.) mechanizm | : (rzecz.) narzędzia | : (rzecz.) odzież | : (rzecz.) przekładnia | : (rzecz.) przerzutka | : (rzecz.) przybory | : (rzecz.) rynsztunek | : (rzecz.) rzecz | : (rzecz.) sprzęt
gear-motor : gear-motor : (rzecz.) motoreduktor
gearbox : gearbox : (rzecz.) skrzynia
gecko : gecko : (rzecz.) jaszczurka
gee : gee : (wykrzyknik) ojej
geek : geek : (rzecz.) maniak | : (rzecz.) palant | : (rzecz.) świr
geese : geese : (rzecz.) gęś
geezer : geezer : (rzecz.) pryk
geisha : geisha : (rzecz.) gejsza
gel : gel : (rzecz.) żel
gelatine : gelatine : (rzecz.) żelatyna
gelatinize : gelatinize : (czas.) galaretowacieć
gelatinous : gelatinous : (przym.) galaretowaty
geld : geld : (czas.) czyścić | : (czas.) kastrować | : (czas.) wałaszyć
gelding : gelding : (rzecz.) wałach
gelid : gelid : (przym.) lodowaty | : (przym.) zimny
gem : gem : (rzecz.) cacko | : (rzecz.) klejnot
geminate : geminate : (czas.) podwajać | : (przym.) parzysty | : (przym.) podwójny
gendarme : gendarme : (rzecz.) żandarm
gendarmerie : gendarmerie : (rzecz.) żandarmeria
gender : gender : (rzecz.) płeć | : (rzecz.) rodzaj
gene : gene : (rzecz.) gen
genealogical : genealogical : (przym.) genealogiczny | : (przym.) rodowodowy
genealogy : genealogy : (rzecz.) genealogia | : (rzecz.) rodowód
general : general : (przym.) generalny | : (przym.) główny | : (przym.) ogólnikowy | : (przym.) ogólnobudowlany | : (przym.) ogólnogospodarczy | : (przym.) ogólny | : (przym.) walny | : (rzecz.) generał | : (rzecz.) loża | : (rzecz.) makroekonomia | : (rzecz.) ogólność
general-purpose : general-purpose : (przym.) uniwersalny
generalisation : generalisation : (rzecz.) uogólnienie
generality : generality : (rzecz.) ogólnik | : (rzecz.) ogólność | : (rzecz.) powszechność
generalization : generalization : (rzecz.) generalizacja | : (rzecz.) uogólnianie | : (rzecz.) uogólnienie
generalize : generalize : (czas.) generalizować | : (czas.) uogólniać
generalized : generalized : (czas.) uogólnić | : (przym.) ogólny | : (przym.) uniwersalny
generally : generally : (przysł.) generalnie | : (przysł.) ogólnie | : (przysł.) ogólnikowo | : (przysł.) powszechnie | : (przysł.) zazwyczaj | : (przysł.) zwykle
generals : generals : (rzecz.) generalicja
generate : generate : (czas.) generować | : (czas.) rodzić | : (czas.) spłodzić | : (czas.) tworzyć | : (czas.) wygenerować | : (czas.) wypracowywać | : (czas.) wytwarzać | : (czas.) wywoływać
generation : generation : (rzecz.) generacja | : (rzecz.) pokolenie | : (rzecz.) rocznik | : (rzecz.) ród | : (rzecz.) rodzenie | : (rzecz.) wytwarzanie
generative : generative : (przym.) generatywny | : (przym.) produkcyjny | : (przym.) rozrodczy
generator : generator : (rzecz.) generator | : (rzecz.) prądnica
generic : generic : (przym.) genetyczny | : (przym.) ogólny | : (przym.) pospolity | : (przym.) rodzajowy
generically : generically : (przysł.) ogólnie
generosity : generosity : (rzecz.) hojność | : (rzecz.) ofiarność | : (rzecz.) szczodrobliwość | : (rzecz.) szczodrość | : (rzecz.) szlachetność | : (rzecz.) wielkoduszność | : (rzecz.) wspaniałomyślność
generous : generous : (przym.) hojny | : (przym.) ofiarny | : (przym.) szczodrobliwy | : (przym.) szczodry | : (przym.) szlachetny | : (przym.) wielkoduszny | : (przym.) wspaniałomyślny
generously : generously : (przysł.) hojnie | : (przysł.) ofiarnie | : (przysł.) rozrzutnie | : (przysł.) sowicie | : (przysł.) szczodrze | : (przysł.) wielkodusznie | : (przysł.) wspaniałomyślnie
genes : genes : (rzecz.) geny
genesis : genesis : (rzecz.) geneza | : (rzecz.) rodowód
genetic : genetic : (przym.) genetyczny | : (przym.) genowy
genetically : genetically : (przysł.) genetycznie
geneticist : geneticist : (rzecz.) genetyk
genetics : genetics : (rzecz.) genetyka
genial : genial : (przym.) dobrotliwy | : (przym.) łagodny | : (przym.) miły | : (przym.) podbródkowy | : (przym.) przychylny | : (przym.) radosny | : (przym.) uprzejmy | : (przym.) wesoły
geniality : geniality : (rzecz.) wesołość
genially : genially : (przysł.) genialnie | : (przysł.) przyjaźnie
genie : genie : (rzecz.) geniusz
genital : genital : (przym.) rodny | : (przym.) rozrodczy
genitals : genitals : (rzecz.) genitalia
genitive : genitive : (rzecz.) dopełniacz
genius : genius : (rzecz.) genialność | : (rzecz.) geniusz | : (rzecz.) talent
genocide : genocide : (rzecz.) ludobójca | : (rzecz.) ludobójstwo
genome : genome : (rzecz.) genom
genotype : genotype : (rzecz.) genotyp
genotyping : genotyping : (przym.) genotypowy
genre : genre : (rzecz.) gatunek | : (rzecz.) rodzaj
gent : gent : (rzecz.) dżentelmen
genteel : genteel : (przym.) dystyngowany
gentian : gentian : (rzecz.) gencjana | : (rzecz.) goryczka
gentile : gentile : (rzecz.) goj | : (rzecz.) poganin
gentility : gentility : (rzecz.) dystynkcja
gentle : gentle : (przym.) cichy | : (przym.) delikatny | : (przym.) łagodny | : (przym.) miły | : (przym.) szlachetny
gentleman : gentleman : (rzecz.) dżentelmen | : (rzecz.) jegomość | : (rzecz.) pan
gentlemanlike : gentlemanlike : (przym.) dżentelmeński
gentlemanly : gentlemanly : (przym.) dżentelmeński
gentleness : gentleness : (rzecz.) delikatność | : (rzecz.) łagodność | : (rzecz.) subtelność
gentlest : gentlest : (przym.) delikatny | : (przym.) łagodny
gentlewoman : gentlewoman : (rzecz.) dama
gently : gently : (przysł.) delikatnie | : (przysł.) łagodnie | : (przysł.) lekko | : (przysł.) miękko | : (przysł.) uprzejmie
gentry : gentry : (rzecz.) szlachta | : (rzecz.) ziemiaństwo
genuflect : genuflect : (czas.) uklęknąć
genuflection : genuflection : (rzecz.) przyklęknięcie
genuine : genuine : (przym.) autentyczny | : (przym.) oryginalny | : (przym.) prawdziwy | : (przym.) szczery
genuinely : genuinely : (przysł.) prawdziwie | : (przysł.) rdzennie
genuineness : genuineness : (rzecz.) autentyczność | : (rzecz.) prawdziwość
genus : genus : (rzecz.) gatunek | : (rzecz.) klasa | : (rzecz.) rodzaj
geocentric : geocentric : (przym.) geocentryczny
geochemistry : geochemistry : (rzecz.) geochemia
geode : geode : (rzecz.) druza | : (rzecz.) geoda
geodesic : geodesic : (przym.) geodezyjny
geodesist : geodesist : (rzecz.) geodeta
geodesy : geodesy : (rzecz.) geodezja
geodetic : geodetic : (przym.) geodezyjny
geodynamics : geodynamics : (rzecz.) geodynamika
geographer : geographer : (rzecz.) geograf
geographic : geographic : (przym.) geograficzny
geographical : geographical : (przym.) geograficzny
geographically : geographically : (przysł.) geograficznie
geography : geography : (rzecz.) geografia
geologic : geologic : (przym.) geologiczny
geological : geological : (przym.) geologiczny
geologically : geologically : (przysł.) geologicznie
geologist : geologist : (rzecz.) geolog
geology : geology : (rzecz.) geolog | : (rzecz.) geologia
geomagnetic : geomagnetic : (przym.) geomagnetyczny
geomagnetism : geomagnetism : (rzecz.) geomagnetyzm
geometer : geometer : (rzecz.) geometra
geometric : geometric : (przym.) geometryczny
geometrical : geometrical : (przym.) geometryczny
geometrically : geometrically : (przysł.) geometrycznie
geometry : geometry : (rzecz.) geometria
geomorphology : geomorphology : (rzecz.) geologia | : (rzecz.) geomorfologia
geophone : geophone : (rzecz.) geofon
geophysical : geophysical : (przym.) geofizyczny
geophysicist : geophysicist : (rzecz.) geofizyk
geophysics : geophysics : (rzecz.) geofizyka
geopolitical : geopolitical : (przym.) geopolityczny
geopolitics : geopolitics : (rzecz.) geopolityka
georgette : georgette : (rzecz.) żorżeta
geothermal : geothermal : (przym.) geotermiczny
geotropism : geotropism : (rzecz.) geotropizm
geranium : geranium : (rzecz.) geranium | : (rzecz.) pelargonia
gerent : gerent : (rzecz.) kierownik
gerfalcon : gerfalcon : (rzecz.) białozór
geriatric : geriatric : (przym.) geriatryczny
geriatrician : geriatrician : (rzecz.) geriatra
geriatrics : geriatrics : (rzecz.) geriatria
germ : germ : (rzecz.) bakcyl | : (rzecz.) drobnoustrój | : (rzecz.) zalążek | : (rzecz.) zarazek | : (rzecz.) zarodek
germanium : germanium : (rzecz.) german
germicidal : germicidal : (przym.) bakteriobójczy
germicide : germicide : (przym.) bakteriobójczy
germinal : germinal : (przym.) zarodkowy
germinate : germinate : (czas.) kiełkować | : (czas.) porastać | : (czas.) rozwijać | : (czas.) wykiełkować
germination : germination : (rzecz.) kiełkowanie | : (rzecz.) słodowanie | : (rzecz.) wschodzenie
gerontology : gerontology : (rzecz.) gerontologia
gesso : gesso : (rzecz.) gips
gestation : gestation : (rzecz.) ciąża | : (rzecz.) rozwój
gestational : gestational : (przym.) ciążowy
gesticulate : gesticulate : (czas.) gestykulować
gesticulation : gesticulation : (rzecz.) gestykulacja
gesture : gesture : (rzecz.) gest
get : get : (czas.) dojechać | : (czas.) dojść | : (czas.) dostać | : (czas.) dostawać | : (czas.) dotrzeć | : (czas.) dowiedzieć | : (czas.) kupić | : (czas.) nabawić | : (czas.) narobić | : (czas.) otrzymać | : (czas.) otrzymywać | : (czas.) pobierać | : (czas.) przynieść | : (czas.) przynosić | : (czas.) robić | : (czas.) sprowadzać | : (czas.) stać | : (czas.) stawać | : (czas.) wpływać | : (czas.) wsiadać | : (czas.) wsypać | : (czas.) wywabić | : (czas.) zaczynać | : (czas.) zostać
get-at-able : get-at-able : (przym.) osiągalny
get-together : get-together : (rzecz.) spotkanie | : (rzecz.) zebranie
get-up-and-go : get-up-and-go : (rzecz.) entuzjazm | : (rzecz.) rozmach
getaway : getaway : (rzecz.) ucieczka
getter : getter : (rzecz.) pochłaniacz | : (rzecz.) rębacz | : (rzecz.) rodzicielka | : (rzecz.) urabiarka
getting : getting : (czas.) porabiać
getup : getup : (rzecz.) reżyseria
gewgaw : gewgaw : (rzecz.) ozdóbka
geyser : geyser : (rzecz.) gejzer | : (rzecz.) grzałka
ghastliness : ghastliness : (rzecz.) okropność
ghastly : ghastly : (przym.) blady | : (przym.) koszmarny | : (przym.) makabryczny | : (przym.) ohydny | : (przym.) okropny | : (przym.) straszny | : (przym.) upiorny
gherkin : gherkin : (rzecz.) korniszon
gherkins : gherkins : (rzecz.) korniszon
ghetto : ghetto : (rzecz.) getto
ghost : ghost : (rzecz.) cień | : (rzecz.) duch | : (rzecz.) upiór | : (rzecz.) widmo | : (rzecz.) zjawa
ghostlike : ghostlike : (przym.) upiorny
ghostly : ghostly : (przym.) duchowy | : (przym.) upiorny | : (przym.) widmowy
ghoul : ghoul : (rzecz.) upiór
ghoulish : ghoulish : (przym.) makabryczny
giant : giant : (przym.) gigantyczny | : (przym.) olbrzymi | : (rzecz.) gigant | : (rzecz.) kolos | : (rzecz.) olbrzym | : (rzecz.) wielkolud
gibber : gibber : (czas.) bełkotać | : (czas.) szwargotać | : (rzecz.) bełkot | : (rzecz.) bełkotanie
gibberish : gibberish : (rzecz.) bełkot | : (rzecz.) bełkotanie | : (rzecz.) szwargot | : (rzecz.) szwargotanie
gibbet : gibbet : (rzecz.) szubienica
gibbon : gibbon : (rzecz.) gibon
gibbous : gibbous : (przym.) garbaty
gibbsite : gibbsite : (rzecz.) hydrargilit
gibe : gibe : (czas.) drwić | : (czas.) kpić | : (rzecz.) docinek | : (rzecz.) kpina | : (rzecz.) przycinek | : (rzecz.) przymówka
giber : giber : (rzecz.) kpiarz
giblets : giblets : (rzecz.) dróbka | : (rzecz.) podroby
giddily : giddily : (przysł.) zawrotnie
giddiness : giddiness : (rzecz.) lekkomyślność
giddy : giddy : (przym.) lekkomyślny | : (przym.) płochy | : (przym.) roztrzepany | : (przym.) zawrotny
gift : gift : (rzecz.) dar | : (rzecz.) darowizna | : (rzecz.) podarek | : (rzecz.) podarunek | : (rzecz.) prezent | : (rzecz.) upominek | : (rzecz.) uzdolnienie
gifted : gifted : (przym.) utalentowany | : (przym.) zdolny
gig : gig : (rzecz.) dwukółka | : (rzecz.) gig | : (rzecz.) gigabajt | : (rzecz.) koncert | : (rzecz.) skip
gigabyte : gigabyte : (rzecz.) gigabajt
gigabytes : gigabytes : (rzecz.) gigabajt
gigahertz : gigahertz : (rzecz.) gigaherc
gigantic : gigantic : (przym.) gigantyczny | : (przym.) olbrzymi | : (przym.) przeogromny
gigantically : gigantically : (przysł.) gigantycznie
giggle : giggle : (czas.) chichotać | : (rzecz.) chichot | : (rzecz.) chichotanie
gigolo : gigolo : (rzecz.) fordanser | : (rzecz.) żigolak
gild : gild : (czas.) osłodzić | : (czas.) pozłacać | : (czas.) złocić | : (rzecz.) gildia
gilder : gilder : (rzecz.) złotnik
gill : gill : (czas.) wypatroszyć | : (rzecz.) skrzele
gilled : gilled : (rzecz.) oskrobanie
gillie : gillie : (rzecz.) sługa
gillyflower : gillyflower : (rzecz.) goździk | : (rzecz.) lewkonia
gilt : gilt : (rzecz.) loszka | : (rzecz.) pozłota | : (rzecz.) złocenie
gilt-edged : gilt-edged : (przym.) cenny
gilthead : gilthead : (rzecz.) dorada
gimcrack : gimcrack : (przym.) straganowy | : (przym.) szychowy | : (rzecz.) cacko
gimmick : gimmick : (rzecz.) chwyt | : (rzecz.) machlojka | : (rzecz.) sztuczka | : (rzecz.) urządzenie
gimmicky : gimmicky : (przym.) wymyślny
gimp : gimp : (rzecz.) galon | : (rzecz.) żyłka
gin : gin : (rzecz.) dżin | : (rzecz.) jałowcówka | : (rzecz.) kołowrót
ginger : ginger : (rzecz.) energia | : (rzecz.) imbir | : (rzecz.) werwa
ginger-haired : ginger-haired : (przym.) rudy | : (przym.) ryży
gingerbread : gingerbread : (rzecz.) miodownik | : (rzecz.) piernik | : (rzecz.) pumpernikiel
gingerly : gingerly : (przysł.) delikatnie | : (przysł.) ostrożnie
gingery : gingery : (przym.) imbirowy | : (przym.) piernikowy
gingham : gingham : (rzecz.) kratka
gingival : gingival : (przym.) dziąsłowy
gink : gink : (rzecz.) facet
gipsy : gipsy : (rzecz.) cygan
giraffe : giraffe : (rzecz.) żyrafa
girandole : girandole : (rzecz.) wodotrysk
girasol : girasol : (przym.) ognisty
gird : gird : (czas.) kpić | : (czas.) opasać | : (czas.) opasywać | : (czas.) przepasywać
girder : girder : (rzecz.) dźwigar | : (rzecz.) opasanie | : (rzecz.) pasek
girdle : girdle : (czas.) obrączkować | : (czas.) opasać | : (czas.) opasywać | : (czas.) przepasać | : (rzecz.) gorset | : (rzecz.) pasek | : (rzecz.) podpaska
girl : girl : (rzecz.) buzia | : (rzecz.) dziewczyna | : (rzecz.) dziewczynka | : (rzecz.) dziewica | : (rzecz.) dziewucha | : (rzecz.) panienka | : (rzecz.) panna
girlfriend : girlfriend : (rzecz.) dziewczyna | : (rzecz.) sympatia
girlie : girlie : (rzecz.) brzana
girlish : girlish : (przym.) dziewczęcy
girls : girls : (rzecz.) girlsa
giro : giro : (rzecz.) przelew
girth : girth : (rzecz.) obwód | : (rzecz.) popręg
gist : gist : (rzecz.) sedno
give : give : (czas.) dać | : (czas.) darować | : (czas.) darzyć | : (czas.) dawać | : (czas.) domierzać | : (czas.) podać | : (czas.) podarować | : (czas.) podawać | : (czas.) przekazywać | : (czas.) rozdawać | : (czas.) wydawać
give-away : give-away : (rzecz.) wpadka | : (rzecz.) wsyp | : (rzecz.) wsypa
giveaway : giveaway : (rzecz.) wpadka
given : given : (przym.) dany | : (przym.) skłonny
giver : giver : (rzecz.) dawca | : (rzecz.) jałmużnik
gizmo : gizmo : (rzecz.) gadżet | : (rzecz.) ustrojstwo
gizzard : gizzard : (rzecz.) gardło
glacial : glacial : (przym.) lodowaty | : (przym.) lodowcowy | : (przym.) lodowy | : (przym.) polodowcowy
glacier : glacier : (rzecz.) lodowiec
glaciology : glaciology : (rzecz.) glacjologia
glad : glad : (przym.) radosny | : (przym.) wesoły | : (przym.) zadowolony
gladden : gladden : (czas.) cieszyć | : (czas.) radować | : (czas.) uradować | : (czas.) weselić
glade : glade : (rzecz.) polana | : (rzecz.) polanka | : (rzecz.) polanko | : (rzecz.) polano | : (rzecz.) przesieka
gladiator : gladiator : (rzecz.) gladiator
gladiatorial : gladiatorial : (przym.) gladiatorski
gladiola : gladiola : (rzecz.) mieczyk
gladiolus : gladiolus : (rzecz.) mieczyk
gladly : gladly : (przysł.) chętnie | : (przysł.) radośnie
gladness : gladness : (rzecz.) radość | : (rzecz.) zadowolenie
gladsome : gladsome : (przym.) radosny
glair : glair : (rzecz.) białko
glaive : glaive : (rzecz.) miecz
glamorous : glamorous : (przym.) czarowny
glamour : glamour : (rzecz.) blask | : (rzecz.) czar | : (rzecz.) splendor | : (rzecz.) świetność | : (rzecz.) urok
glance : glance : (czas.) błyszczeć | : (czas.) łypać | : (czas.) popatrzeć | : (czas.) spoglądać | : (czas.) spojrzeć | : (czas.) wypolerować | : (czas.) zerkać | : (czas.) zerknąć | : (czas.) ześlizgiwać | : (rzecz.) błyszcz | : (rzecz.) błyszczenie | : (rzecz.) rykoszet | : (rzecz.) spojrzenie | : (rzecz.) zerknięcie
gland : gland : (rzecz.) dławica | : (rzecz.) dławik | : (rzecz.) dławnica | : (rzecz.) gruczoł
glandular : glandular : (przym.) gruczołowaty | : (przym.) gruczołowy
glare : glare : (czas.) błyskać | : (czas.) błyszczeć | : (czas.) jaśnieć | : (czas.) świecić | : (rzecz.) blask | : (rzecz.) blichtr | : (rzecz.) olśnienie
glaring : glaring : (przym.) jaskrawy
glaringly : glaringly : (przysł.) jaskrawo | : (przysł.) krzycząco
glass : glass : (rzecz.) kieliszek | : (rzecz.) lampka | : (rzecz.) oszklenie | : (rzecz.) szkiełko | : (rzecz.) szklanka | : (rzecz.) szkło | : (rzecz.) szyba
glass-blower : glass-blower : (rzecz.) dmuchacz | : (rzecz.) wydymacz
glass-cue : glass-cue : (rzecz.) gablotka | : (rzecz.) witryna
glass-house : glass-house : (rzecz.) szklarnia
glass-making : glass-making : (rzecz.) szklarstwo
glassblower : glassblower : (rzecz.) dmuchacz | : (rzecz.) wydymacz
glasses : glasses : (rzecz.) etui | : (rzecz.) gogle | : (rzecz.) okulary
glassful : glassful : (rzecz.) szklanka
glasshouse : glasshouse : (rzecz.) areszt | : (rzecz.) szklarnia
glassine : glassine : (rzecz.) celofan
glassiness : glassiness : (rzecz.) szklistość
glasslike : glasslike : (przym.) szklisty
glassmaking : glassmaking : (rzecz.) szklarstwo
glassy : glassy : (przym.) mętny | : (przym.) szklisty
glaucoma : glaucoma : (rzecz.) jaskra
glaucomatous : glaucomatous : (przym.) jaskrawy
glaze : glaze : (czas.) glazurować | : (czas.) laserować | : (czas.) oszklić | : (czas.) szklić | : (czas.) zaszklić | : (rzecz.) emalia | : (rzecz.) glazura | : (rzecz.) gołoledź | : (rzecz.) polewa | : (rzecz.) ślizgawica | : (rzecz.) szkliwo
glazier : glazier : (rzecz.) szklarz
gleam : gleam : (czas.) błyszczeć | : (czas.) migotać | : (czas.) połyskiwać | : (czas.) świecić | : (rzecz.) blask | : (rzecz.) lśnienie | : (rzecz.) migot | : (rzecz.) odblask | : (rzecz.) połyskiwanie | : (rzecz.) przebłysk
glean : glean : (czas.) gromadzić | : (czas.) zbierać
gleanings : gleanings : (rzecz.) pokłosie
glebe : glebe : (rzecz.) gleba | : (rzecz.) ziemia
glee : glee : (rzecz.) radość | : (rzecz.) uciecha | : (rzecz.) wesele
gleeful : gleeful : (przym.) radosny
glen : glen : (rzecz.) dolina | : (rzecz.) wąwóz
glib : glib : (przym.) gładki | : (przym.) płynny | : (przym.) wymowny | : (przym.) żwawy
glibly : glibly : (przysł.) gładko
glibness : glibness : (rzecz.) gładkość
glide : glide : (czas.) ślizgać | : (czas.) sunąć | : (czas.) szybować | : (rzecz.) ślizg | : (rzecz.) ślizganie | : (rzecz.) sunięcie | : (rzecz.) szybowanie
glider : glider : (rzecz.) lotnia | : (rzecz.) lotniarz | : (rzecz.) szybowiec | : (rzecz.) szybownik
gliding : gliding : (rzecz.) ślizganie | : (rzecz.) szybowanie | : (rzecz.) szybownictwo
glimmer : glimmer : (czas.) migotać | : (czas.) pobłyskiwać | : (czas.) przebłyskiwać | : (rzecz.) migotanie | : (rzecz.) ognik | : (rzecz.) płomyk | : (rzecz.) poblask | : (rzecz.) promyk | : (rzecz.) przebłysk
glimmering : glimmering : (czas.) migotać | : (czas.) przebłyskiwać | : (rzecz.) migotanie | : (rzecz.) promyk | : (rzecz.) przebłysk
glimpse : glimpse : (czas.) dojrzeć | : (czas.) ujrzeć | : (czas.) zauważyć | : (czas.) zobaczyć | : (rzecz.) mgnienie | : (rzecz.) mignięcie | : (rzecz.) spojrzenie
glint : glint : (czas.) błyskać | : (czas.) błyszczeć | : (czas.) zaiskrzyć | : (rzecz.) błysk
glisten : glisten : (czas.) błyszczeć | : (czas.) lśnić | : (czas.) migotać | : (czas.) połyskiwać
glister : glister : (czas.) błyszczeć | : (czas.) migotać | : (czas.) połyskiwać
glitch : glitch : (rzecz.) błąd | : (rzecz.) usterka
glitter : glitter : (czas.) błyszczeć | : (czas.) lśnić | : (czas.) pobłyskiwać | : (czas.) połyskiwać | : (rzecz.) blask | : (rzecz.) błyszczenie | : (rzecz.) lśnienie | : (rzecz.) połysk | : (rzecz.) połyskiwanie | : (rzecz.) świecenie
glittering : glittering : (przym.) połyskliwy
glitz : glitz : (rzecz.) blask | : (rzecz.) blichtr
gloaming : gloaming : (rzecz.) zmrok
gloat : gloat : (czas.) napawać | : (czas.) tryumfować
gloatingly : gloatingly : (przysł.) chełpliwie
global : global : (przym.) globalny | : (przym.) ogólnoświatowy | : (przym.) ogólny | : (przym.) światowy
globalization : globalization : (rzecz.) globalizacja
globally : globally : (przysł.) globalnie
globe : globe : (rzecz.) glob | : (rzecz.) globus | : (rzecz.) kula
globe-trotter : globe-trotter : (rzecz.) obieżyświat
globetrotter : globetrotter : (rzecz.) globtroter | : (rzecz.) obieżyświat | : (rzecz.) wędrowiec
globular : globular : (przym.) kulisty
globule : globule : (rzecz.) globula | : (rzecz.) kulka
globulin : globulin : (rzecz.) globulina
gloom : gloom : (czas.) zaciemniać | : (czas.) zasnuć | : (rzecz.) ciemność | : (rzecz.) ciemności | : (rzecz.) mrok | : (rzecz.) ponurość | : (rzecz.) posępność | : (rzecz.) przygnębienie | : (rzecz.) smutek
gloomily : gloomily : (przysł.) markotnie | : (przysł.) ponuro | : (przysł.) posępnie
gloomy : gloomy : (przym.) ciemny | : (przym.) grobowy | : (przym.) mroczny | : (przym.) pochmurny | : (przym.) ponury | : (przym.) posępny | : (przym.) szary
glorification : glorification : (rzecz.) gloryfikacja
glorify : glorify : (czas.) apoteozować | : (czas.) chwalić | : (czas.) gloryfikować | : (czas.) pochwalać | : (czas.) sławić | : (czas.) wielbić | : (czas.) wysławiać
glorious : glorious : (przym.) chlubny | : (przym.) chwalebny | : (przym.) sławetny | : (przym.) sławny | : (przym.) świetny | : (przym.) wspaniały
gloriously : gloriously : (przysł.) sławnie
glory : glory : (czas.) chlubić | : (rzecz.) chluba | : (rzecz.) chwała | : (rzecz.) cześć | : (rzecz.) gloria | : (rzecz.) halo | : (rzecz.) majestat | : (rzecz.) sława | : (rzecz.) świetność | : (rzecz.) wspaniałość
gloss : gloss : (rzecz.) blask | : (rzecz.) blichtr | : (rzecz.) połysk
glossary : glossary : (rzecz.) glosariusz | : (rzecz.) klucz | : (rzecz.) leksykon | : (rzecz.) słownik
glossiness : glossiness : (rzecz.) blask | : (rzecz.) połysk
glossy : glossy : (przym.) gładki | : (przym.) ilustrowany | : (przym.) lśniący | : (przym.) połyskliwy | : (przym.) połyskujący
glottal : glottal : (przym.) dźwięczny | : (przym.) głośniowy
glottis : glottis : (rzecz.) głośnia
glove : glove : (rzecz.) rękawica | : (rzecz.) rękawiczka
glover : glover : (rzecz.) rękawicznik
gloves : gloves : (rzecz.) rękawice
glow : glow : (czas.) błyszczeć | : (czas.) jarzyć | : (czas.) płonąć | : (czas.) promieniować | : (czas.) tlić | : (czas.) żarzyć | : (rzecz.) blask | : (rzecz.) łuna | : (rzecz.) ogień | : (rzecz.) poblask | : (rzecz.) poświata | : (rzecz.) świetlic | : (rzecz.) żar | : (rzecz.) żarzenie
glowing : glowing : (rzecz.) blask | : (rzecz.) jarzenie | : (rzecz.) pałanie
gloze : gloze : (czas.) wyjaśniać | : (czas.) wyjaśnić
glucose : glucose : (rzecz.) glikoza | : (rzecz.) glukoza
glue : glue : (czas.) kleić | : (czas.) lepić | : (czas.) przyklejać | : (czas.) przylepiać | : (czas.) przylepić | : (czas.) skleić | : (czas.) sklejać | : (rzecz.) klajster | : (rzecz.) klej | : (rzecz.) lep | : (rzecz.) lepik
gluer : gluer : (rzecz.) gumówka | : (rzecz.) klejarka
gluey : gluey : (przym.) kleisty | : (przym.) lepki
gluier : gluier : (rzecz.) lugier
glum : glum : (przym.) chmurny | : (przym.) pochmurny | : (przym.) ponury
glut : glut : (czas.) nasycać | : (czas.) nasycić | : (czas.) zatykać | : (rzecz.) nadmiar | : (rzecz.) nasycenie | : (rzecz.) przesycenie | : (rzecz.) przesyt
glutamate : glutamate : (rzecz.) glutaminian
glutamine : glutamine : (rzecz.) glutamina
glutathione : glutathione : (rzecz.) glutation
gluten : gluten : (rzecz.) gluten
gluteus : gluteus : (przym.) pośladkowy
glutinous : glutinous : (przym.) kleisty | : (przym.) lepki
glutton : glutton : (rzecz.) łakomczuch | : (rzecz.) obżartuch | : (rzecz.) pożeracz | : (rzecz.) żarłok
gluttonize : gluttonize : (czas.) obeżreć
gluttonous : gluttonous : (przym.) żarłoczny
gluttony : gluttony : (rzecz.) łakomstwo | : (rzecz.) obżarstwo | : (rzecz.) żarłoczność
glycerine : glycerine : (rzecz.) gliceryna
glycerol : glycerol : (rzecz.) glicerol
glycogen : glycogen : (rzecz.) glikogen
glycol : glycol : (rzecz.) glikol
glyph : glyph : (rzecz.) glif | : (rzecz.) znak
gnarl : gnarl : (czas.) skręcać | : (czas.) wykręcać | : (rzecz.) sęk
gnarled : gnarled : (przym.) chropowaty | : (przym.) sękaty
gnarly : gnarly : (przym.) chropowaty
gnash : gnash : (czas.) zgrzytać
gnat : gnat : (rzecz.) komar
gnaw : gnaw : (czas.) dręczyć | : (czas.) gryźć | : (czas.) nadgryzać | : (czas.) obgryzać | : (czas.) ogryzać | : (czas.) zeżreć | : (czas.) zgrzytać
gneiss : gneiss : (rzecz.) gnejs
gnome : gnome : (rzecz.) gnom | : (rzecz.) karzeł
gnomic : gnomic : (przym.) gnomiczny
gnomon : gnomon : (rzecz.) gnomon
gnosis : gnosis : (rzecz.) gnostycyzm
gnu : gnu : (rzecz.) gnu
go : go : (czas.) chodzić | : (czas.) iść | : (czas.) jechać | : (czas.) odejść | : (czas.) podróżować | : (czas.) pójść | : (czas.) stawać | : (czas.) udawać | : (czas.) wyjeżdżać | : (rzecz.) próba
go-ahead : go-ahead : (przym.) przebojowy | : (rzecz.) akceptacja | : (rzecz.) pozwolenie | : (rzecz.) zgoda
go-between : go-between : (rzecz.) pośrednik
go-cart : go-cart : (rzecz.) gokart
go-devil : go-devil : (rzecz.) drezyna | : (rzecz.) uderzak | : (rzecz.) zbijak | : (rzecz.) zgrabiarka
go-getter : go-getter : (rzecz.) ktoś
go-kart : go-kart : (rzecz.) gokart
go-slow : go-slow : (rzecz.) strajk
goad : goad : (czas.) kłuć | : (czas.) podjudzać | : (czas.) popędzać | : (czas.) prowokować | : (rzecz.) oścień
goal : goal : (rzecz.) bramka | : (rzecz.) cel | : (rzecz.) gol | : (rzecz.) przeznaczenie
goal-keeper : goal-keeper : (rzecz.) bramkarz
goalie : goalie : (rzecz.) bramkarz
goalkeeper : goalkeeper : (rzecz.) bramkarz
goalless : goalless : (przym.) bezbramkowy
goat : goat : (rzecz.) koza | : (rzecz.) kozica | : (rzecz.) kozioł
goat's : goat's : (przym.) kozi
goatherd : goatherd : (rzecz.) koziarz | : (rzecz.) pasterz
goatsucker : goatsucker : (rzecz.) kozodój
gob : gob : (rzecz.) gęba | : (rzecz.) grudka | : (rzecz.) kropla | : (rzecz.) podsadzka | : (rzecz.) porcja | : (rzecz.) zawał | : (rzecz.) zawalisko | : (rzecz.) zroby
gobbet : gobbet : (rzecz.) kawał | : (rzecz.) kęs
gobble : gobble : (czas.) bulgotać | : (czas.) gulgotać | : (czas.) pożerać | : (czas.) żreć | : (rzecz.) gulgot
gobbler : gobbler : (rzecz.) indor
goblet : goblet : (rzecz.) czar | : (rzecz.) czara | : (rzecz.) kielich | : (rzecz.) kieliszek | : (rzecz.) puchar
goblin : goblin : (rzecz.) chochlik | : (rzecz.) skrzat
goby : goby : (rzecz.) babka
god : god : (rzecz.) bóg | : (rzecz.) bóstwo | : (rzecz.) bożek
god-child : god-child : (rzecz.) chrześniak
god-fearing : god-fearing : (przym.) bogobojny
godchild : godchild : (rzecz.) chrześniak
goddess : goddess : (rzecz.) bogini
godforsaken : godforsaken : (przym.) bezludny | : (przym.) opuszczony | : (przym.) zapadły
godhead : godhead : (rzecz.) bóstwo
godless : godless : (przym.) bezbożny
godlike : godlike : (przym.) boski
godliness : godliness : (rzecz.) bogobojność | : (rzecz.) pobożność | : (rzecz.) religijność
godly : godly : (przym.) bogobojny | : (przym.) nabożny | : (przym.) pobożny
godmother : godmother : (rzecz.) chrzestna
godsend : godsend : (rzecz.) niespodzianka
godson : godson : (rzecz.) chrześniak
goethite : goethite : (rzecz.) getyt
gofer : gofer : (rzecz.) andrut | : (rzecz.) posłaniec
goggle : goggle : (czas.) wytrzeszczać | : (rzecz.) gogle
goggles : goggles : (rzecz.) gogle
going : going : (czas.) zamierzać | : (rzecz.) jazda | : (rzecz.) odejście | : (rzecz.) ruch | : (rzecz.) zagłębianie
goings-on : goings-on : (rzecz.) zachowanie
goitre : goitre : (rzecz.) wole
gold : gold : (rzecz.) gołda | : (rzecz.) złoto
gold-bearing : gold-bearing : (przym.) złotodajny | : (przym.) złotonośny
gold-plated : gold-plated : (przym.) złocony
goldbrick : goldbrick : (rzecz.) tandeta
golden : golden : (przym.) złocisty | : (przym.) złoty
golden-mouthed : golden-mouthed : (przym.) złotousty
goldfinch : goldfinch : (rzecz.) szczygieł
goldilocks : goldilocks : (rzecz.) blondyn
goldsmith : goldsmith : (rzecz.) złotnik
golf : golf : (rzecz.) golf
golfer : golfer : (rzecz.) golfista
golliwog : golliwog : (rzecz.) pajac | : (rzecz.) strach | : (rzecz.) straszak | : (rzecz.) straszydło
gonad : gonad : (rzecz.) gonada
gondola : gondola : (rzecz.) gondola
gong : gong : (rzecz.) dobro | : (rzecz.) gong | : (rzecz.) towar | : (rzecz.) wiadomość
goniometry : goniometry : (rzecz.) goniometria
gonococcus : gonococcus : (rzecz.) gonokok
gonorrhoea : gonorrhoea : (rzecz.) rzeżączka | : (rzecz.) tryper
gonorrhoeal : gonorrhoeal : (przym.) rzeżączkowy
good : good : (przym.) atrakcyjny | : (przym.) dobry | : (przym.) dogodny | : (przym.) grzeczny | : (przym.) miły | : (przym.) niezły | : (przym.) odpowiedni | : (przym.) poprawny | : (przym.) udatny | : (przym.) urodzajny | : (przym.) ważny | : (przym.) zacny
good-by : good-by : (rzecz.) pożegnanie
good-bye : good-bye : (rzecz.) pożegnanie
good-for-nothing : good-for-nothing : (rzecz.) nicpoń
good-hearted : good-hearted : (przym.) życzliwy
good-humoured : good-humoured : (przym.) dobroduszny | : (przym.) pogodny
good-looking : good-looking : (przym.) atrakcyjny | : (przym.) dorodny | : (przym.) przystojny | : (przym.) urodziwy
good-natured : good-natured : (przym.) dobroduszny | : (przym.) dobrotliwy | : (przym.) uprzejmy | : (przym.) zgodny
good-night : good-night : (rzecz.) dobranoc
good-steering : good-steering : (przym.) sterowny
good-turning : good-turning : (przym.) zwrotny
goodbye : goodbye : (rzecz.) pożegnanie
goodie : goodie : (rzecz.) sztywniak
goodish : goodish : (przym.) niezły | : (przym.) spory
goodly : goodly : (przym.) duży | : (przym.) miły | : (przym.) piękny | : (przym.) pokaźny | : (przym.) spory | : (przym.) znaczny
goodness : goodness : (rzecz.) dobroć | : (rzecz.) uprzejmość
goodnight : goodnight : (rzecz.) dobranoc
goods : goods : (rzecz.) towar
goodwill : goodwill : (rzecz.) pieczołowitość | : (rzecz.) reputacja | : (rzecz.) życzliwość
goody : goody : (rzecz.) słodycz | : (rzecz.) świętoszek
goody-goody : goody-goody : (rzecz.) oportunista | : (rzecz.) pochlebca | : (rzecz.) świętoszek
gooey : gooey : (przym.) kleisty | : (przym.) lepki
goof : goof : (rzecz.) głupiec | : (rzecz.) niedorajda
goofy : goofy : (przym.) durny | : (przym.) głupkowaty
gook : gook : (rzecz.) prostytutka
goon : goon : (rzecz.) głupek | : (rzecz.) kretyn
goose : goose : (rzecz.) gąska | : (rzecz.) gęś | : (rzecz.) gęsina | : (rzecz.) gęsior
gooseberries : gooseberries : (rzecz.) agrest
gooseberry : gooseberry : (rzecz.) agrest
gooseflesh : gooseflesh : (rzecz.) mrowie
gooseneck : gooseneck : (rzecz.) przewód
goosy : goosy : (przym.) nerwowy
gopher : gopher : (rzecz.) suseł | : (rzecz.) świstak
gore : gore : (czas.) przebijać | : (rzecz.) bryt | : (rzecz.) godet | : (rzecz.) klin | : (rzecz.) posoka | : (rzecz.) zrogowacenie
gorge : gorge : (rzecz.) czeluść | : (rzecz.) gardło | : (rzecz.) gardziel | : (rzecz.) kapinos | : (rzecz.) łzawnik | : (rzecz.) parów | : (rzecz.) przełom | : (rzecz.) wąwóz | : (rzecz.) wyżerka
gorgeous : gorgeous : (przym.) cudny | : (przym.) cudowny | : (przym.) okazały | : (przym.) przepiękny | : (przym.) wspaniały | : (przym.) wystawny
gorgeously : gorgeously : (przysł.) barwnie
gorgeousness : gorgeousness : (rzecz.) przepych | : (rzecz.) przepychanie
gorgon : gorgon : (rzecz.) megiera
gorilla : gorilla : (rzecz.) goryl
gormandize : gormandize : (czas.) objadać | : (czas.) objeść | : (rzecz.) obżartuch
gormless : gormless : (przym.) głupi
gorse : gorse : (rzecz.) janowiec
gory : gory : (przym.) krwawy
gosh : gosh : (wykrzyknik) ojej
gosling : gosling : (rzecz.) gąsiątko
gospel : gospel : (rzecz.) ewangelia
gossamer : gossamer : (rzecz.) pajęczynka
gossip : gossip : (czas.) gawędzić | : (czas.) plotkować | : (czas.) poplotkować | : (rzecz.) bajczarz | : (rzecz.) gawęda | : (rzecz.) paniusia | : (rzecz.) plotka | : (rzecz.) plotkarstwo | : (rzecz.) plotkarz | : (rzecz.) plotkowanie
gossip-monger : gossip-monger : (rzecz.) nowinkarz
gossiper : gossiper : (rzecz.) plotkarz
gossipmonger : gossipmonger : (rzecz.) plotkarz
gossipy : gossipy : (przym.) plotkarski
gossoon : gossoon : (rzecz.) chłopak
got : got : (czas.) dojść | : (czas.) dostać | : (czas.) otrzymać | : (czas.) robić | : (czas.) stać | : (czas.) wpływać
gothic : gothic : (przym.) gocki | : (przym.) gotycki | : (rzecz.) gotyk
gotten : gotten : (czas.) robić
gouache : gouache : (rzecz.) gwasz
gouge : gouge : (czas.) dłubać | : (czas.) oszukiwać | : (czas.) rozdłubać | : (czas.) żłobkować
goulash : goulash : (rzecz.) gulasz
gourd : gourd : (rzecz.) bania | : (rzecz.) gurda | : (rzecz.) tykwa
gourmand : gourmand : (rzecz.) łakomczuch | : (rzecz.) łasuch | : (rzecz.) obżartuch | : (rzecz.) smakosz
gourmandise : gourmandise : (rzecz.) łakomstwo
gourmet : gourmet : (rzecz.) smakosz
gout : gout : (rzecz.) gościec | : (rzecz.) kropla | : (rzecz.) podagra
gouty : gouty : (przym.) artretyczny | : (przym.) podagryczny
govern : govern : (czas.) determinować | : (czas.) panować | : (czas.) rządzić
governance : governance : (rzecz.) kierowanie | : (rzecz.) rządzenie | : (rzecz.) zarządzanie
government : government : (rzecz.) administracja | : (rzecz.) gubernia | : (rzecz.) rekcja | : (rzecz.) rząd | : (rzecz.) ustrój
governmental : governmental : (przym.) rządowy
governor : governor : (rzecz.) dyrektor | : (rzecz.) gubernator | : (rzecz.) naczelnik | : (rzecz.) namiestnik | : (rzecz.) regulator | : (rzecz.) wielkorządca | : (rzecz.) wojewoda | : (rzecz.) zarządca
governorship : governorship : (rzecz.) gubernatorstwo | : (rzecz.) namiestnictwo
gown : gown : (rzecz.) fartuch | : (rzecz.) płaszcz | : (rzecz.) suknia | : (rzecz.) toga
grab : grab : (czas.) chwycić | : (czas.) chwytać | : (czas.) dorwać | : (czas.) grabić | : (czas.) porwać | : (czas.) porywać | : (czas.) przechwytywać | : (czas.) przejąć | : (czas.) złapać
grabber : grabber : (rzecz.) chciwiec
grabble : grabble : (czas.) macać
grace : grace : (czas.) faworyzować | : (czas.) zdobić | : (rzecz.) gracja | : (rzecz.) grzeczność | : (rzecz.) karencja | : (rzecz.) łaska | : (rzecz.) wdzięk
graceful : graceful : (przym.) łagodny | : (przym.) poprawny | : (przym.) powabny | : (przym.) wdzięczny
gracefully : gracefully : (przysł.) wdzięcznie
gracefulness : gracefulness : (rzecz.) wdzięk
graceless : graceless : (przym.) bezwstydny
gracious : gracious : (przym.) łaskawy | : (przym.) miłościwy | : (przym.) miłosierny
graciously : graciously : (przysł.) łaskawie | : (przysł.) uprzejmie
graciousness : graciousness : (rzecz.) łaskawość
grackle : grackle : (rzecz.) gwarek
grad : grad : (przym.) gradowy
gradate : gradate : (czas.) tonować
gradation : gradation : (rzecz.) gradacja | : (rzecz.) podziałka | : (rzecz.) skala | : (rzecz.) stopniowanie | : (rzecz.) ukończenie
grade : grade : (rzecz.) gatunek | : (rzecz.) klasa | : (rzecz.) nachylenie | : (rzecz.) ocena | : (rzecz.) ranga | : (rzecz.) stopień | : (rzecz.) szczebel
grader : grader : (rzecz.) równiarka | : (rzecz.) sortowacz
gradient : gradient : (rzecz.) nachylenie | : (rzecz.) pochylenie | : (rzecz.) spadek
grading : grading : (rzecz.) klasyfikowanie | : (rzecz.) sortowanie | : (rzecz.) stopniowanie | : (rzecz.) tonowanie | : (rzecz.) zaszeregowanie
gradiometer : gradiometer : (przym.) stopniowy | : (rzecz.) pochyłomierz
gradual : gradual : (przym.) stopniowy
gradually : gradually : (przysł.) powoli | : (przysł.) stopniowo
gradualness : gradualness : (rzecz.) stopniowość
graduate : graduate : (czas.) stopniować | : (rzecz.) abiturient | : (rzecz.) absolutorium | : (rzecz.) absolwent
graduate's : graduate's : (przym.) magisterski
graduation : graduation : (rzecz.) absolutorium | : (rzecz.) podziałką | : (rzecz.) stopniowanie
graffiti : graffiti : (rzecz.) graffiti | : (rzecz.) grafika
graffito : graffito : (rzecz.) szczep
graft : graft : (czas.) dawać | : (czas.) krzewić | : (czas.) przeszczepiać | : (czas.) szczepić | : (czas.) transplantować | : (czas.) wymuszać | : (rzecz.) łapówka | : (rzecz.) przeszczep | : (rzecz.) szczep | : (rzecz.) szczepionka | : (rzecz.) wymuszenie | : (rzecz.) zaszczepka | : (rzecz.) zraz | : (rzecz.) zrażenie
grafter : grafter : (rzecz.) łapówkarz | : (rzecz.) łapownik
grain : grain : (rzecz.) kasza | : (rzecz.) lico | : (rzecz.) odrobina | : (rzecz.) słój | : (rzecz.) włókno | : (rzecz.) zborze | : (rzecz.) zboże | : (rzecz.) ziarenko | : (rzecz.) ziarnistość | : (rzecz.) ziarnko | : (rzecz.) ziarno
grained : grained : (przym.) ziarnisty
grainer : grainer : (rzecz.) ziarnówka
graininess : graininess : (rzecz.) ziarnistość
graining : graining : (rzecz.) granulowanie | : (rzecz.) groszkowanie | : (rzecz.) ziarnowanie
grains : grains : (rzecz.) harpun | : (rzecz.) ziarno
grainy : grainy : (przym.) chropowaty | : (przym.) ziarnisty
gram : gram : (rzecz.) cieciorka | : (rzecz.) gram
gram-atom : gram-atom : (rzecz.) gramoatom
gram-equivalent : gram-equivalent : (rzecz.) gramorównoważnik | : (rzecz.) wal
gram-force : gram-force : (rzecz.) gram-siła | : (rzecz.) pond
gram-molecule : gram-molecule : (rzecz.) gramocząsteczka | : (rzecz.) mol
grammalogue : grammalogue : (rzecz.) znacznik
grammar : grammar : (rzecz.) gramatyka
grammars : grammars : (rzecz.) gramatyk
grammatical : grammatical : (przym.) gramatyczny
grammaticality : grammaticality : (przym.) gramatyczny
gramophone : gramophone : (rzecz.) gramofon | : (rzecz.) patefon
grampus : grampus : (rzecz.) szablogrzbiet
grams : grams : (rzecz.) gram
granary : granary : (rzecz.) spichlerz
grand : grand : (przym.) duży | : (przym.) główny | : (przym.) huczny | : (przym.) imponujący | : (przym.) paradny | : (przym.) świetny | : (przym.) uroczysty | : (przym.) wielki | : (przym.) znakomity
grandchild : grandchild : (rzecz.) prawnuk | : (rzecz.) wnuczka | : (rzecz.) wnuk
grandchildren : grandchildren : (rzecz.) wnuczki
granddad : granddad : (rzecz.) dziadek | : (rzecz.) dziadunio | : (rzecz.) dziadzio
granddaughter : granddaughter : (rzecz.) wnuczka
grandee : grandee : (rzecz.) granda
grander : grander : (przym.) świetny
grandeur : grandeur : (rzecz.) dostojność | : (rzecz.) majestatyczność | : (rzecz.) okazałość | : (rzecz.) szlachetność | : (rzecz.) wielkość | : (rzecz.) wspaniałość
grandfather : grandfather : (rzecz.) dziadek
grandiloquence : grandiloquence : (rzecz.) górnolotność | : (rzecz.) grandilokwencja | : (rzecz.) pompatyczność
grandiloquent : grandiloquent : (przym.) górnolotny
grandiose : grandiose : (przym.) efekciarski | : (przym.) pompatyczny
grandly : grandly : (przysł.) okazale
grandma : grandma : (rzecz.) babcia | : (rzecz.) babunia
grandmamma : grandmamma : (rzecz.) babcia | : (rzecz.) babula
grandmother : grandmother : (rzecz.) babcia | : (rzecz.) babka | : (rzecz.) babunia
grandpa : grandpa : (rzecz.) dziadek | : (rzecz.) dziadunio | : (rzecz.) dziadzio | : (rzecz.) dziadziuś
grandpapa : grandpapa : (rzecz.) dziadunio
grandparent : grandparent : (rzecz.) babcia | : (rzecz.) dziadek
grandparents : grandparents : (rzecz.) dziadkowie
grandson : grandson : (rzecz.) wnuk
grange : grange : (rzecz.) farma | : (rzecz.) towarzystwo
granite : granite : (rzecz.) granit
granny : granny : (rzecz.) babcia | : (rzecz.) babunia
grant : grant : (czas.) nadać | : (czas.) nadawać | : (czas.) oddać | : (czas.) przyznać | : (czas.) przyznawać | : (czas.) udzielać | : (czas.) udzielić | : (czas.) użyczać | : (rzecz.) dar | : (rzecz.) darowizna | : (rzecz.) dofinansowanie | : (rzecz.) dotacja | : (rzecz.) grant | : (rzecz.) nadanie | : (rzecz.) stypendium | : (rzecz.) subwencja | : (rzecz.) udzielenie | : (rzecz.) wyasygnowanie | : (rzecz.) zapomoga
grant-in-aid : grant-in-aid : (rzecz.) dotacja | : (rzecz.) subwencja
grantee : grantee : (rzecz.) cesjonariusz
granular : granular : (przym.) drobny | : (przym.) ziarnisty
granularity : granularity : (rzecz.) rozdrobnienie | : (rzecz.) szczegółowość | : (rzecz.) ziarnistość
granulate : granulate : (czas.) granulować | : (czas.) rozdrabniać
granulation : granulation : (rzecz.) granulacja | : (rzecz.) granulowanie | : (rzecz.) ziarnina | : (rzecz.) ziarnistość
granulator : granulator : (rzecz.) granulator
granule : granule : (rzecz.) granula | : (rzecz.) granulka | : (rzecz.) ziarenko | : (rzecz.) ziarnko
granules : granules : (rzecz.) granulat
grape : grape : (rzecz.) grapa | : (rzecz.) moszcz | : (rzecz.) winogrono | : (rzecz.) winorośl
grape-fruit : grape-fruit : (rzecz.) grejpfrut | : (rzecz.) winogrono
grape-juice : grape-juice : (rzecz.) moszcz
grape-shot : grape-shot : (rzecz.) kartacz
grape-vine : grape-vine : (rzecz.) winorośl
grapefruit : grapefruit : (rzecz.) grejpfrut | : (rzecz.) winogrono
grapes : grapes : (rzecz.) winogrona | : (rzecz.) winogrono
grapevine : grapevine : (rzecz.) latorośl | : (rzecz.) winorośl
graph : graph : (rzecz.) graf | : (rzecz.) krzywa | : (rzecz.) wykres
graphic : graphic : (przym.) graficzny | : (przym.) obrazowy | : (przym.) wykreślny | : (rzecz.) grafik | : (rzecz.) grafika
graphical : graphical : (przym.) graficzny
graphically : graphically : (przysł.) graficznie | : (przysł.) obrazowo
graphics : graphics : (rzecz.) grafika
graphite : graphite : (rzecz.) grafit
graphitizing : graphitizing : (rzecz.) grafityzowanie
graphologist : graphologist : (rzecz.) grafolog
graphology : graphology : (rzecz.) grafologia
grapnel : grapnel : (rzecz.) harpun
grapple : grapple : (czas.) chwytać | : (czas.) objąć | : (czas.) zmagać | : (rzecz.) chwyt | : (rzecz.) chwytak | : (rzecz.) walka | : (rzecz.) zmaganie
grapy : grapy : (przym.) winogronowy
grasp : grasp : (czas.) chwycić | : (czas.) chwytać | : (czas.) łapać | : (czas.) objąć | : (czas.) pojąć | : (czas.) pojmować | : (czas.) schwytać | : (czas.) uchwycić | : (rzecz.) chwyt | : (rzecz.) uchwyt | : (rzecz.) ujęcie | : (rzecz.) uścisk
graspable : graspable : (przym.) uchwytny
grasped : grasped : (czas.) chwytać | : (czas.) pojąć | : (czas.) pojmować | : (czas.) ściskać | : (czas.) uchwycić | : (czas.) zrozumieć
grasping : grasping : (przym.) drapieżczy | : (przym.) łapczywy | : (przym.) zachłanny
grass : grass : (rzecz.) kapuś | : (rzecz.) murawa | : (rzecz.) trawa | : (rzecz.) trawka
grass-green : grass-green : (przym.) trawiastozielony
grass-snake : grass-snake : (rzecz.) zaskroniec
grasshopper : grasshopper : (rzecz.) pasikonik | : (rzecz.) świerszcz
grassland : grassland : (rzecz.) łąka | : (rzecz.) step
grassy : grassy : (przym.) trawiasty
grate : grate : (czas.) chrypieć | : (czas.) drapać | : (czas.) okratować | : (czas.) skrobać | : (czas.) skrzypieć | : (czas.) trzeć | : (czas.) zakratować | : (czas.) zetrzeć | : (rzecz.) krata | : (rzecz.) kratownica | : (rzecz.) ognisko | : (rzecz.) palenisko | : (rzecz.) ruszt
grateful : grateful : (przym.) wdzięczny
gratefully : gratefully : (przysł.) wdzięcznie
gratefulness : gratefulness : (rzecz.) wdzięczność
grater : grater : (rzecz.) tarka
gratification : gratification : (rzecz.) gratyfikacja | : (rzecz.) przyjemność | : (rzecz.) wynagrodzenie | : (rzecz.) zadośćuczynienie | : (rzecz.) zadowolenie | : (rzecz.) zaspokojenie
gratify : gratify : (czas.) satysfakcjonować | : (czas.) schlebiać | : (czas.) ucieszyć | : (czas.) wynagrodzić | : (czas.) zadowolić | : (czas.) zaspokajać | : (czas.) zaspokoić
grating : grating : (przym.) chrobotliwy | : (przym.) chrypliwy | : (przym.) zgrzytliwy | : (rzecz.) chrobot | : (rzecz.) krata | : (rzecz.) okratowanie | : (rzecz.) ucieranie
gratis : gratis : (przym.) darmowy | : (przysł.) bezpłatnie | : (przysł.) darmo
gratitude : gratitude : (rzecz.) wdzięczność
gratuitous : gratuitous : (przym.) bezpłatny | : (przym.) bezpodstawny | : (przym.) dobrowolny | : (przym.) zbędny
gratuitously : gratuitously : (przysł.) bezpłatnie
gratuity : gratuity : (rzecz.) dar | : (rzecz.) gratyfikacja | : (rzecz.) napiwek
gratulatory : gratulatory : (przym.) gratulacyjny
grave : grave : (przym.) ciężki | : (przym.) doniosły | : (przym.) grobowy | : (przym.) ponury | : (przym.) poważny | : (przym.) ważny | : (rzecz.) grób | : (rzecz.) mogiła
gravedigger : gravedigger : (rzecz.) grabarz
gravel : gravel : (rzecz.) żużel | : (rzecz.) żwir | : (rzecz.) żwirownia
gravel-pit : gravel-pit : (rzecz.) żwirownia
gravely : gravely : (przysł.) poważnie
graveness : graveness : (rzecz.) grób | : (rzecz.) wyrycie
graver : graver : (rzecz.) grawer | : (rzecz.) rylec
gravestone : gravestone : (rzecz.) nagrobek
graveyard : graveyard : (rzecz.) cmentarz | : (rzecz.) cmentarzysko | : (rzecz.) mogilnik
gravidity : gravidity : (rzecz.) ciąża
gravimeter : gravimeter : (rzecz.) grawimetr
gravimetric : gravimetric : (przym.) grawimetryczny | : (przym.) wagowy
gravitate : gravitate : (czas.) ciążyć | : (czas.) grawitować | : (czas.) opadać
gravitation : gravitation : (rzecz.) ciążenie | : (rzecz.) grawitacja
gravitational : gravitational : (przym.) grawitacyjny
graviton : graviton : (rzecz.) grawiton
gravity : gravity : (rzecz.) ciążenie | : (rzecz.) ciężar | : (rzecz.) ciężkość | : (rzecz.) grawitacja | : (rzecz.) namaszczenie | : (rzecz.) ociekanie | : (rzecz.) powaga | : (rzecz.) przyciąganie | : (rzecz.) waga | : (rzecz.) ważkość
gravure : gravure : (rzecz.) fotograwiura
gravy : gravy : (rzecz.) okrasa | : (rzecz.) okraszenie | : (rzecz.) sos
grayling : grayling : (rzecz.) lipień
graze : graze : (rzecz.) draśnięcie | : (rzecz.) zadraśnięcie
grazing : grazing : (rzecz.) pasienie | : (rzecz.) pastwisko | : (rzecz.) wypas
grease : grease : (czas.) nasmarować | : (czas.) natłuszczać | : (czas.) omaścić | : (czas.) posmarować | : (czas.) smarować | : (czas.) tłuścić | : (rzecz.) maź | : (rzecz.) okrasa | : (rzecz.) pomada | : (rzecz.) smalec | : (rzecz.) smar | : (rzecz.) tłuszcz
grease-box : grease-box : (rzecz.) maźnica
greasepaint : greasepaint : (rzecz.) szminka
greaser : greaser : (rzecz.) smarowacz | : (rzecz.) smarownica | : (rzecz.) smarownik
greasiness : greasiness : (rzecz.) smarność | : (rzecz.) smarowność | : (rzecz.) tłustość | : (rzecz.) zatłuszczenie
greasing : greasing : (rzecz.) natłuszczanie | : (rzecz.) omaszczenie | : (rzecz.) smarowanie
greasy : greasy : (przym.) brudny | : (przym.) mazisty | : (przym.) natłuszczony | : (przym.) tłusty | : (przym.) zatłuszczony
great : great : (przym.) duży | : (przym.) fajny | : (przym.) gruby | : (przym.) ogromny | : (przym.) świetny | : (przym.) wielki | : (przym.) wspaniały | : (przym.) wybitny
great-coat : great-coat : (rzecz.) palto | : (rzecz.) płaszcz
great-grandchild : great-grandchild : (rzecz.) prawnuk
great-grandfather : great-grandfather : (rzecz.) pradziadek
great-grandmother : great-grandmother : (rzecz.) prababcia | : (rzecz.) prababka
great-grandson : great-grandson : (rzecz.) prawnuk | : (rzecz.) wnuk
greatcoat : greatcoat : (rzecz.) palto | : (rzecz.) płaszcz | : (rzecz.) szynel
greaten : greaten : (czas.) powiększać
greatly : greatly : (przysł.) bardzo | : (przysł.) ogromnie | : (przysł.) wielce | : (przysł.) znacznie
greatness : greatness : (rzecz.) ogrom | : (rzecz.) wielkość | : (rzecz.) wspaniałość
greave : greave : (rzecz.) skwarek
greaves : greaves : (rzecz.) skwarki
grebe : grebe : (rzecz.) perkoz
greed : greed : (rzecz.) chciwość | : (rzecz.) łakomstwo | : (rzecz.) zachłanność | : (rzecz.) żądza
greedily : greedily : (przysł.) chciwie | : (przysł.) łapczywie | : (przysł.) zachłannie
greediness : greediness : (rzecz.) chciwość | : (rzecz.) łakomstwo | : (rzecz.) łapczywość
greedy : greedy : (przym.) chciwy | : (przym.) łakomy | : (przym.) łapczywy | : (przym.) łasy | : (przym.) pazerny | : (przym.) pożądliwy | : (przym.) rządny | : (przym.) zachłanny | : (przym.) żądny | : (przym.) żarłoczny
greedy-guts : greedy-guts : (rzecz.) pasibrzuch
green : green : (przym.) zielony | : (rzecz.) łąka | : (rzecz.) skwer | : (rzecz.) zieleń
green-back : green-back : (rzecz.) banknot
green-eyed : green-eyed : (przym.) zielonooki
green-sickness : green-sickness : (rzecz.) blednica
greenback : greenback : (rzecz.) banknot
greenery : greenery : (rzecz.) roślinność | : (rzecz.) trawnik | : (rzecz.) warzywo | : (rzecz.) zieleń
greenfinch : greenfinch : (rzecz.) dzwoniec
greenfly : greenfly : (rzecz.) mszyca
greengage : greengage : (rzecz.) renkloda
greengrocer : greengrocer : (rzecz.) badylarz | : (rzecz.) jarzyniarz | : (rzecz.) warzywniak | : (rzecz.) zieleniak | : (rzecz.) zieleniarz
greengrocer's : greengrocer's : (rzecz.) warzywniak | : (rzecz.) zieleniak
greengrocery : greengrocery : (rzecz.) warzywniak
greengrocer’s : greengrocer’s : (rzecz.) warzywniak
greenhorn : greenhorn : (rzecz.) żółtodziób
greenhouse : greenhouse : (rzecz.) cieplarnia | : (rzecz.) palmiarnia | : (rzecz.) szklarnia
greening : greening : (rzecz.) zielenienie
greenish : greenish : (przym.) zielonkawy
greenness : greenness : (rzecz.) zieleń | : (rzecz.) zieloność
greens : greens : (rzecz.) warzywa | : (rzecz.) zielenina
greensickness : greensickness : (rzecz.) blednica
greensward : greensward : (rzecz.) murawa
greenwood : greenwood : (rzecz.) las
greet : greet : (czas.) kłaniać | : (czas.) powitać | : (czas.) pozdrawiać | : (czas.) pozdrowić | : (czas.) witać
greeting : greeting : (rzecz.) powitanie | : (rzecz.) pozdrawianie | : (rzecz.) pozdrowienie | : (rzecz.) przywitanie | : (rzecz.) salutowanie
gregarious : gregarious : (przym.) stadny | : (przym.) towarzyski
gremial : gremial : (rzecz.) gremiał
gremlin : gremlin : (rzecz.) chochlik
grenade : grenade : (rzecz.) granat
grenadier : grenadier : (rzecz.) grenadier
grenadine : grenadine : (rzecz.) grenadyna
grew : grew : (czas.) rosnąć
grey : grey : (przym.) popielaty | : (przym.) siwy | : (przym.) szary
grey-haired : grey-haired : (przym.) siwowłosy | : (przym.) siwy
greyhound : greyhound : (rzecz.) chart
greyness : greyness : (rzecz.) szarzyzna
grid : grid : (rzecz.) kratka | : (rzecz.) kratownica | : (rzecz.) nieszczęście | : (rzecz.) ruszt | : (rzecz.) siatka | : (rzecz.) smutek | : (rzecz.) żal | : (rzecz.) żałość | : (rzecz.) zgryzota
griddle : griddle : (rzecz.) blacha
gridiron : gridiron : (rzecz.) ruszt
gridlock : gridlock : (rzecz.) korek
grief : grief : (rzecz.) frasunek | : (rzecz.) nieszczęście | : (rzecz.) smutek | : (rzecz.) żal | : (rzecz.) żałoba | : (rzecz.) żałość | : (rzecz.) zgryzota | : (rzecz.) zmartwienie
grievance : grievance : (rzecz.) krzywda | : (rzecz.) skarga | : (rzecz.) uraza | : (rzecz.) żal
grieve : grieve : (czas.) krzywdzić | : (czas.) martwić | : (czas.) rozpaczać | : (czas.) smucić | : (czas.) ubolewać
grievous : grievous : (przym.) bolesny | : (przym.) ciężki | : (przym.) jaskrawy | : (przym.) poważny | : (przym.) przykry
griffin : griffin : (rzecz.) gryf | : (rzecz.) nowicjusz
griffon : griffon : (rzecz.) gryfon
grill : grill : (czas.) prażyć | : (czas.) przypiekać | : (czas.) smażyć | : (rzecz.) krata | : (rzecz.) opiekacz | : (rzecz.) rożen | : (rzecz.) ruszt
grille : grille : (rzecz.) krata | : (rzecz.) kratka | : (rzecz.) okratowanie
grillroom : grillroom : (rzecz.) restauracja
grim : grim : (przym.) groźny | : (przym.) okrutny | : (przym.) ponury | : (przym.) srogi | : (przym.) wisielczy
grimace : grimace : (czas.) grymasić | : (czas.) wykrzywiać | : (czas.) wykrzywić | : (rzecz.) grymas
grime : grime : (czas.) brudzić | : (czas.) usmarować | : (czas.) zbrukać | : (rzecz.) brud
grimness : grimness : (rzecz.) ponuractwo | : (rzecz.) srogość
grimy : grimy : (przym.) brudny
grin : grin : (czas.) śmiać | : (czas.) szczerzyć | : (czas.) uśmiechać | : (rzecz.) uśmiech
grind : grind : (czas.) chrzęścić | : (czas.) mielić | : (czas.) mleć | : (czas.) obtaczać | : (czas.) przemleć | : (czas.) rozcierać | : (czas.) rozdrabiać | : (czas.) skruszyć | : (czas.) szlifować | : (czas.) wyszlifować | : (czas.) zemleć | : (czas.) zgrzytać | : (czas.) zmielić | : (rzecz.) kujon
grinder : grinder : (rzecz.) młyn | : (rzecz.) młynek | : (rzecz.) śrutownik | : (rzecz.) szlifierka | : (rzecz.) szlifierz
grindery : grindery : (rzecz.) szlifiernia
grinding : grinding : (przym.) szlifierski
grindstone : grindstone : (rzecz.) osełka | : (rzecz.) toczak | : (rzecz.) toczydło
gringo : gringo : (rzecz.) cudzoziemiec | : (rzecz.) obcokrajowiec
grip : grip : (czas.) ściskać | : (czas.) trzymać | : (czas.) ująć | : (rzecz.) chwyt | : (rzecz.) chwytacz | : (rzecz.) opanowanie | : (rzecz.) uchwyt | : (rzecz.) uścisk | : (rzecz.) zaczepienie
gripe : gripe : (czas.) biadolić | : (czas.) chwytać | : (czas.) dojmować | : (czas.) labiedzić | : (czas.) narzekać | : (czas.) przeszyć
grippe : grippe : (rzecz.) grypa
gripper : gripper : (rzecz.) imak | : (rzecz.) łapadło | : (rzecz.) spadochron | : (rzecz.) zacisk
gripping : gripping : (przym.) pasjonujący
grisly : grisly : (przym.) makabryczny | : (przym.) okropny
grist : grist : (rzecz.) przemiał | : (rzecz.) słód | : (rzecz.) ziarno
gristle : gristle : (rzecz.) chrząstka
gristly : gristly : (przym.) chrząstkowaty
grit : grit : (czas.) chrzęścić | : (czas.) zachrzęścić | : (rzecz.) grys | : (rzecz.) odwaga | : (rzecz.) piasek | : (rzecz.) piaskowiec | : (rzecz.) stanowczość | : (rzecz.) żwir
grits : grits : (rzecz.) grys
gritty : gritty : (przym.) krupiasty | : (przym.) piaszczysty
grizzle : grizzle : (czas.) marudzić | : (czas.) narzekać | : (czas.) płakać | : (czas.) popłakiwać
grizzly : grizzly : (rzecz.) krata
groan : groan : (czas.) jęczeć | : (czas.) stękać | : (czas.) zajęczeć | : (rzecz.) jęczenie | : (rzecz.) jęk | : (rzecz.) pomruk
grocer : grocer : (rzecz.) sklepikarz | : (rzecz.) sprzedawca
grog : grog : (rzecz.) grog | : (rzecz.) palonka
groggy : groggy : (przym.) niepewny
groin : groin : (rzecz.) falochron | : (rzecz.) krawędź | : (rzecz.) ostroga | : (rzecz.) pachwina
groins : groins : (rzecz.) ostróg
grommet : grommet : (rzecz.) przelotka
groom : groom : (czas.) obrządzać | : (rzecz.) fornal | : (rzecz.) koniuch | : (rzecz.) koniuszy | : (rzecz.) szambelan
grooming : grooming : (rzecz.) oporządzanie
groomsman : groomsman : (rzecz.) drużba
groove : groove : (czas.) bruzdować | : (czas.) bruździć | : (czas.) żłobić | : (czas.) zryć | : (rzecz.) bruzda | : (rzecz.) przyzwyczajenie | : (rzecz.) rowek | : (rzecz.) szablon | : (rzecz.) wpust | : (rzecz.) wyżłobienie | : (rzecz.) żłobek
grope : grope : (czas.) macać
gropingly : gropingly : (przysł.) omackiem
grosbeak : grosbeak : (rzecz.) grubodziób
gross : gross : (przym.) całkowity | : (przym.) duży | : (przym.) gruby | : (przym.) jaskrawy | : (przym.) karygodny | : (przym.) niewybredny | : (przym.) ordynarny | : (przym.) poważny | : (przym.) sprośny | : (przym.) tłusty | : (przym.) toporny | : (rzecz.) brutto | : (rzecz.) gros | : (rzecz.) suma
grossly : grossly : (przysł.) rażąco | : (przysł.) sprośnie
grossness : grossness : (rzecz.) ogrom | : (rzecz.) ordynarność | : (rzecz.) skandaliczność | : (rzecz.) sprośność
grosz : grosz : (przym.) groszowy
grot : grot : (rzecz.) grota
grotesque : grotesque : (przym.) groteskowy | : (przym.) karykaturalny | : (rzecz.) groteska | : (rzecz.) groteskowość
grotesquely : grotesquely : (przysł.) groteskowo
grotesqueness : grotesqueness : (rzecz.) groteskowość
grotto : grotto : (rzecz.) grota
grottos : grottos : (rzecz.) grot
grouch : grouch : (czas.) gderać | : (czas.) zrzędzić | : (rzecz.) gderanie | : (rzecz.) zrzęda
grouchiness : grouchiness : (rzecz.) zrzędliwość
grouchy : grouchy : (przym.) zrzędliwy
ground : ground : (czas.) gruntować | : (czas.) opierać | : (czas.) podkładać | : (czas.) podmalować | : (czas.) skruszyć | : (czas.) ustępować | : (czas.) uziemić | : (rzecz.) dno | : (rzecz.) grunt | : (rzecz.) masa | : (rzecz.) plac | : (rzecz.) podkład | : (rzecz.) podłoże | : (rzecz.) podstawa | : (rzecz.) przyziem | : (rzecz.) teren | : (rzecz.) uziemienie | : (rzecz.) ziemia
ground-floor : ground-floor : (przym.) parterowy | : (rzecz.) parter
groundage : groundage : (rzecz.) kotwiczenie | : (rzecz.) kotwiczne
grounding : grounding : (rzecz.) gruntowanie | : (rzecz.) podstawa | : (rzecz.) uziemianie | : (rzecz.) wyszkolenie
groundless : groundless : (przym.) bezpodstawny | : (przym.) bezprzedmiotowy | : (przym.) bezzasadny | : (przym.) gołosłowny
groundlessly : groundlessly : (przysł.) bezpodstawnie
groundlessness : groundlessness : (rzecz.) bezpodstawność
groundmass : groundmass : (rzecz.) osnowa
groundnut : groundnut : (rzecz.) arachid
grounds : grounds : (rzecz.) teren
groundsel : groundsel : (rzecz.) podwalina
groundsheet : groundsheet : (rzecz.) brezent | : (rzecz.) pałatka
groundwork : groundwork : (rzecz.) baza | : (rzecz.) podkład | : (rzecz.) podstawa
group : group : (czas.) dzielić | : (czas.) grupować | : (czas.) klasyfikować | : (czas.) pogrupować | : (czas.) zgrupować | : (rzecz.) gromada | : (rzecz.) grupa | : (rzecz.) grupka | : (rzecz.) koncern | : (rzecz.) peleton | : (rzecz.) ugrupowanie | : (rzecz.) zbiorowość | : (rzecz.) zespół | : (rzecz.) zgrupowanie
grouping : grouping : (rzecz.) zgrupowanie
groupware : groupware : (rzecz.) kooperacyjne
grouse : grouse : (czas.) kwękać | : (czas.) narzekać | : (czas.) zrzędzić | : (rzecz.) gderanie | : (rzecz.) głuszec | : (rzecz.) jarząbek | : (rzecz.) kuropatwa | : (rzecz.) pardwa
grout : grout : (rzecz.) torkret | : (rzecz.) tynk
grouting : grouting : (rzecz.) cementacja
grove : grove : (rzecz.) gaj | : (rzecz.) lasek | : (rzecz.) zagajnik
grovel : grovel : (czas.) czołgać | : (czas.) pełzać | : (czas.) płaszczyć | : (czas.) poniżać
grow : grow : (czas.) dorastać | : (czas.) hodować | : (czas.) martwieć | : (czas.) narastać | : (czas.) podrastać | : (czas.) rosnąć | : (czas.) rozrastać | : (czas.) stawać | : (czas.) uprawiać | : (czas.) urastać | : (czas.) wychudnąć | : (czas.) wyhodować | : (czas.) wyrastać
grower : grower : (rzecz.) hodowca | : (rzecz.) plantator
growing : growing : (przym.) wegetacyjny | : (rzecz.) dorastanie | : (rzecz.) uprawianie | : (rzecz.) wyrastanie
growl : growl : (czas.) gderać | : (czas.) mruczeć | : (czas.) warczeć | : (rzecz.) gderanie | : (rzecz.) mruczenie | : (rzecz.) pomruk | : (rzecz.) warczenie
growler : growler : (rzecz.) burczymucha | : (rzecz.) drynda | : (rzecz.) kibel | : (rzecz.) klop | : (rzecz.) kufel | : (rzecz.) malkontent | : (rzecz.) mruk | : (rzecz.) toaleta | : (rzecz.) zrzęda
grown-up : grown-up : (przym.) dorosły
grownup : grownup : (przym.) dorosły
growth : growth : (rzecz.) narastanie | : (rzecz.) narośl | : (rzecz.) porost | : (rzecz.) powiększenie | : (rzecz.) przyrost | : (rzecz.) rośnięcie | : (rzecz.) rozrost | : (rzecz.) rozwój | : (rzecz.) wzrastanie | : (rzecz.) wzrost
growths : growths : (przym.) porosty
grub : grub : (czas.) grzebać | : (czas.) karczować | : (czas.) ryć | : (rzecz.) czerw | : (rzecz.) larwa | : (rzecz.) niechluj | : (rzecz.) pędrak | : (rzecz.) wyżerka | : (rzecz.) żarcie
grubber : grubber : (rzecz.) gruber | : (rzecz.) karczownik
grubbiness : grubbiness : (rzecz.) niechlujstwo
grubby : grubby : (przym.) brudny | : (przym.) niechlujny | : (przym.) robaczywy
grudge : grudge : (czas.) skąpić | : (czas.) szczędzić | : (czas.) żałować | : (czas.) zazdrościć | : (rzecz.) niechęć | : (rzecz.) rozżalenie | : (rzecz.) uraza | : (rzecz.) złość
grudging : grudging : (przym.) niechętny | : (przym.) skąpy | : (przym.) wstrzemięźliwy
grudgingly : grudgingly : (przysł.) niechętnie | : (przysł.) zazdrośnie
gruel : gruel : (rzecz.) kaszka | : (rzecz.) kleik
gruesome : gruesome : (przym.) groźny | : (przym.) makabryczny | : (przym.) okropny | : (przym.) straszny
gruff : gruff : (przym.) burkliwy | : (przym.) cierpki | : (przym.) gburowaty | : (przym.) mrukliwy | : (przym.) opryskliwy | : (przym.) rubaszny | : (przym.) szorstki
gruffly : gruffly : (przysł.) szorstko
gruffness : gruffness : (rzecz.) mrukliwość
grumble : grumble : (czas.) burczeć | : (czas.) dokuczać | : (czas.) gderać | : (czas.) grzmieć | : (czas.) narzekać | : (czas.) pogderać | : (czas.) sarkać | : (czas.) skarżyć | : (czas.) szemrać | : (czas.) utyskiwać | : (czas.) zrzędzić | : (rzecz.) gderanie | : (rzecz.) mruczenie | : (rzecz.) mruk | : (rzecz.) pomruk
grumbler : grumbler : (rzecz.) malkontent | : (rzecz.) maruda | : (rzecz.) tetryk | : (rzecz.) zrzęda
grummet : grummet : (rzecz.) przelotka
grumpily : grumpily : (przysł.) zrzędliwie
grumpiness : grumpiness : (rzecz.) gderliwość | : (rzecz.) nieprzystępność
grumpy : grumpy : (przym.) gderliwy | : (przym.) marudny | : (przym.) zrzędliwy
grunge : grunge : (rzecz.) obrzydlistwo | : (rzecz.) paskudztwo | : (rzecz.) świństwo
grunt : grunt : (czas.) chrząkać | : (czas.) kwiczeć | : (rzecz.) chrząkanie | : (rzecz.) kwik
gryphon : gryphon : (rzecz.) gryf
guan : guan : (rzecz.) czubatka
guanidine : guanidine : (rzecz.) guanidyna
guanine : guanine : (rzecz.) guanina
guano : guano : (rzecz.) guano
guarantee : guarantee : (czas.) gwarantować | : (czas.) poręczyć | : (czas.) ręczyć | : (czas.) uzasadniać | : (czas.) zagwarantować | : (czas.) zapewniać | : (czas.) zapewnić | : (rzecz.) gwarancja | : (rzecz.) gwarant | : (rzecz.) gwarantowanie | : (rzecz.) poręczenie | : (rzecz.) poręczyciel | : (rzecz.) poręka | : (rzecz.) rękojmia | : (rzecz.) wadium | : (rzecz.) zagwarantowanie | : (rzecz.) zapewnienie | : (rzecz.) zastaw
guarantor : guarantor : (rzecz.) gwarant | : (rzecz.) poręczyciel | : (rzecz.) żyrant
guaranty : guaranty : (rzecz.) gwarancja | : (rzecz.) poręczenie | : (rzecz.) zabezpieczenie
guard : guard : (czas.) chronić | : (czas.) osłaniać | : (czas.) pilnować | : (rzecz.) garda | : (rzecz.) gwardia | : (rzecz.) konduktor | : (rzecz.) kordegarda | : (rzecz.) obstawa | : (rzecz.) ochraniacz | : (rzecz.) ochrona | : (rzecz.) osłona | : (rzecz.) straż | : (rzecz.) strażnik | : (rzecz.) stróż | : (rzecz.) warta | : (rzecz.) wartownia | : (rzecz.) wartownik | : (rzecz.) zastawa
guard-rail : guard-rail : (rzecz.) balustrada | : (rzecz.) poręcz
guard-room : guard-room : (rzecz.) stróżówka
guardedly : guardedly : (przysł.) ostrożnie
guardhouse : guardhouse : (rzecz.) wartownia
guardian : guardian : (rzecz.) cerber | : (rzecz.) gwardian | : (rzecz.) obrońca | : (rzecz.) opiekun | : (rzecz.) piastun | : (rzecz.) strażnik | : (rzecz.) stróż
guardianship : guardianship : (rzecz.) kuratela
guardrail : guardrail : (rzecz.) balustrada | : (rzecz.) bariera | : (rzecz.) poręcz
guardroom : guardroom : (rzecz.) odwach | : (rzecz.) stróżówka | : (rzecz.) wartownia
guardsman : guardsman : (rzecz.) gwardzista | : (rzecz.) ochroniarz | : (rzecz.) strażnik
guava : guava : (rzecz.) krzew
gubernatorial : gubernatorial : (przym.) gubernatorski
guerdon : guerdon : (czas.) wynagradzać | : (rzecz.) wynagrodzenie | : (rzecz.) zapłata
guerrilla : guerrilla : (przym.) partyzancki | : (przym.) podjazdowy | : (rzecz.) partyzant
guess : guess : (czas.) domniemać | : (czas.) domyślać | : (czas.) domyśleć | : (czas.) domyślić | : (czas.) dorozumieć | : (czas.) miarkować | : (czas.) odgadywać | : (czas.) przypuszczać | : (czas.) wymiarkować | : (czas.) zgadywać | : (rzecz.) domniemanie | : (rzecz.) domysł | : (rzecz.) przypuszczenie | : (rzecz.) zgadnięcie | : (rzecz.) zgadywanie
guess-work : guess-work : (rzecz.) domysł | : (rzecz.) zgadywanie
guesswork : guesswork : (rzecz.) domysł | : (rzecz.) zgadywanie | : (rzecz.) zgadywanka
guest : guest : (rzecz.) gość | : (rzecz.) pensjonariusz
guesthouse : guesthouse : (rzecz.) pensjonat
guffaw : guffaw : (rzecz.) ryk
guidance : guidance : (rzecz.) informacja | : (rzecz.) kierowanie | : (rzecz.) kierownictwo | : (rzecz.) porada | : (rzecz.) poradnictwo | : (rzecz.) prowadzenie
guide : guide : (czas.) kierować | : (czas.) oprowadzać | : (czas.) pokierować | : (czas.) prowadzić | : (rzecz.) kierownik | : (rzecz.) podręcznik | : (rzecz.) poradnik | : (rzecz.) prowadnica | : (rzecz.) prowadnik | : (rzecz.) przewodnik | : (rzecz.) wskazówka
guide-block : guide-block : (rzecz.) wodzik
guide-book : guide-book : (rzecz.) przewodnik
guide-pin : guide-pin : (rzecz.) pilot
guide-post : guide-post : (rzecz.) drogowskaz
guidebook : guidebook : (rzecz.) poradnik | : (rzecz.) przewodnik
guideline : guideline : (rzecz.) prowadnica | : (rzecz.) wskazówka | : (rzecz.) wytyczna
guidelines : guidelines : (rzecz.) wskazówki | : (rzecz.) wytyczne
guidepost : guidepost : (rzecz.) drogowskaz | : (rzecz.) kierunkowskaz
guild : guild : (rzecz.) bractwo | : (rzecz.) cech | : (rzecz.) gildia | : (rzecz.) korporacja
guild's : guild's : (przym.) cechowy
guilder : guilder : (rzecz.) gulden
guildhall : guildhall : (rzecz.) ratusz
guile : guile : (rzecz.) oszustwo | : (rzecz.) podstęp
guileful : guileful : (przym.) chytry | : (przym.) podstępny | : (przym.) przebiegły
guileless : guileless : (przym.) prostoduszny | : (przym.) szczery
guilelessly : guilelessly : (rzecz.) podstęp
guilloche : guilloche : (rzecz.) gilosza
guillotine : guillotine : (rzecz.) gilotyna | : (rzecz.) gilotynowanie | : (rzecz.) krajarka
guilt : guilt : (rzecz.) uczucie | : (rzecz.) wina
guiltily : guiltily : (przysł.) karygodnie
guiltless : guiltless : (przym.) niewinny
guiltlessly : guiltlessly : (przysł.) niewinnie
guilty : guilty : (przym.) karygodny | : (przym.) odpowiedzialny | : (przym.) winien | : (przym.) winny
guinea-fowl : guinea-fowl : (rzecz.) perliczka
guise : guise : (rzecz.) przebranie | : (rzecz.) strój
guitar : guitar : (rzecz.) gitara
guitarist : guitarist : (rzecz.) gitarzysta
gulag : gulag : (rzecz.) gułag
gulch : gulch : (rzecz.) parów | : (rzecz.) wąwóz
gules : gules : (rzecz.) kiep
gulf : gulf : (rzecz.) czeluść | : (rzecz.) mewa | : (rzecz.) otchłań | : (rzecz.) topiel | : (rzecz.) ujadanie | : (rzecz.) wir | : (rzecz.) zatoka
gull : gull : (rzecz.) czajka | : (rzecz.) frajer | : (rzecz.) mewa | : (rzecz.) naiwniak | : (rzecz.) rybitwa
gullet : gullet : (rzecz.) gardło | : (rzecz.) gardziel | : (rzecz.) przełyk
gullibility : gullibility : (rzecz.) bezkrytyczność | : (rzecz.) łatwowierność | : (rzecz.) naiwność
gullible : gullible : (przym.) łatwowierny | : (przym.) naiwny
gully : gully : (rzecz.) kanał | : (rzecz.) ściek | : (rzecz.) wąwóz | : (rzecz.) żleb
gulp : gulp : (czas.) chłeptać | : (czas.) kropić | : (czas.) krztusić | : (czas.) łykać | : (czas.) połykać | : (rzecz.) haust | : (rzecz.) łyk | : (rzecz.) łyknięcie | : (rzecz.) przełknięcie
gum : gum : (rzecz.) dziąsło | : (rzecz.) guma | : (rzecz.) klej
gumboil : gumboil : (rzecz.) fluksja
gummy : gummy : (przym.) gumowaty | : (przym.) lepki | : (przym.) żywiczny
gumption : gumption : (rzecz.) inicjatywa | : (rzecz.) smykałka | : (rzecz.) spryt
gumshoe : gumshoe : (rzecz.) szpicel
gun : gun : (rzecz.) armata | : (rzecz.) armatka | : (rzecz.) broń | : (rzecz.) działo | : (rzecz.) karabin | : (rzecz.) pistolet | : (rzecz.) spluwanie | : (rzecz.) strzelba | : (rzecz.) sztucer
gun-camera : gun-camera : (rzecz.) fotokarabin
gun-carriage : gun-carriage : (rzecz.) laweta
gun-cotton : gun-cotton : (rzecz.) spiż
gunboat : gunboat : (rzecz.) kanonierka
guncotton : guncotton : (rzecz.) spiż
gunfight : gunfight : (rzecz.) strzelanina
gunfighter : gunfighter : (rzecz.) rewolwerowiec
gunfire : gunfire : (rzecz.) kanonada | : (rzecz.) obstrzał | : (rzecz.) ogień | : (rzecz.) ostrzał | : (rzecz.) pukanina | : (rzecz.) strzelanina
gunk : gunk : (rzecz.) maź
gunman : gunman : (rzecz.) rewolwerowiec | : (rzecz.) strzelec
gunner : gunner : (rzecz.) artylerzysta | : (rzecz.) kanonier
gunnery : gunnery : (rzecz.) artyleria | : (rzecz.) balistyka
gunning : gunning : (rzecz.) zastrzelenie
gunpoint : gunpoint : (rzecz.) muszka
gunpowder : gunpowder : (rzecz.) proch | : (rzecz.) prochownia
gunshot : gunshot : (rzecz.) postrzał | : (rzecz.) wystrzał
gunsmith : gunsmith : (rzecz.) puszkarz | : (rzecz.) rusznikarz
gunwale : gunwale : (rzecz.) okrężnica
guppy : guppy : (rzecz.) gupik
gurgitation : gurgitation : (rzecz.) bulgot
gurgle : gurgle : (czas.) bulgotać | : (czas.) gulgotać | : (rzecz.) bulgot | : (rzecz.) bulgotanie
gush : gush : (czas.) bić | : (czas.) chlustać | : (czas.) lać | : (czas.) tryskać | : (czas.) wylewać | : (czas.) zbić | : (rzecz.) gejzer | : (rzecz.) potok | : (rzecz.) tryśnięcie | : (rzecz.) ulewa | : (rzecz.) wybuch | : (rzecz.) wylew | : (rzecz.) wytrysk | : (rzecz.) wytryśnięcie
gusher : gusher : (rzecz.) gejzer | : (rzecz.) wytrysk
gusset : gusset : (rzecz.) klamra | : (rzecz.) klin | : (rzecz.) węzłówka | : (rzecz.) wstawka
gust : gust : (rzecz.) podmuch | : (rzecz.) poryw | : (rzecz.) wybuch
gustatory : gustatory : (przym.) smakowy
gusto : gusto : (rzecz.) werwa | : (rzecz.) zapał
gusty : gusty : (przym.) gwałtowny | : (przym.) porywisty
gut : gut : (czas.) patroszyć | : (rzecz.) brzuch | : (rzecz.) czelność | : (rzecz.) flak | : (rzecz.) jelito | : (rzecz.) kiszka | : (rzecz.) struna
gutlessness : gutlessness : (rzecz.) jelito
guts : guts : (rzecz.) bebechy | : (rzecz.) odwaga
gutsy : gutsy : (przym.) gruby | : (przym.) mięsisty | : (przym.) mocny
gutta-percha : gutta-percha : (rzecz.) gutaperka
gutter : gutter : (rzecz.) rynna | : (rzecz.) rynsztok | : (rzecz.) ściek
guttersnipe : guttersnipe : (rzecz.) ulicznik
guttural : guttural : (przym.) gardłowy
guy : guy : (rzecz.) człowiek | : (rzecz.) dziwak | : (rzecz.) facet | : (rzecz.) gość | : (rzecz.) koleś | : (rzecz.) odciąg
guzzle : guzzle : (czas.) pochłaniać | : (czas.) pożerać | : (czas.) przepić | : (czas.) przepijać | : (czas.) wyżłopać | : (czas.) żłopać | : (czas.) żreć
guzzler : guzzler : (rzecz.) obżartuch | : (rzecz.) pijak | : (rzecz.) żarłok
gym : gym : (rzecz.) gimnastyka | : (rzecz.) siłownia
gymnasium : gymnasium : (rzecz.) boisko | : (rzecz.) gimnazjum | : (rzecz.) sala | : (rzecz.) siłownia
gymnast : gymnast : (rzecz.) gimnastyk | : (rzecz.) gimnastyka
gymnastic : gymnastic : (przym.) gimnastyczny
gymnastics : gymnastics : (rzecz.) gimnastyka
gymnosperm : gymnosperm : (przym.) nagonasienny
gynaecologist : gynaecologist : (rzecz.) ginekolog
gynaecology : gynaecology : (rzecz.) ginekologia
gyp : gyp : (rzecz.) kanciarz | : (rzecz.) kant
gypsum : gypsum : (rzecz.) gips | : (rzecz.) gipsowanie
gypsy : gypsy : (rzecz.) cygan | : (rzecz.) czarnula
gyrate : gyrate : (czas.) kręcić | : (czas.) obracać | : (czas.) wirować
gyration : gyration : (rzecz.) cyrkulacja | : (rzecz.) wirowanie
gyre : gyre : (rzecz.) wir
gyrfalcon : gyrfalcon : (rzecz.) sokół
gyro : gyro : (rzecz.) żyro | : (rzecz.) żyroskop
gyro-compass : gyro-compass : (rzecz.) żyrokompas
gyrocompass : gyrocompass : (rzecz.) żyrokompas
gyroplane : gyroplane : (rzecz.) autożyro | : (rzecz.) wiatrakowiec
gyroscope : gyroscope : (rzecz.) bączek | : (rzecz.) giroskop | : (rzecz.) żyroskop
gyroscopes : gyroscopes : (rzecz.) żyroskop
gyroscopic : gyroscopic : (przym.) żyroskopowy
gyrostat : gyrostat : (rzecz.) girostat
